3d%,3d%_allowed,TOP,date,first_downs,first_downs_allowed,ha,margin,opp,pass_yards,pass_yards_allowed,penalty_yards,plays,points,points_allowed,result,rush_yards,rush_yards_allowed,sacked,sacks,takeaways,team,total_points,total_yards,total_yards_allowed,turnovers,prediction
0.25,0.333333333,22.9,2015-01-03,8,25,away,-11,CAR,51,198,38,47,16,27,Loss,27,188,4,1,3,ARI,43,78,386,3,Loss
0.333333333,0.25,37.1,2015-01-03,25,8,home,11,ARI,198,51,80,74,27,16,Win,188,27,1,4,3,CAR,43,386,78,3,Win
0.363636364,0.3125,24.71666667,2015-01-03,19,22,away,13,PIT,246,319,14,55,30,17,Win,53,68,1,5,3,BAL,47,299,387,1,Win
0.3125,0.363636364,35.28333333,2015-01-03,22,19,home,-13,BAL,319,246,114,72,17,30,Loss,68,53,5,1,1,PIT,47,387,299,3,Loss
0.4,0.428571429,25.83333333,2015-01-04,14,22,away,-16,IND,144,368,45,59,10,26,Loss,110,114,3,1,1,CIN,36,254,482,1,Loss
0.428571429,0.4,34.16666667,2015-01-04,22,14,home,16,CIN,368,144,66,70,26,10,Win,114,110,1,3,1,IND,36,482,254,1,Win
0.363636364,0.428571429,29.55,2015-01-04,19,18,away,-4,DAL,307,242,44,67,20,24,Loss,90,73,3,6,1,DET,44,397,315,3,Loss
0.428571429,0.363636364,30.45,2015-01-04,18,19,home,4,DET,242,307,46,58,24,20,Win,73,90,6,3,3,DAL,44,315,397,1,Win
0.111111111,0.545454545,32.65,2015-01-10,28,29,away,-4,NEP,292,408,65,73,31,35,Loss,136,14,0,2,1,BAL,66,428,422,2,Loss
0.545454545,0.111111111,27.35,2015-01-10,29,28,home,4,BAL,408,292,60,66,35,31,Win,14,136,2,0,2,NEP,66,422,428,1,Win
0.5625,0.538461538,34.05,2015-01-10,21,16,away,-14,SEA,230,248,35,68,17,31,Loss,132,100,2,2,0,CAR,48,362,348,3,Loss
0.538461538,0.5625,25.95,2015-01-10,16,21,home,14,CAR,248,230,60,52,31,17,Win,100,132,2,2,3,SEA,48,348,362,0,Win
0.5,0.642857143,30.65,2015-01-11,21,23,away,-5,GBP,170,297,35,51,21,26,Loss,145,119,4,2,1,DAL,47,315,416,1,Loss
0.642857143,0.5,29.35,2015-01-11,23,21,home,5,DAL,297,170,87,66,26,21,Win,119,145,2,4,1,GBP,47,416,315,1,Win
0.384615385,0.25,34.01666667,2015-01-11,23,19,away,11,DEN,265,200,67,71,24,13,Win,99,88,0,2,1,IND,37,364,288,2,Win
0.25,0.384615385,25.98333333,2015-01-11,19,23,home,-11,IND,200,265,8,68,13,24,Loss,88,99,2,0,2,DEN,37,288,364,1,Loss
0.214285714,0.5,32.25,2015-01-18,19,20,away,-6,SEA,171,203,45,65,0,6,Loss,135,194,1,5,5,GBP,6,306,397,2,Loss
0.5,0.214285714,31.06666667,2015-01-18,20,19,home,6,GBP,203,171,40,70,6,0,Win,194,135,5,1,2,SEA,6,397,306,5,Win
0.272727273,0.666666667,22.18333333,2015-01-18,17,28,away,-38,NEP,126,220,23,52,7,45,Loss,83,177,0,1,1,IND,52,209,397,3,Loss
0.666666667,0.272727273,37.81666667,2015-01-18,28,17,home,38,IND,220,126,45,76,45,7,Win,177,83,1,0,3,NEP,52,397,209,1,Win
0.571428571,0.3,33.76666667,2015-02-01,25,20,away,4,SEA,320,234,36,72,28,24,Win,57,162,1,3,1,NEP,52,377,396,2,Win
0.3,0.571428571,26.23333333,2015-02-01,20,25,home,-4,NEP,234,320,70,53,24,28,Loss,162,57,3,1,2,SEA,52,396,377,1,Win
0.46666666700000003,0.636363636,32.08333333,2015-09-10,23,26,away,-7,NEP,330,281,77,66,21,28,Loss,134,80,3,2,0,PIT,49,464,361,1,Loss
0.636363636,0.46666666700000003,27.91666667,2015-09-10,26,23,home,7,PIT,281,330,64,58,28,21,Win,80,134,2,3,1,NEP,49,361,464,0,Win
0.6,0.647058824,28.13333333,2015-09-13,21,25,away,8,CHI,189,213,74,53,31,23,Win,133,189,0,2,1,GBP,54,322,402,0,Win
0.647058824,0.6,31.86666667,2015-09-13,25,21,home,-8,GBP,213,189,64,71,23,31,Loss,189,133,2,0,0,CHI,54,402,322,1,Loss
0.23076923100000002,0.214285714,35.31666667,2015-09-13,19,24,away,7,HOU,233,298,25,67,27,20,Win,97,98,2,5,2,KCC,47,330,396,0,Win
0.214285714,0.23076923100000002,24.68333333,2015-09-13,24,19,home,-7,KCC,298,233,39,73,20,27,Loss,98,97,5,2,0,HOU,47,396,330,2,Loss
0.5,0.538461538,31.66666667,2015-09-13,15,18,away,-21,NYJ,217,179,109,63,10,31,Loss,104,154,3,0,1,CLE,41,321,333,5,Loss
0.538461538,0.5,28.33333333,2015-09-13,18,15,home,21,CLE,179,217,30,60,31,10,Win,154,104,0,3,5,NYJ,41,333,321,1,Win
0.533333333,0.384615385,29.06666667,2015-09-13,23,15,away,-13,BUF,240,195,49,68,14,27,Loss,64,147,2,0,0,IND,41,304,342,3,Loss
0.384615385,0.533333333,30.93333333,2015-09-13,15,23,home,13,IND,195,240,113,55,27,14,Win,147,64,0,2,3,BUF,41,342,304,0,Win
0.41666666700000005,0.428571429,22.1,2015-09-13,19,20,away,7,WAS,182,188,39,55,17,10,Win,74,161,3,1,2,MIA,27,256,349,1,Win
0.428571429,0.41666666700000005,37.9,2015-09-13,20,19,home,-7,MIA,188,182,88,69,10,17,Loss,161,74,1,3,1,WAS,27,349,256,2,Loss
0.470588235,0.25,34.1,2015-09-13,17,18,away,11,JAX,158,169,22,68,20,9,Win,105,96,2,5,3,CAR,29,263,265,1,Win
0.25,0.470588235,25.9,2015-09-13,18,17,home,-11,CAR,169,158,25,66,9,20,Loss,96,105,5,2,1,JAX,29,265,263,3,Loss
0.42105263200000004,0.545454545,37.46666667,2015-09-13,21,19,away,-3,LAR,219,276,46,79,0,3,Loss,124,76,6,2,3,SEA,3,343,352,1,Loss
0.545454545,0.42105263200000004,28.53333333,2015-09-13,19,21,home,3,SEA,276,219,30,55,3,0,Win,76,124,2,6,1,LAR,3,352,343,3,Win
0.38888888899999996,0.5,33.4,2015-09-13,18,25,away,-12,ARI,354,307,73,70,19,31,Loss,54,120,2,0,1,NOS,50,408,427,1,Loss
0.5,0.38888888899999996,26.6,2015-09-13,25,18,home,12,NOS,307,354,30,57,31,19,Win,120,54,0,2,1,ARI,50,427,408,1,Win
0.3,0.545454545,21.8,2015-09-13,16,28,away,-5,LAC,233,387,29,47,28,33,Loss,69,96,1,2,3,DET,61,302,483,2,Loss
0.545454545,0.3,38.2,2015-09-13,28,16,home,5,DET,387,233,40,74,33,28,Win,96,69,2,1,2,LAC,61,483,302,3,Win
0.444444444,0.214285714,31.51666667,2015-09-13,20,16,away,28,TBB,185,181,55,49,42,14,Win,124,92,2,4,2,TEN,56,309,273,1,Win
0.214285714,0.444444444,28.48333333,2015-09-13,16,20,home,-28,TEN,181,185,97,63,14,42,Loss,92,124,4,2,1,TBB,56,273,309,2,Loss
0.307692308,0.25,32.53333333,2015-09-13,22,16,away,20,OAK,269,183,50,65,33,13,Win,127,63,0,2,2,CIN,46,396,246,0,Win
0.25,0.307692308,27.46666667,2015-09-13,16,22,home,-20,CIN,183,269,32,61,13,33,Loss,63,127,2,0,0,OAK,46,246,396,2,Loss
0.153846154,0.444444444,22.71666667,2015-09-13,11,16,away,-6,DEN,100,150,15,57,13,19,Loss,73,69,2,4,1,BAL,32,173,219,2,Loss
0.444444444,0.153846154,37.28333333,2015-09-13,16,11,home,6,BAL,150,100,45,69,19,13,Win,69,73,4,2,2,DEN,32,219,173,1,Win
0.428571429,0.545454545,22.83333333,2015-09-13,18,27,away,-1,DAL,186,356,44,61,26,27,Loss,99,80,1,0,3,NYG,53,285,436,0,Win
0.545454545,0.428571429,37.16666667,2015-09-13,27,18,home,1,NYG,356,186,35,68,27,26,Win,80,99,0,1,0,DAL,53,436,285,3,Loss
0.25,0.28571428600000004,24.55,2015-09-14,23,21,away,-2,ATL,336,290,88,68,24,26,Loss,63,105,0,1,2,PHI,50,399,395,2,Loss
0.28571428600000004,0.25,35.45,2015-09-14,21,23,home,2,PHI,290,336,57,70,26,24,Win,105,63,1,0,2,ATL,50,395,399,2,Win
0.111111111,0.41666666700000005,26.96666667,2015-09-14,17,25,away,-17,SFO,177,165,25,54,3,20,Loss,71,230,5,1,1,MIN,23,248,395,1,Loss
0.41666666700000005,0.111111111,33.03333333,2015-09-14,25,17,home,17,MIN,165,177,57,66,20,3,Win,230,71,1,5,1,SFO,23,395,248,1,Win
0.375,0.0,31.01666667,2015-09-17,21,20,away,7,KCC,238,167,85,70,31,24,Win,61,147,3,5,5,DEN,55,299,314,1,Win
0.0,0.375,28.98333333,2015-09-17,20,21,home,-7,DEN,167,238,60,58,24,31,Loss,147,61,5,3,1,KCC,55,314,299,5,Loss
0.263157895,0.307692308,27.71666667,2015-09-20,21,25,away,-7,CAR,239,178,70,82,17,24,Loss,61,172,1,2,1,HOU,41,300,350,1,Loss
0.307692308,0.263157895,32.28333333,2015-09-20,25,21,home,7,HOU,178,239,92,72,24,17,Win,172,61,2,1,1,CAR,41,350,300,1,Win
0.41176470600000004,0.6,36.98333333,2015-09-20,27,21,away,-25,PIT,298,369,46,82,18,43,Loss,111,84,5,0,0,SFO,61,409,453,1,Loss
0.6,0.41176470600000004,23.01666667,2015-09-20,21,27,home,25,SFO,369,298,58,52,43,18,Win,84,111,0,5,1,PIT,61,453,409,0,Win
0.35714285700000004,0.5,28.53333333,2015-09-20,18,21,away,7,NOS,194,219,90,59,26,19,Win,139,104,3,4,3,TBB,45,333,323,2,Win
0.5,0.35714285700000004,31.46666667,2015-09-20,21,18,home,-7,TBB,219,194,115,69,19,26,Loss,104,139,4,3,2,NOS,45,323,333,3,Loss
0.46153846200000004,0.5,28.9,2015-09-20,25,20,away,-10,MIN,285,151,39,70,16,26,Loss,38,199,1,1,1,DET,42,323,350,3,Loss
0.5,0.46153846200000004,31.1,2015-09-20,20,25,home,10,DET,151,285,97,61,26,16,Win,199,38,1,1,3,MIN,42,350,323,1,Win
0.5555555560000001,0.166666667,30.06666667,2015-09-20,21,18,away,25,CHI,185,226,58,52,48,23,Win,115,109,0,2,2,ARI,71,300,335,2,Win
0.166666667,0.5555555560000001,29.93333333,2015-09-20,18,21,home,-25,ARI,226,185,170,62,23,48,Loss,109,115,2,0,2,CHI,71,335,300,2,Loss
0.3,0.307692308,29.95,2015-09-20,27,23,away,8,BUF,451,189,119,76,40,32,Win,56,160,2,8,3,NEP,72,507,349,2,Win
0.307692308,0.3,30.05,2015-09-20,23,27,home,-8,NEP,189,451,140,65,32,40,Loss,160,56,8,2,2,BUF,72,349,507,3,Loss
0.363636364,0.4,30.15,2015-09-20,19,20,away,-5,CIN,223,214,64,56,19,24,Loss,131,175,4,0,2,LAC,43,354,389,3,Loss
0.4,0.363636364,29.85,2015-09-20,20,19,home,5,LAC,214,223,75,62,24,19,Win,175,131,0,4,3,CIN,43,389,354,2,Win
0.4375,0.363636364,35.18333333,2015-09-20,21,13,away,-14,CLE,219,158,85,74,14,28,Loss,166,116,7,2,0,TEN,42,385,274,3,Loss
0.363636364,0.4375,24.81666667,2015-09-20,13,21,home,14,TEN,158,219,40,47,28,14,Win,116,166,2,7,3,CLE,42,274,385,0,Win
0.647058824,0.588235294,31.58333333,2015-09-20,25,19,away,4,NYG,346,291,65,70,24,20,Win,56,97,2,2,1,ATL,44,402,388,0,Win
0.588235294,0.647058824,28.41666667,2015-09-20,19,25,home,-4,ATL,291,346,35,65,20,24,Loss,97,56,2,2,0,NYG,44,388,402,1,Loss
0.166666667,0.5,22.26666667,2015-09-20,11,19,away,-14,WAS,146,191,80,46,10,24,Loss,67,182,1,2,1,LAR,34,213,373,0,Loss
0.5,0.166666667,37.73333333,2015-09-20,19,11,home,14,LAR,191,146,53,66,24,10,Win,182,67,2,1,0,WAS,34,373,213,1,Win
0.333333333,0.35714285700000004,29.86666667,2015-09-20,17,19,away,-3,JAX,344,273,112,62,20,23,Loss,42,123,2,0,0,MIA,43,386,396,0,Loss
0.35714285700000004,0.333333333,30.13333333,2015-09-20,19,17,home,3,MIA,273,344,93,66,23,20,Win,123,42,0,2,0,JAX,43,396,386,0,Win
0.363636364,0.642857143,30.43333333,2015-09-20,29,27,away,-4,OAK,384,351,109,70,33,37,Loss,109,97,0,1,1,BAL,70,493,448,2,Loss
0.642857143,0.363636364,29.56666667,2015-09-20,27,29,home,4,BAL,351,384,106,66,37,33,Win,97,109,1,0,2,OAK,70,448,493,1,Win
0.333333333,0.181818182,40.41666667,2015-09-20,21,17,away,10,PHI,250,219,142,70,20,10,Win,109,7,3,1,3,DAL,30,359,226,2,Win
0.181818182,0.333333333,19.58333333,2015-09-20,17,21,home,-10,DAL,219,250,60,55,10,20,Loss,7,109,1,3,2,PHI,30,226,359,3,Loss
0.333333333,0.363636364,26.7,2015-09-20,21,21,away,-10,GBP,205,234,92,57,17,27,Loss,119,127,2,2,1,SEA,44,324,361,2,Loss
0.363636364,0.333333333,33.3,2015-09-20,21,21,home,10,SEA,234,205,35,64,27,17,Win,127,119,2,2,2,GBP,44,361,324,1,Win
0.333333333,0.428571429,31.8,2015-09-21,20,17,away,13,IND,243,250,90,62,20,7,Win,101,93,1,0,5,NYJ,27,344,343,1,Win
0.428571429,0.333333333,28.2,2015-09-21,17,20,home,-13,NYJ,250,243,84,61,7,20,Loss,93,101,0,1,1,IND,27,343,344,5,Loss
0.4,0.333333333,28.5,2015-09-24,22,19,away,-11,NYG,305,279,58,70,21,32,Loss,88,84,1,0,0,WAS,53,393,363,3,Loss
0.333333333,0.4,31.5,2015-09-24,19,22,home,11,WAS,279,305,67,63,32,21,Win,84,88,0,1,3,NYG,53,363,393,0,Win
0.642857143,0.166666667,34.21666667,2015-09-27,26,23,away,11,DAL,280,220,70,69,39,28,Win,158,127,1,2,1,ATL,67,438,347,0,Win
0.166666667,0.642857143,25.78333333,2015-09-27,23,26,home,-11,ATL,220,280,31,49,28,39,Loss,127,158,2,1,0,DAL,67,347,438,1,Loss
0.363636364,0.307692308,25.01666667,2015-09-27,20,28,away,2,TEN,245,345,71,56,35,33,Win,133,88,3,3,2,IND,68,378,433,2,Win
0.307692308,0.363636364,34.98333333,2015-09-27,28,20,home,-2,IND,345,245,55,74,33,35,Loss,88,133,3,3,2,TEN,68,433,378,2,Loss
0.428571429,0.5,32.48333333,2015-09-27,19,21,away,7,CLE,314,316,85,62,27,20,Win,155,39,0,5,2,OAK,47,469,355,1,Win
0.5,0.428571429,27.51666667,2015-09-27,21,19,home,-7,OAK,316,314,50,68,20,27,Loss,39,155,5,0,1,CLE,47,355,469,2,Loss
0.533333333,0.4375,30.13333333,2015-09-27,23,19,away,4,BAL,372,362,67,65,28,24,Win,86,36,2,0,1,CIN,52,458,398,2,Win
0.4375,0.533333333,29.86666667,2015-09-27,19,23,home,-4,CIN,362,372,116,67,24,28,Loss,36,86,0,2,2,BAL,52,398,458,1,Loss
0.5,0.7857142859999999,25.33333333,2015-09-27,15,35,away,-34,NEP,236,346,114,55,17,51,Loss,57,125,2,2,0,JAX,68,293,471,1,Loss
0.7857142859999999,0.5,34.66666667,2015-09-27,35,15,home,34,JAX,346,236,30,76,51,17,Win,125,57,2,2,1,NEP,68,471,293,0,Win
0.583333333,0.454545455,32.73333333,2015-09-27,27,24,away,-5,CAR,310,312,55,63,22,27,Loss,70,119,1,1,0,NOS,49,380,431,2,Loss
0.454545455,0.583333333,27.26666667,2015-09-27,24,27,home,5,NOS,312,310,88,62,27,22,Win,119,70,1,1,2,CAR,49,431,380,0,Win
0.28571428600000004,0.41176470600000004,28.18333333,2015-09-27,18,19,away,7,NYJ,108,276,21,67,24,17,Win,123,47,1,1,4,PHI,41,231,323,1,Win
0.41176470600000004,0.28571428600000004,31.81666667,2015-09-27,19,18,home,-7,PHI,276,108,53,75,17,24,Loss,47,123,1,1,1,NYJ,41,323,231,4,Loss
0.083333333,0.444444444,23.71666667,2015-09-27,14,30,away,-10,HOU,261,227,84,56,9,19,Loss,57,186,0,1,1,TBB,28,318,413,1,Loss
0.444444444,0.083333333,36.28333333,2015-09-27,30,14,home,10,TBB,227,261,58,86,19,9,Win,186,57,1,0,1,HOU,28,413,318,1,Win
0.470588235,0.333333333,33.48333333,2015-09-27,21,18,away,-17,MIN,279,121,74,72,14,31,Loss,90,163,4,0,1,LAC,45,369,284,2,Loss
0.333333333,0.470588235,26.51666667,2015-09-27,18,21,home,17,LAC,121,279,39,55,31,14,Win,163,90,0,4,2,MIN,45,284,369,1,Win
0.5,0.2,32.31666667,2015-09-27,17,12,away,6,LAR,197,187,63,57,12,6,Win,62,71,5,2,1,PIT,18,259,258,1,Win
0.2,0.5,27.68333333,2015-09-27,12,17,home,-6,PIT,187,197,47,49,6,12,Loss,71,62,2,5,1,LAR,18,258,259,1,Loss
0.333333333,0.46153846200000004,23.46666667,2015-09-27,10,28,away,-40,ARI,53,307,45,50,7,47,Loss,103,139,2,1,1,SFO,54,156,446,4,Loss
0.46153846200000004,0.333333333,36.53333333,2015-09-27,28,10,home,40,SFO,307,53,24,70,47,7,Win,139,103,1,2,4,ARI,54,446,156,1,Win
0.538461538,0.307692308,31.88333333,2015-09-27,21,21,away,27,MIA,277,289,40,63,41,14,Win,151,102,0,2,3,BUF,55,428,391,0,Win
0.307692308,0.538461538,28.11666667,2015-09-27,21,21,home,-27,BUF,289,277,36,71,14,41,Loss,102,151,2,0,0,MIA,55,391,428,3,Loss
0.23076923100000002,0.3125,27.4,2015-09-27,7,17,away,-26,SEA,48,212,40,46,0,26,Loss,98,159,2,4,0,CHI,26,146,371,0,Loss
0.3125,0.23076923100000002,32.6,2015-09-27,17,7,home,26,CHI,212,48,41,63,26,0,Win,159,98,4,2,0,SEA,26,371,146,0,Win
0.333333333,0.333333333,28.86666667,2015-09-27,19,22,away,12,DET,313,262,94,62,24,12,Win,41,28,1,4,3,DEN,36,354,290,2,Win
0.333333333,0.333333333,31.13333333,2015-09-27,22,19,home,-12,DEN,262,313,75,68,12,24,Loss,28,41,4,1,2,DET,36,290,354,3,Loss
0.2,0.363636364,26.5,2015-09-28,23,26,away,-10,GBP,251,325,38,65,28,38,Loss,75,123,7,1,0,KCC,66,326,448,1,Loss
0.363636364,0.2,33.5,2015-09-28,26,23,home,10,KCC,325,251,89,68,38,28,Win,123,75,1,7,1,GBP,66,448,326,0,Win
0.352941176,0.153846154,37.71666667,2015-10-01,21,17,away,3,PIT,165,96,30,78,3,0,Win,191,167,5,4,0,BAL,3,356,263,2,Win
0.153846154,0.352941176,32.15,2015-10-01,17,21,home,-3,BAL,96,165,20,63,0,3,Loss,167,191,4,5,2,PIT,3,263,356,0,Loss
0.375,0.0,37.38333333,2015-10-04,23,17,away,13,MIA,218,167,163,72,27,14,Win,207,59,0,3,2,NYJ,41,425,226,1,Win
0.0,0.375,22.61666667,2015-10-04,17,23,home,-13,NYJ,167,218,80,58,14,27,Loss,59,207,3,0,1,MIA,41,226,425,2,Loss
0.38888888899999996,0.46666666700000003,36.16666667,2015-10-04,21,22,away,-3,IND,289,266,92,79,0,3,Loss,142,60,1,3,2,JAX,3,431,326,0,Loss
0.46666666700000003,0.38888888899999996,34.23333333,2015-10-04,22,21,home,3,JAX,266,289,45,74,3,0,Win,60,142,3,1,0,IND,3,326,431,2,Win
0.2,0.1875,30.55,2015-10-04,19,14,away,14,BUF,211,258,85,64,24,10,Win,92,55,1,2,2,NYG,34,303,313,1,Win
0.1875,0.2,29.45,2015-10-04,14,19,home,-14,NYG,258,211,135,68,10,24,Loss,55,92,2,1,1,BUF,34,313,303,2,Loss
0.272727273,0.5,27.86666667,2015-10-04,17,25,away,14,TBB,111,270,45,57,37,23,Win,133,141,2,2,5,CAR,60,244,411,1,Win
0.5,0.272727273,32.13333333,2015-10-04,25,17,home,-14,CAR,270,111,48,75,23,37,Loss,141,133,2,2,1,TBB,60,411,244,5,Loss
0.333333333,0.529411765,18.86666667,2015-10-04,14,25,away,-3,WAS,233,290,72,51,20,23,Loss,87,127,5,1,1,PHI,43,320,417,2,Loss
0.529411765,0.333333333,41.13333333,2015-10-04,25,14,home,3,PHI,290,233,110,79,23,20,Win,127,87,1,5,2,WAS,43,417,320,1,Win
0.46153846200000004,0.588235294,26.63333333,2015-10-04,16,23,away,-2,CHI,173,273,47,57,20,22,Loss,70,98,2,3,3,OAK,42,243,371,2,Loss
0.588235294,0.46153846200000004,33.36666667,2015-10-04,23,16,home,2,OAK,273,173,48,75,22,20,Win,98,70,3,2,2,CHI,42,371,243,3,Loss
0.46666666700000003,0.5625,24.13333333,2015-10-04,24,22,away,-27,ATL,374,243,35,75,21,48,Loss,54,135,1,2,0,HOU,69,428,378,4,Loss
0.5625,0.46666666700000003,35.86666667,2015-10-04,22,24,home,27,HOU,243,374,80,64,48,21,Win,135,54,2,1,4,ATL,69,378,428,0,Win
0.4375,0.6,36.88333333,2015-10-04,24,18,away,-15,CIN,348,321,46,73,21,36,Loss,113,124,5,0,0,KCC,57,461,445,1,Loss
0.6,0.4375,23.11666667,2015-10-04,18,24,home,15,KCC,321,348,84,50,36,21,Win,124,113,0,5,1,CIN,57,445,461,0,Win
0.307692308,0.272727273,34.31666667,2015-10-04,20,23,away,-3,LAC,332,347,91,66,27,30,Loss,100,91,4,2,0,CLE,57,432,438,1,Loss
0.272727273,0.307692308,25.68333333,2015-10-04,23,20,home,3,CLE,347,332,31,61,30,27,Win,91,100,2,4,1,LAC,57,438,432,0,Win
0.333333333,0.307692308,36.56666667,2015-10-04,18,8,away,14,SFO,200,119,65,68,17,3,Win,162,77,3,6,1,GBP,20,362,196,0,Win
0.307692308,0.333333333,23.43333333,2015-10-04,8,18,home,-14,GBP,119,200,30,50,3,17,Loss,77,162,6,3,0,SFO,20,196,362,1,Loss
0.384615385,0.181818182,26.78333333,2015-10-04,13,26,away,2,ARI,164,334,66,51,24,22,Win,164,113,1,4,3,LAR,46,328,447,0,Win
0.181818182,0.384615385,33.21666667,2015-10-04,26,13,home,-2,LAR,334,164,20,71,22,24,Loss,113,164,4,1,0,ARI,46,447,328,3,Loss
0.375,0.222222222,33.9,2015-10-04,19,18,away,-3,DEN,212,200,63,69,20,23,Loss,113,144,7,2,2,MIN,43,325,344,1,Loss
0.222222222,0.375,26.1,2015-10-04,18,19,home,3,MIN,200,212,40,53,23,20,Win,144,113,2,7,1,DEN,43,344,325,2,Win
0.25,0.46153846200000004,29.33333333,2015-10-04,21,27,away,-6,NOS,220,335,30,57,0,6,Loss,115,103,3,3,0,DAL,6,335,438,0,Loss
0.46153846200000004,0.25,30.88333333,2015-10-04,27,21,home,6,DAL,335,220,64,69,6,0,Win,103,115,3,3,0,NOS,6,438,335,0,Win
0.23076923100000002,0.46153846200000004,27.93333333,2015-10-05,12,18,away,-3,SEA,203,235,37,53,10,13,Loss,53,110,0,6,3,DET,23,256,345,1,Loss
0.46153846200000004,0.23076923100000002,32.06666667,2015-10-05,18,12,home,3,DET,235,203,30,63,13,10,Win,110,53,6,0,1,SEA,23,345,256,3,Loss
0.272727273,0.5,27.55,2015-10-08,22,24,away,7,HOU,213,362,65,59,27,20,Win,110,82,0,1,2,IND,47,323,444,0,Win
0.5,0.272727273,32.45,2015-10-08,24,22,home,-7,IND,362,213,125,70,20,27,Loss,82,110,1,0,0,HOU,47,444,323,2,Loss
0.428571429,0.35714285700000004,33.61666667,2015-10-11,21,16,away,1,KCC,241,170,49,73,18,17,Win,87,117,2,3,0,CHI,35,328,287,1,Loss
0.35714285700000004,0.428571429,26.38333333,2015-10-11,16,21,home,-1,CHI,170,241,49,58,17,18,Loss,117,87,3,2,1,KCC,35,287,328,0,Win
0.384615385,0.4,30.58333333,2015-10-11,16,27,away,-3,CIN,197,310,112,57,0,3,Loss,200,109,4,4,2,SEA,3,397,419,1,Loss
0.4,0.384615385,40.81666667,2015-10-11,27,16,home,3,SEA,310,197,50,79,3,0,Win,109,200,4,4,1,CIN,3,419,397,2,Loss
0.333333333,0.4,27.81666667,2015-10-11,18,29,away,-6,ATL,219,242,51,57,0,6,Loss,51,176,1,3,3,WAS,6,270,418,2,Loss
0.4,0.333333333,34.93333333,2015-10-11,29,18,home,6,WAS,242,219,62,77,6,0,Win,176,51,3,1,2,ATL,6,418,270,3,Win
0.25,0.454545455,25.31666667,2015-10-11,21,20,away,-7,TBB,270,186,12,56,31,38,Loss,55,183,6,2,0,JAX,69,325,369,2,Loss
0.454545455,0.25,34.68333333,2015-10-11,20,21,home,7,JAX,186,270,72,61,38,31,Win,183,55,2,6,2,TBB,69,369,325,0,Win
0.5,0.363636364,25.96666667,2015-10-11,19,34,away,-22,PHI,292,333,78,69,17,39,Loss,96,186,5,0,2,NOS,56,388,519,4,Loss
0.363636364,0.5,34.03333333,2015-10-11,34,19,home,22,NOS,333,292,35,79,39,17,Win,186,96,0,5,4,PHI,56,519,388,2,Win
0.6315789470000001,0.35714285700000004,39.26666667,2015-10-11,25,22,away,3,BAL,422,196,74,80,3,0,Win,83,181,4,1,0,CLE,3,505,377,0,Tie
0.35714285700000004,0.6315789470000001,29.01666667,2015-10-11,22,25,home,-3,CLE,196,422,98,67,0,3,Loss,181,83,1,4,0,BAL,3,377,505,0,Loss
0.27777777800000003,0.307692308,33.71666667,2015-10-11,17,14,away,-14,GBP,143,236,40,70,10,24,Loss,191,86,3,2,3,LAR,34,334,322,4,Loss
0.307692308,0.27777777800000003,26.28333333,2015-10-11,14,17,home,14,LAR,236,143,67,59,24,10,Win,86,191,2,3,4,GBP,34,322,334,3,Win
0.333333333,0.384615385,24.48333333,2015-10-11,13,17,away,1,TEN,82,179,62,50,14,13,Win,127,97,4,2,1,BUF,27,209,276,1,Loss
0.384615385,0.333333333,35.51666667,2015-10-11,17,13,home,-1,BUF,179,82,74,62,13,14,Loss,97,127,2,4,1,TEN,27,276,209,1,Win
0.125,0.470588235,23.46666667,2015-10-11,15,29,away,25,DET,158,379,70,45,42,17,Win,187,56,2,1,6,ARI,59,345,435,0,Win
0.470588235,0.125,36.53333333,2015-10-11,29,15,home,-25,ARI,379,158,85,89,17,42,Loss,56,187,1,2,0,DET,59,435,345,6,Loss
0.3,0.28571428600000004,26.8,2015-10-11,20,18,away,24,DAL,247,163,64,55,30,6,Win,109,102,5,3,2,NEP,36,356,265,0,Win
0.28571428600000004,0.3,33.2,2015-10-11,18,20,home,-24,NEP,163,247,50,66,6,30,Loss,102,109,3,5,0,DAL,36,265,356,2,Loss
0.153846154,0.4375,25.85,2015-10-11,15,20,away,6,OAK,254,223,103,55,16,10,Win,43,65,2,4,3,DEN,26,297,288,2,Win
0.4375,0.153846154,34.15,2015-10-11,20,15,home,-6,DEN,223,254,41,68,10,16,Loss,65,43,4,2,2,OAK,26,288,297,3,Loss
0.571428571,0.642857143,28.03333333,2015-10-11,22,30,away,-3,NYG,256,441,28,64,27,30,Loss,124,84,2,0,1,SFO,57,380,525,0,Loss
0.642857143,0.571428571,31.96666667,2015-10-11,30,22,home,3,SFO,441,256,65,75,30,27,Win,84,124,0,2,0,NYG,57,525,380,1,Win
0.35714285700000004,0.28571428600000004,26.28333333,2015-10-12,14,24,away,4,LAC,194,354,86,56,24,20,Win,155,52,3,2,2,PIT,44,349,406,1,Win
0.28571428600000004,0.35714285700000004,33.71666667,2015-10-12,24,14,home,-4,PIT,354,194,54,69,20,24,Loss,52,155,2,3,1,LAC,44,406,349,2,Loss
0.25,0.5,27.5,2015-10-15,23,25,away,-10,NOS,263,304,41,70,21,31,Loss,150,81,5,1,0,ATL,52,413,385,3,Loss
0.5,0.25,32.5,2015-10-15,25,23,home,10,ATL,304,263,15,72,31,21,Win,81,150,1,5,3,NOS,52,385,413,0,Win
0.333333333,0.5,27.35,2015-10-18,14,22,away,-14,NYJ,191,253,15,62,20,34,Loss,34,221,1,0,3,WAS,54,225,474,2,Loss
0.5,0.333333333,32.65,2015-10-18,22,14,home,14,WAS,253,191,5,67,34,20,Win,221,34,0,1,2,NYJ,54,474,225,3,Win
0.41666666700000005,0.25,31.15,2015-10-18,21,14,away,-12,PIT,414,169,111,66,13,25,Loss,55,141,1,1,0,ARI,38,469,310,3,Loss
0.25,0.41666666700000005,28.85,2015-10-18,14,21,home,12,ARI,169,414,48,53,25,13,Win,141,55,1,1,3,PIT,38,310,469,0,Win
0.25,0.352941176,26.88333333,2015-10-18,16,16,away,-6,MIN,271,237,95,57,10,16,Loss,57,84,2,2,2,KCC,26,328,321,1,Loss
0.352941176,0.25,33.11666667,2015-10-18,16,16,home,6,KCC,237,271,50,68,16,10,Win,84,57,2,2,1,MIN,26,321,328,2,Win
0.583333333,0.384615385,30.0,2015-10-18,21,22,away,13,BUF,243,256,20,61,34,21,Win,112,112,0,2,1,CIN,55,355,368,0,Win
0.384615385,0.583333333,30.0,2015-10-18,22,21,home,-13,CIN,256,243,93,67,21,34,Loss,112,112,2,0,0,BUF,55,368,355,1,Loss
0.428571429,0.529411765,33.56666667,2015-10-18,24,26,away,-3,DET,353,391,76,73,0,3,Loss,91,155,1,2,3,CHI,3,444,546,1,Loss
0.529411765,0.428571429,38.95,2015-10-18,26,24,home,3,CHI,391,353,98,76,3,0,Win,155,91,2,1,1,DET,3,546,444,3,Loss
0.222222222,0.4,36.9,2015-10-18,21,20,away,3,CLE,290,189,81,81,3,0,Win,152,109,0,4,3,DEN,3,442,298,3,Win
0.4,0.222222222,33.16666667,2015-10-18,20,21,home,-3,DEN,189,290,30,76,0,3,Loss,109,152,4,0,3,CLE,3,298,442,3,Loss
0.5,0.333333333,30.03333333,2015-10-18,24,26,away,11,JAX,287,311,69,68,31,20,Win,95,83,1,3,3,HOU,51,382,394,0,Win
0.333333333,0.5,29.96666667,2015-10-18,26,24,home,-11,HOU,311,287,64,77,20,31,Loss,83,95,3,1,0,JAX,51,394,382,3,Loss
0.5555555560000001,0.2,31.88333333,2015-10-18,26,22,away,28,TEN,254,236,97,63,38,10,Win,180,63,2,6,4,MIA,48,434,299,2,Win
0.2,0.5555555560000001,28.11666667,2015-10-18,22,26,home,-28,MIA,236,254,50,65,10,38,Loss,63,180,6,2,2,TEN,48,299,434,4,Loss
0.363636364,0.28571428600000004,32.2,2015-10-18,25,14,away,4,SEA,248,219,25,72,27,23,Win,135,115,3,4,0,CAR,50,383,334,2,Loss
0.28571428600000004,0.363636364,27.8,2015-10-18,14,25,home,-4,CAR,219,248,48,60,23,27,Loss,115,135,4,3,2,SEA,50,334,383,0,Win
0.5,0.333333333,37.98333333,2015-10-18,32,17,away,-7,GBP,488,237,76,89,20,27,Loss,60,133,3,3,0,LAC,47,548,370,1,Loss
0.333333333,0.5,22.01666667,2015-10-18,17,32,home,7,LAC,237,488,50,49,27,20,Win,133,60,3,3,1,GBP,47,370,548,0,Win
0.307692308,0.384615385,33.11666667,2015-10-18,25,15,away,-5,SFO,343,326,15,75,20,25,Loss,77,65,0,3,0,BAL,45,420,391,2,Loss
0.384615385,0.307692308,26.88333333,2015-10-18,15,25,home,5,BAL,326,343,25,55,25,20,Win,65,77,3,0,2,SFO,45,391,420,0,Win
0.41666666700000005,0.4375,27.46666667,2015-10-18,22,24,away,7,IND,301,289,72,64,34,27,Win,116,120,2,3,0,NEP,61,417,409,1,Win
0.4375,0.41666666700000005,32.53333333,2015-10-18,24,22,home,-7,NEP,289,301,103,75,27,34,Loss,120,116,3,2,1,IND,61,409,417,0,Loss
0.307692308,0.375,29.6,2015-10-19,18,24,away,-20,PHI,166,270,94,64,7,27,Loss,81,158,3,1,4,NYG,34,247,428,3,Loss
0.375,0.307692308,30.4,2015-10-19,24,18,home,20,NYG,270,166,72,76,27,7,Win,158,81,1,3,3,PHI,34,428,247,4,Win
0.384615385,0.090909091,38.08333333,2015-10-22,21,8,away,17,SFO,212,81,50,70,20,3,Win,176,61,5,6,0,SEA,23,388,142,2,Win
0.090909091,0.384615385,21.91666667,2015-10-22,8,21,home,-17,SEA,81,212,33,45,3,20,Loss,61,176,6,5,2,SFO,23,142,388,0,Loss
0.25,0.35714285700000004,31.36666667,2015-10-25,26,17,away,-3,JAX,260,175,87,74,31,34,Loss,115,120,4,2,1,BUF,65,375,295,4,Loss
0.35714285700000004,0.25,28.63333333,2015-10-25,17,26,home,3,BUF,175,260,66,63,34,31,Win,120,115,2,4,4,JAX,65,295,375,1,Win
0.583333333,0.454545455,31.3,2015-10-25,21,27,away,-1,WAS,289,305,142,60,30,31,Loss,190,50,1,1,1,TBB,61,479,355,1,Loss
0.454545455,0.583333333,28.7,2015-10-25,27,21,home,1,TBB,305,289,20,60,31,30,Win,50,190,1,1,1,WAS,61,355,479,1,Loss
0.35714285700000004,0.111111111,34.75,2015-10-25,21,15,away,3,TEN,251,179,53,69,10,7,Win,127,77,0,1,2,ATL,17,378,256,2,Win
0.111111111,0.35714285700000004,25.25,2015-10-25,15,21,home,-3,ATL,179,251,45,52,7,10,Loss,77,127,1,0,2,TEN,17,256,378,2,Loss
0.35,0.23076923100000002,38.38333333,2015-10-25,22,15,away,6,IND,266,301,100,83,27,21,Win,183,75,2,4,3,NOS,48,449,376,1,Win
0.23076923100000002,0.35,21.61666667,2015-10-25,15,22,home,-6,NOS,301,266,42,61,21,27,Loss,75,183,4,2,1,IND,48,376,449,3,Loss
0.384615385,0.1,36.45,2015-10-25,25,14,away,9,DET,285,197,31,74,28,19,Win,140,77,4,7,0,MIN,47,425,274,1,Win
0.1,0.384615385,23.55,2015-10-25,14,25,home,-9,MIN,197,285,30,50,19,28,Loss,77,140,7,4,1,DET,47,274,425,0,Loss
0.2,0.5625,27.56666667,2015-10-25,18,18,away,-10,KCC,192,239,5,55,13,23,Loss,147,138,2,2,0,PIT,36,339,377,3,Loss
0.5625,0.2,32.43333333,2015-10-25,18,18,home,10,PIT,239,192,66,63,23,13,Win,138,147,2,2,3,KCC,36,377,339,0,Win
0.25,0.111111111,35.55,2015-10-25,19,16,away,-18,LAR,282,150,98,65,6,24,Loss,82,158,4,2,1,CLE,30,364,308,4,Loss
0.111111111,0.25,24.45,2015-10-25,16,19,home,18,CLE,150,282,75,51,24,6,Win,158,82,2,4,4,LAR,30,308,364,1,Win
0.4,0.111111111,27.91666667,2015-10-25,24,21,away,-18,MIA,251,255,25,78,26,44,Loss,71,248,4,4,1,HOU,70,322,503,1,Loss
0.111111111,0.4,32.08333333,2015-10-25,21,24,home,18,HOU,255,251,52,59,44,26,Win,248,71,4,4,1,MIA,70,503,322,1,Win
0.571428571,0.5,33.05,2015-10-25,25,20,away,-7,NEP,283,337,29,70,23,30,Loss,89,16,2,3,0,NYJ,53,372,353,1,Loss
0.5,0.571428571,26.95,2015-10-25,20,25,home,7,NYJ,337,283,38,66,30,23,Win,16,89,3,2,1,NEP,53,353,372,0,Win
0.41666666700000005,0.5,30.81666667,2015-10-25,19,28,away,8,LAC,282,327,136,58,37,29,Win,130,90,1,1,2,OAK,66,412,417,0,Win
0.5,0.41666666700000005,29.18333333,2015-10-25,28,19,home,-8,OAK,327,282,86,80,29,37,Loss,90,130,1,1,0,LAC,66,417,412,2,Loss
0.545454545,0.272727273,38.06666667,2015-10-25,27,13,away,-7,NYG,227,157,46,69,20,27,Loss,233,132,1,2,0,DAL,47,460,289,4,Loss
0.272727273,0.545454545,21.93333333,2015-10-25,13,27,home,7,DAL,157,227,13,51,27,20,Win,132,233,2,1,4,NYG,47,289,460,0,Win
0.38888888899999996,0.222222222,31.1,2015-10-25,20,21,away,-11,CAR,172,190,46,81,16,27,Loss,177,204,5,1,3,PHI,43,349,394,1,Loss
0.222222222,0.38888888899999996,28.9,2015-10-25,21,20,home,11,PHI,190,172,43,58,27,16,Win,204,177,1,5,1,CAR,43,394,349,3,Win
0.384615385,0.41666666700000005,30.4,2015-10-26,18,21,away,-8,ARI,221,264,64,59,18,26,Loss,55,150,3,2,0,BAL,44,276,414,2,Loss
0.41666666700000005,0.384615385,29.6,2015-10-26,21,18,home,8,BAL,264,221,40,59,26,18,Win,150,55,2,3,2,ARI,44,414,276,0,Win
0.181818182,0.25,27.38333333,2015-10-29,18,24,away,-29,NEP,255,342,40,62,7,36,Loss,15,95,5,2,0,MIA,43,270,437,2,Loss
0.25,0.181818182,32.61666667,2015-10-29,24,18,home,29,MIA,342,255,69,66,36,7,Win,95,15,2,5,2,NEP,43,437,270,0,Win
0.166666667,0.615384615,25.76666667,2015-11-01,16,24,away,-35,KCC,195,134,81,58,10,45,Loss,81,206,6,3,0,DET,55,276,340,2,Loss
0.615384615,0.166666667,34.23333333,2015-11-01,24,16,home,35,DET,134,195,20,63,45,10,Win,206,81,3,6,2,KCC,55,340,276,0,Win
0.46153846200000004,0.5,30.18333333,2015-11-01,21,28,away,3,ATL,173,395,43,63,3,0,Win,117,101,2,1,4,TBB,3,290,496,0,Win
0.5,0.46153846200000004,39.08333333,2015-11-01,28,21,home,-3,TBB,395,173,124,73,0,3,Loss,101,117,1,2,0,ATL,3,496,290,4,Loss
0.8125,0.5625,34.38333333,2015-11-01,25,16,away,14,CLE,372,215,25,77,34,20,Win,119,39,1,1,2,ARI,54,491,254,4,Win
0.5625,0.8125,25.61666667,2015-11-01,16,25,home,-14,ARI,215,372,35,61,20,34,Loss,39,119,1,1,4,CLE,54,254,491,2,Loss
0.176470588,0.083333333,28.03333333,2015-11-01,11,16,away,-21,LAR,151,191,93,65,6,27,Loss,38,197,3,0,1,SFO,33,189,388,0,Loss
0.083333333,0.176470588,31.96666667,2015-11-01,16,11,home,21,SFO,191,151,93,64,27,6,Win,197,38,0,3,0,LAR,33,388,189,1,Win
0.125,0.636363636,25.08333333,2015-11-01,28,35,away,-3,NOS,329,505,53,65,49,52,Loss,87,103,3,0,2,NYG,101,416,608,1,Loss
0.636363636,0.125,34.91666667,2015-11-01,35,28,home,3,NYG,505,329,93,76,52,49,Win,103,87,0,3,1,NOS,101,608,416,2,Win
0.41666666700000005,0.25,27.3,2015-11-01,17,18,away,3,CHI,180,208,35,56,23,20,Win,147,97,1,1,0,MIN,43,327,305,1,Win
0.25,0.41666666700000005,32.7,2015-11-01,18,17,home,-3,MIN,208,180,38,59,20,23,Loss,97,147,1,1,1,CHI,43,305,327,0,Loss
0.538461538,0.41666666700000005,30.1,2015-11-01,22,23,away,-3,BAL,290,293,66,64,26,29,Loss,81,72,1,3,0,LAC,55,371,365,0,Win
0.41666666700000005,0.538461538,29.9,2015-11-01,23,22,home,3,LAC,293,290,46,65,29,26,Win,72,81,3,1,0,BAL,55,365,371,0,Loss
0.26666666699999997,0.272727273,29.85,2015-11-01,16,21,away,6,PIT,218,240,94,64,16,10,Win,78,116,3,3,3,CIN,26,296,356,2,Win
0.272727273,0.26666666699999997,30.15,2015-11-01,21,16,home,-6,CIN,240,218,91,67,10,16,Loss,116,78,3,3,2,PIT,26,356,296,3,Loss
0.083333333,0.26666666699999997,31.13333333,2015-11-01,15,14,away,-14,HOU,125,214,45,58,6,20,Loss,86,56,7,3,0,TEN,26,211,270,3,Loss
0.26666666699999997,0.083333333,28.86666667,2015-11-01,14,15,home,14,TEN,214,125,85,61,20,6,Win,56,86,3,7,3,HOU,26,270,211,0,Win
0.4375,0.4,29.36666667,2015-11-01,22,21,away,-14,OAK,292,333,40,71,20,34,Loss,74,118,3,0,0,NYJ,54,366,451,1,Loss
0.4,0.4375,30.63333333,2015-11-01,21,22,home,14,NYJ,333,292,61,61,34,20,Win,118,74,0,3,1,OAK,54,451,366,0,Win
0.41666666700000005,0.28571428600000004,29.63333333,2015-11-01,19,14,away,1,DAL,210,91,40,61,13,12,Win,113,129,0,1,0,SEA,25,323,220,1,Win
0.28571428600000004,0.41666666700000005,30.36666667,2015-11-01,14,19,home,-1,SEA,91,210,40,57,12,13,Loss,129,113,1,0,1,DAL,25,220,323,0,Win
0.25,0.5,26.55,2015-11-01,14,24,away,-19,DEN,50,340,15,46,10,29,Loss,90,160,3,0,1,GBP,39,140,500,0,Loss
0.5,0.25,33.45,2015-11-01,24,14,home,19,GBP,340,50,93,63,29,10,Win,160,90,0,3,0,DEN,39,500,140,1,Win
0.333333333,0.25,36.0,2015-11-02,19,17,away,-3,CAR,223,239,15,84,3,6,Loss,136,140,2,2,3,IND,9,359,379,4,Loss
0.25,0.333333333,33.63333333,2015-11-02,17,19,home,3,IND,239,223,55,73,6,3,Win,140,136,2,2,4,CAR,9,379,359,3,Loss
0.307692308,0.571428571,23.95,2015-11-05,13,23,away,-21,CIN,144,219,28,53,10,31,Loss,69,152,3,2,0,CLE,41,213,371,0,Loss
0.571428571,0.307692308,36.05,2015-11-05,23,13,home,21,CLE,219,144,20,66,31,10,Win,152,69,2,3,0,CIN,41,371,213,0,Win
0.214285714,0.333333333,27.8,2015-11-08,21,20,away,-8,CAR,331,297,87,72,29,37,Loss,71,130,5,0,1,GBP,66,402,427,2,Loss
0.333333333,0.214285714,32.2,2015-11-08,20,21,home,8,GBP,297,331,45,66,37,29,Win,130,71,0,5,2,CAR,66,427,402,1,Win
0.5,0.5625,22.91666667,2015-11-08,16,27,away,-17,NEP,213,299,27,56,10,27,Loss,37,161,1,0,2,WAS,37,250,460,2,Loss
0.5625,0.5,37.08333333,2015-11-08,27,16,home,17,WAS,299,213,43,76,27,10,Win,161,37,0,1,2,NEP,37,460,250,2,Win
0.384615385,0.545454545,32.35,2015-11-08,25,30,away,6,NOS,371,355,66,67,6,0,Win,112,61,0,4,2,TEN,6,483,416,1,Win
0.545454545,0.384615385,32.81666667,2015-11-08,30,25,home,-6,TEN,355,371,75,70,0,6,Loss,61,112,4,0,1,NOS,6,416,483,2,Loss
0.444444444,0.615384615,28.78333333,2015-11-08,29,18,away,-16,BUF,289,154,62,62,17,33,Loss,108,266,2,3,0,MIA,50,397,420,1,Loss
0.615384615,0.444444444,31.21666667,2015-11-08,18,29,home,16,MIA,154,289,94,51,33,17,Win,266,108,3,2,1,BUF,50,420,397,0,Win
0.125,0.23076923100000002,32.45,2015-11-08,18,21,away,-3,MIN,160,148,87,70,0,3,Loss,160,145,1,1,1,LAR,3,320,293,0,Loss
0.23076923100000002,0.125,33.21666667,2015-11-08,21,18,home,3,LAR,148,160,67,63,3,0,Win,145,160,1,1,0,MIN,3,293,320,1,Win
0.4375,0.333333333,29.26666667,2015-11-08,19,14,away,-5,NYJ,338,261,30,65,23,28,Loss,98,29,6,2,0,JAX,51,436,290,4,Loss
0.333333333,0.4375,30.73333333,2015-11-08,14,19,home,5,JAX,261,338,41,64,28,23,Win,29,98,2,6,4,NYJ,51,290,436,0,Win
0.428571429,0.352941176,27.93333333,2015-11-08,24,27,away,-3,PIT,301,402,21,69,35,38,Loss,139,195,0,1,2,OAK,73,440,597,4,Loss
0.352941176,0.428571429,32.06666667,2015-11-08,27,24,home,3,OAK,402,301,42,81,38,35,Win,195,139,1,0,4,PIT,73,597,440,2,Loss
0.5625,0.46153846200000004,34.91666667,2015-11-08,24,19,away,14,TBB,213,247,49,73,32,18,Win,114,136,0,0,3,NYG,50,327,383,2,Win
0.46153846200000004,0.5625,25.08333333,2015-11-08,19,24,home,-14,NYG,247,213,79,59,18,32,Loss,136,114,0,0,2,TBB,50,383,327,3,Loss
0.333333333,0.428571429,32.13333333,2015-11-08,17,18,away,-1,SFO,285,185,63,61,16,17,Loss,17,133,2,0,2,ATL,33,302,318,0,Win
0.428571429,0.333333333,27.86666667,2015-11-08,18,17,home,1,ATL,185,285,30,64,17,16,Win,133,17,0,2,0,SFO,33,318,302,2,Loss
0.5,0.6,21.35,2015-11-08,16,27,away,-3,IND,274,245,56,51,24,27,Loss,35,120,1,1,0,DEN,51,309,365,2,Loss
0.6,0.5,38.65,2015-11-08,27,16,home,3,DEN,245,274,30,77,27,24,Win,120,35,1,1,2,IND,51,365,309,0,Win
0.23076923100000002,0.5,25.7,2015-11-08,25,25,away,6,DAL,287,277,70,72,6,0,Win,172,134,1,4,1,PHI,6,459,411,0,Win
0.5,0.23076923100000002,38.31666667,2015-11-08,25,25,home,-6,PHI,277,287,58,71,0,6,Loss,134,172,4,1,0,DAL,6,411,459,1,Loss
0.6,0.538461538,33.58333333,2015-11-09,25,19,away,3,LAC,337,262,55,70,22,19,Win,109,77,1,2,1,CHI,41,446,339,2,Win
0.538461538,0.6,26.41666667,2015-11-09,19,25,home,-3,CHI,262,337,54,63,19,22,Loss,77,109,2,1,2,LAC,41,339,446,1,Loss
0.3125,0.23076923100000002,33.26666667,2015-11-12,13,15,away,5,NYJ,132,190,44,64,22,17,Win,148,128,4,1,4,BUF,39,280,318,0,Win
0.23076923100000002,0.3125,26.73333333,2015-11-12,15,13,home,-5,BUF,190,132,20,59,17,22,Loss,128,148,1,4,0,NYJ,39,318,280,4,Loss
0.3125,0.473684211,30.66666667,2015-11-15,16,22,away,2,GBP,242,325,35,64,18,16,Win,45,47,0,3,0,DET,34,287,372,1,Loss
0.473684211,0.3125,29.33333333,2015-11-15,22,16,home,-2,DET,325,242,55,82,16,18,Loss,47,45,3,0,1,GBP,34,372,287,0,Win
0.307692308,0.333333333,30.06666667,2015-11-15,12,23,away,-4,TBB,174,246,65,53,6,10,Loss,42,84,3,2,2,DAL,16,216,330,1,Loss
0.333333333,0.307692308,29.93333333,2015-11-15,23,12,home,4,DAL,246,174,62,67,10,6,Win,84,42,2,3,1,TBB,16,330,216,2,Loss
0.538461538,0.41666666700000005,35.91666667,2015-11-15,24,11,away,17,TEN,184,178,45,64,27,10,Win,119,64,5,1,2,CAR,37,303,242,0,Win
0.41666666700000005,0.538461538,24.08333333,2015-11-15,11,24,home,-17,CAR,178,184,30,46,10,27,Loss,64,119,1,5,0,TEN,37,242,303,2,Loss
0.25,0.28571428600000004,34.36666667,2015-11-15,17,12,away,24,LAR,244,191,44,63,37,13,Win,153,94,2,1,2,CHI,50,397,285,2,Win
0.28571428600000004,0.25,25.63333333,2015-11-15,12,17,home,-24,CHI,191,244,57,59,13,37,Loss,94,153,1,2,2,LAR,50,285,397,2,Loss
0.363636364,0.545454545,26.43333333,2015-11-15,16,23,away,-33,WAS,192,301,50,55,14,47,Loss,158,209,2,3,0,NOS,61,350,510,2,Loss
0.545454545,0.363636364,33.56666667,2015-11-15,23,16,home,33,NOS,301,192,26,59,47,14,Win,209,158,3,2,2,WAS,61,510,350,0,Win
0.333333333,0.38888888899999996,28.88333333,2015-11-15,15,29,away,1,PHI,190,353,84,66,20,19,Win,99,83,4,4,1,MIA,39,289,436,0,Loss
0.38888888899999996,0.333333333,31.11666667,2015-11-15,29,15,home,-1,MIA,353,190,54,87,19,20,Loss,83,99,4,4,0,PHI,39,436,289,1,Loss
0.384615385,0.3,32.71666667,2015-11-15,20,22,away,-21,PIT,327,399,188,65,9,30,Loss,15,60,6,1,2,CLE,39,342,459,3,Loss
0.3,0.384615385,27.28333333,2015-11-15,22,20,home,21,CLE,399,327,50,59,30,9,Win,60,15,1,6,3,PIT,39,459,342,2,Win
0.25,0.571428571,30.53333333,2015-11-15,22,22,away,2,BAL,168,308,30,70,22,20,Win,90,89,3,1,4,JAX,42,258,397,1,Loss
0.571428571,0.25,29.46666667,2015-11-15,22,22,home,-2,JAX,308,168,121,67,20,22,Loss,89,90,1,3,1,BAL,42,397,258,4,Loss
0.363636364,0.5,33.01666667,2015-11-15,21,20,away,16,OAK,122,287,15,59,30,14,Win,263,84,4,2,2,MIN,44,385,371,0,Win
0.5,0.363636364,26.98333333,2015-11-15,20,21,home,-16,MIN,287,122,82,64,14,30,Loss,84,263,2,4,0,OAK,44,371,385,2,Loss
0.5,0.46666666700000003,31.6,2015-11-15,22,21,away,1,NYG,329,342,93,68,27,26,Win,77,80,3,3,1,NEP,53,406,422,2,Loss
0.46666666700000003,0.5,28.4,2015-11-15,21,22,home,-1,NEP,342,329,49,70,26,27,Loss,80,77,3,3,2,NYG,53,422,406,1,Loss
0.25,0.214285714,33.45,2015-11-15,13,18,away,16,DEN,197,152,102,65,29,13,Win,106,69,2,5,5,KCC,42,303,221,0,Win
0.214285714,0.25,26.55,2015-11-15,18,13,home,-16,KCC,152,197,55,65,13,29,Loss,69,106,5,2,0,DEN,42,221,303,5,Loss
0.470588235,0.125,38.86666667,2015-11-15,30,18,away,7,SEA,334,228,66,83,39,32,Win,117,115,3,2,1,ARI,71,451,343,3,Win
0.125,0.470588235,21.13333333,2015-11-15,18,30,home,-7,ARI,228,334,131,52,32,39,Loss,115,117,2,3,3,SEA,71,343,451,1,Loss
0.333333333,0.28571428600000004,28.56666667,2015-11-16,16,16,away,4,CIN,174,182,54,61,10,6,Win,82,74,3,4,2,HOU,16,256,256,1,Win
0.28571428600000004,0.333333333,31.43333333,2015-11-16,16,16,home,-4,HOU,182,174,70,62,6,10,Loss,74,82,4,3,1,CIN,16,256,256,2,Loss
0.384615385,0.307692308,31.58333333,2015-11-19,22,18,away,-6,JAX,212,218,59,65,13,19,Loss,104,90,4,4,2,TEN,32,316,308,1,Loss
0.307692308,0.384615385,28.41666667,2015-11-19,18,22,home,6,TEN,218,212,88,58,19,13,Win,90,104,4,4,1,JAX,32,308,316,2,Win
0.363636364,0.428571429,23.96666667,2015-11-22,13,22,away,-5,DET,164,266,31,47,13,18,Loss,52,109,1,4,0,OAK,31,216,375,0,Loss
0.428571429,0.363636364,36.03333333,2015-11-22,22,13,home,5,OAK,266,164,55,70,18,13,Win,109,52,4,1,0,DET,31,375,216,0,Win
0.5,0.5,32.65,2015-11-22,17,21,away,3,ATL,202,275,42,61,24,21,Win,74,100,2,1,4,IND,45,276,375,3,Win
0.5,0.5,27.35,2015-11-22,21,17,home,-3,IND,275,202,69,71,21,24,Loss,100,74,1,2,3,ATL,45,375,276,4,Loss
0.214285714,0.38888888899999996,26.68333333,2015-11-22,16,19,away,-7,HOU,197,241,54,63,17,24,Loss,70,123,3,1,1,NYJ,41,267,364,2,Loss
0.38888888899999996,0.214285714,33.31666667,2015-11-22,19,16,home,7,NYJ,241,197,54,73,24,17,Win,123,70,1,3,2,HOU,41,364,267,1,Win
0.625,0.46666666700000003,35.9,2015-11-22,25,21,away,28,PHI,238,247,82,72,45,17,Win,283,136,1,3,4,TBB,62,521,383,1,Win
0.46666666700000003,0.625,24.1,2015-11-22,21,25,home,-28,TBB,247,238,25,72,17,45,Loss,136,283,3,1,1,PHI,62,383,521,4,Loss
0.428571429,0.333333333,33.21666667,2015-11-22,21,19,away,2,CHI,219,261,118,68,17,15,Win,170,86,5,2,2,DEN,32,389,347,0,Win
0.333333333,0.428571429,26.78333333,2015-11-22,19,21,home,-2,DEN,261,219,0,59,15,17,Loss,86,170,2,5,0,CHI,32,347,389,2,Loss
0.23076923100000002,0.25,27.13333333,2015-11-22,13,16,away,-3,BAL,131,292,35,56,13,16,Loss,82,96,1,1,2,LAR,29,213,388,4,Loss
0.25,0.23076923100000002,32.86666667,2015-11-22,16,13,home,3,LAR,292,131,137,73,16,13,Win,96,82,1,1,4,BAL,29,388,213,2,Win
0.5,0.1,38.83333333,2015-11-22,22,9,away,10,MIA,220,140,79,68,24,14,Win,166,70,2,3,1,DAL,38,386,210,2,Win
0.1,0.5,21.16666667,2015-11-22,9,22,home,-10,DAL,140,220,74,41,14,24,Loss,70,166,3,2,2,MIA,38,210,386,1,Loss
0.222222222,0.5,21.88333333,2015-11-22,9,27,away,-28,CAR,172,226,68,47,16,44,Loss,14,142,5,2,0,WAS,60,186,368,5,Loss
0.5,0.222222222,38.11666667,2015-11-22,27,9,home,28,WAS,226,172,66,75,44,16,Win,142,14,2,5,5,CAR,60,368,186,0,Win
0.41666666700000005,0.307692308,33.46666667,2015-11-22,22,14,away,30,LAC,232,149,35,59,33,3,Win,153,52,3,3,2,KCC,36,385,201,0,Win
0.307692308,0.41666666700000005,26.53333333,2015-11-22,14,22,home,-30,KCC,149,232,39,58,3,33,Loss,52,153,3,3,0,LAC,36,201,385,2,Loss
0.375,0.384615385,30.36666667,2015-11-22,19,16,away,17,MIN,196,248,19,70,30,13,Win,124,94,2,6,1,GBP,43,320,342,0,Win
0.384615385,0.375,29.63333333,2015-11-22,16,19,home,-17,GBP,248,196,110,62,13,30,Loss,94,124,6,2,0,MIN,43,342,320,1,Loss
0.181818182,0.571428571,22.35,2015-11-22,14,28,away,-16,SEA,247,253,42,52,13,29,Loss,59,255,2,2,0,SFO,42,306,508,0,Loss
0.571428571,0.181818182,37.65,2015-11-22,28,14,home,16,SFO,253,247,51,75,29,13,Win,255,59,2,2,0,SEA,42,508,306,0,Win
0.384615385,0.454545455,31.25,2015-11-22,24,21,away,-3,ARI,278,301,108,71,31,34,Loss,99,82,4,2,2,CIN,65,377,383,1,Loss
0.454545455,0.384615385,28.75,2015-11-22,21,24,home,3,CIN,301,278,40,58,34,31,Win,82,99,2,4,1,ARI,65,383,377,2,Win
0.2,0.28571428600000004,32.91666667,2015-11-23,16,18,away,-7,NEP,225,271,44,68,13,20,Loss,94,85,2,1,1,BUF,33,319,356,1,Loss
0.28571428600000004,0.2,27.08333333,2015-11-23,18,16,home,7,BUF,271,225,61,62,20,13,Win,85,94,1,2,1,NEP,33,356,319,1,Win
0.428571429,0.5,22.81666667,2015-11-26,14,28,away,-31,DET,159,322,30,58,14,45,Loss,68,108,6,2,0,PHI,59,227,430,1,Loss
0.5,0.428571429,37.18333333,2015-11-26,28,14,home,31,PHI,322,159,29,70,45,14,Win,108,68,2,6,1,DET,59,430,227,0,Win
0.5,0.46153846200000004,35.23333333,2015-11-26,18,14,away,19,DAL,165,179,53,65,33,14,Win,129,31,1,2,3,CAR,47,294,210,0,Win
0.46153846200000004,0.5,24.76666667,2015-11-26,14,18,home,-19,CAR,179,165,40,56,14,33,Loss,31,129,2,1,0,DAL,47,210,294,3,Loss
0.35714285700000004,0.272727273,31.2,2015-11-26,17,23,away,4,GBP,189,188,95,63,17,13,Win,101,177,1,2,2,CHI,30,290,365,0,Win
0.272727273,0.35714285700000004,28.8,2015-11-26,23,17,home,-4,CHI,188,189,38,73,13,17,Loss,177,101,2,1,0,GBP,30,365,290,2,Loss
0.25,0.46153846200000004,23.61666667,2015-11-29,14,23,away,-18,HOU,218,195,82,56,6,24,Loss,50,167,2,1,1,NOS,30,268,362,1,Loss
0.46153846200000004,0.25,36.38333333,2015-11-29,23,14,home,18,NOS,195,218,40,66,24,6,Win,167,50,1,2,1,HOU,30,362,268,1,Win
0.4,0.3,29.88333333,2015-11-29,19,19,away,-24,CIN,251,236,45,71,7,31,Loss,94,140,1,0,1,LAR,38,345,376,3,Loss
0.3,0.4,30.11666667,2015-11-29,19,19,home,24,LAR,236,251,35,59,31,7,Win,140,94,0,1,3,CIN,38,376,345,1,Win
0.583333333,0.454545455,33.46666667,2015-11-29,24,22,away,10,ATL,174,210,53,67,20,10,Win,191,116,0,2,3,MIN,30,365,326,1,Win
0.454545455,0.583333333,26.53333333,2015-11-29,22,24,home,-10,MIN,210,174,78,57,10,20,Loss,116,191,2,0,1,ATL,30,326,365,3,Loss
0.2,0.26666666699999997,24.0,2015-11-29,17,18,away,-6,WAS,299,302,35,67,14,20,Loss,33,105,3,0,0,NYG,34,332,407,3,Loss
0.26666666699999997,0.2,36.0,2015-11-29,18,17,home,6,NYG,302,299,80,66,20,14,Win,105,33,0,3,3,WAS,34,407,332,0,Win
0.46153846200000004,0.4375,27.58333333,2015-11-29,21,23,away,-13,IND,212,309,95,62,12,25,Loss,132,27,5,3,0,TBB,37,344,336,1,Loss
0.4375,0.46153846200000004,32.41666667,2015-11-29,23,21,home,13,TBB,309,212,45,71,25,12,Win,27,132,3,5,1,IND,37,336,344,0,Win
0.41666666700000005,0.46153846200000004,30.53333333,2015-11-29,25,21,away,-8,KCC,286,255,91,67,22,30,Loss,129,158,1,1,0,BUF,52,415,413,2,Loss
0.46153846200000004,0.41666666700000005,29.46666667,2015-11-29,21,25,home,8,BUF,255,286,58,58,30,22,Win,158,129,1,1,2,KCC,52,413,415,0,Win
0.533333333,0.25,34.91666667,2015-11-29,22,19,away,3,TEN,323,205,94,69,24,21,Win,84,44,1,2,2,OAK,45,407,249,2,Loss
0.25,0.533333333,25.08333333,2015-11-29,19,22,home,-3,OAK,205,323,25,57,21,24,Loss,44,84,2,1,2,TEN,45,249,407,2,Loss
0.428571429,0.333333333,31.4,2015-11-29,24,20,away,6,JAX,290,318,70,71,31,25,Win,79,102,2,2,1,LAC,56,369,420,0,Win
0.333333333,0.428571429,28.6,2015-11-29,20,24,home,-6,LAC,318,290,35,70,25,31,Loss,102,79,2,2,0,JAX,56,420,369,1,Loss
0.26666666699999997,0.588235294,28.73333333,2015-11-29,20,24,away,-18,NYJ,321,274,45,70,20,38,Loss,12,137,3,1,0,MIA,58,333,411,2,Loss
0.588235294,0.26666666699999997,31.26666667,2015-11-29,24,20,home,18,MIA,274,321,40,72,38,20,Win,137,12,1,3,2,NYJ,58,411,333,0,Win
0.5,0.0,37.45,2015-11-29,26,17,away,6,SFO,267,301,47,70,19,13,Win,70,67,1,2,2,ARI,32,337,368,0,Win
0.0,0.5,22.55,2015-11-29,17,26,home,-6,ARI,301,267,81,55,13,19,Loss,67,70,2,1,0,SFO,32,368,337,2,Loss
0.454545455,0.538461538,32.0,2015-11-29,26,21,away,-9,SEA,480,336,65,75,30,39,Loss,58,100,2,2,0,PIT,69,538,436,4,Loss
0.538461538,0.454545455,28.0,2015-11-29,21,26,home,9,PIT,336,480,76,59,39,30,Win,100,58,2,2,4,SEA,69,436,538,0,Win
0.153846154,0.25,25.95,2015-11-29,16,23,away,-6,DEN,262,254,47,61,0,6,Loss,39,179,3,3,1,NEP,6,301,433,1,Loss
0.25,0.153846154,36.51666667,2015-11-29,23,16,home,6,NEP,254,262,46,77,6,0,Win,179,39,3,3,1,DEN,6,433,301,1,Win
0.181818182,0.26666666699999997,29.5,2015-11-30,16,21,away,6,CLE,232,275,50,57,33,27,Win,104,63,0,2,0,BAL,60,336,338,2,Win
0.26666666699999997,0.181818182,30.5,2015-11-30,21,16,home,-6,BAL,275,232,15,68,27,33,Loss,63,104,2,0,2,CLE,60,338,336,0,Loss
0.25,0.375,26.93333333,2015-12-03,19,17,away,4,DET,246,205,55,63,27,23,Win,67,101,3,3,1,GBP,50,313,306,1,Win
0.375,0.25,33.06666667,2015-12-03,17,19,home,-4,GBP,205,246,108,63,23,27,Loss,101,67,3,3,1,DET,50,306,313,1,Loss
0.4,0.26666666699999997,38.51666667,2015-12-06,28,14,away,3,NYG,373,281,61,77,3,0,Win,90,74,3,3,1,NYJ,3,463,355,1,Win
0.26666666699999997,0.4,29.93333333,2015-12-06,14,28,home,-3,NYJ,281,373,60,61,0,3,Loss,74,90,3,3,1,NYG,3,355,463,1,Loss
0.4375,0.083333333,39.78333333,2015-12-06,29,9,away,24,LAR,349,146,25,79,27,3,Win,175,66,2,0,1,ARI,30,524,212,0,Win
0.083333333,0.4375,20.21666667,2015-12-06,9,29,home,-24,ARI,146,349,104,50,3,27,Loss,66,175,0,2,0,LAR,30,212,524,1,Loss
0.5,0.545454545,28.75,2015-12-06,21,25,away,-4,TBB,255,222,58,66,19,23,Loss,64,166,3,1,2,ATL,42,319,388,1,Loss
0.545454545,0.5,31.25,2015-12-06,25,21,home,4,ATL,222,255,53,65,23,19,Win,166,64,1,3,1,TBB,42,388,319,2,Win
0.692307692,0.2,35.16666667,2015-12-06,25,9,away,31,MIN,260,94,65,66,38,7,Win,173,31,2,4,1,SEA,45,433,125,1,Win
0.2,0.692307692,24.83333333,2015-12-06,9,25,home,-31,SEA,94,260,95,48,7,38,Loss,31,173,4,2,1,MIN,45,125,433,1,Loss
0.46666666700000003,0.5,31.88333333,2015-12-06,21,15,away,-9,BUF,275,203,89,71,21,30,Loss,126,187,2,1,0,HOU,51,401,390,1,Loss
0.5,0.46666666700000003,28.11666667,2015-12-06,15,21,home,9,HOU,203,275,42,58,30,21,Win,187,126,1,2,1,BUF,51,390,401,0,Win
0.35714285700000004,0.307692308,38.15,2015-12-06,22,8,away,-2,MIA,281,82,36,75,13,15,Loss,94,137,3,1,1,BAL,28,375,219,2,Win
0.307692308,0.35714285700000004,21.85,2015-12-06,8,22,home,2,BAL,82,281,31,46,15,13,Win,137,94,1,3,2,MIA,28,219,375,1,Win
0.41666666700000005,0.46153846200000004,30.96666667,2015-12-06,20,18,away,34,CLE,233,205,55,56,37,3,Win,144,68,1,3,2,CIN,40,377,273,0,Win
0.46153846200000004,0.41666666700000005,29.03333333,2015-12-06,18,20,home,-34,CIN,205,233,84,60,3,37,Loss,68,144,3,1,0,CLE,40,273,377,2,Loss
0.7142857140000001,0.615384615,26.43333333,2015-12-06,20,26,away,-3,TEN,302,257,21,59,39,42,Loss,81,210,2,4,2,JAX,81,383,467,1,Loss
0.615384615,0.7142857140000001,33.56666667,2015-12-06,26,20,home,3,JAX,257,302,38,68,42,39,Win,210,81,4,2,1,TEN,81,467,383,2,Loss
0.4375,0.470588235,24.76666667,2015-12-06,13,20,away,6,CHI,170,194,50,59,6,0,Win,121,170,4,1,1,SFO,6,291,364,0,Win
0.470588235,0.4375,37.4,2015-12-06,20,13,home,-6,SFO,194,170,72,74,0,6,Loss,170,121,1,4,0,CHI,6,364,291,1,Loss
0.46153846200000004,0.35714285700000004,32.95,2015-12-06,19,15,away,14,LAC,159,179,18,66,17,3,Win,134,93,1,4,3,DEN,20,293,272,1,Win
0.35714285700000004,0.46153846200000004,27.05,2015-12-06,15,19,home,-14,DEN,179,159,72,62,3,17,Loss,93,134,4,1,1,LAC,20,272,293,3,Loss
0.375,0.428571429,25.53333333,2015-12-06,15,27,away,14,OAK,143,262,88,48,34,20,Win,89,99,4,4,3,KCC,54,232,361,2,Win
0.428571429,0.375,34.46666667,2015-12-06,27,15,home,-14,KCC,262,143,21,76,20,34,Loss,99,89,4,4,2,OAK,54,361,232,3,Loss
0.375,0.3,36.56666667,2015-12-06,33,21,away,3,NOS,322,264,87,76,41,38,Win,175,70,1,2,1,CAR,79,497,334,3,Win
0.3,0.375,23.43333333,2015-12-06,21,33,home,-3,CAR,264,322,104,58,38,41,Loss,70,175,2,1,3,NOS,79,334,497,1,Win
0.428571429,0.41176470600000004,25.73333333,2015-12-06,15,27,away,7,NEP,120,324,97,58,35,28,Win,128,103,1,4,2,PHI,63,248,427,1,Win
0.41176470600000004,0.428571429,34.26666667,2015-12-06,27,15,home,-7,PHI,324,120,30,86,28,35,Loss,103,128,4,1,1,NEP,63,427,248,2,Loss
0.214285714,0.615384615,27.16666667,2015-12-06,11,24,away,-35,PIT,186,364,30,57,10,45,Loss,54,158,5,0,2,IND,55,240,522,3,Loss
0.615384615,0.214285714,32.83333333,2015-12-06,24,11,home,35,IND,364,186,48,71,45,10,Win,158,54,0,5,3,PIT,55,522,240,2,Win
0.111111111,0.375,27.21666667,2015-12-07,16,15,away,3,WAS,221,193,70,54,19,16,Win,97,73,1,3,1,DAL,35,318,266,3,Win
0.375,0.111111111,32.78333333,2015-12-07,15,16,home,-3,DAL,193,221,72,60,16,19,Loss,73,97,3,1,3,WAS,35,266,318,1,Loss
0.545454545,0.46153846200000004,28.01666667,2015-12-10,23,22,away,-3,ARI,317,296,25,63,20,23,Loss,72,97,3,2,0,MIN,43,389,393,3,Loss
0.46153846200000004,0.545454545,31.98333333,2015-12-10,22,23,home,3,MIN,296,317,30,66,23,20,Win,97,72,2,3,3,ARI,43,393,389,0,Win
0.375,0.5,35.03333333,2015-12-13,18,20,away,-3,PHI,260,232,101,69,20,23,Loss,152,116,1,1,1,BUF,43,412,348,2,Loss
0.5,0.375,24.96666667,2015-12-13,20,18,home,3,BUF,232,260,55,73,23,20,Win,116,152,1,1,2,PHI,43,348,412,1,Win
0.153846154,0.5,22.35,2015-12-13,15,28,away,-14,CLE,150,251,40,54,10,24,Loss,71,230,9,2,2,SFO,34,221,481,0,Loss
0.5,0.153846154,37.65,2015-12-13,28,15,home,14,SFO,251,150,71,74,24,10,Win,230,71,2,9,0,CLE,34,481,221,2,Win
0.384615385,0.363636364,33.83333333,2015-12-13,22,15,away,-7,LAR,220,114,45,70,14,21,Loss,111,203,4,1,1,DET,35,331,317,1,Loss
0.363636364,0.384615385,26.16666667,2015-12-13,15,22,home,7,DET,114,220,48,52,21,14,Win,203,111,1,4,1,LAR,35,317,331,1,Win
0.705882353,0.363636364,37.23333333,2015-12-13,26,18,away,7,TBB,301,176,95,78,24,17,Win,87,115,2,1,0,NOS,41,388,291,0,Win
0.363636364,0.705882353,22.76666667,2015-12-13,18,26,home,-7,NOS,176,301,80,52,17,24,Loss,115,87,1,2,0,TBB,41,291,388,0,Loss
0.214285714,0.46666666700000003,24.06666667,2015-12-13,15,24,away,-22,NYJ,268,256,20,58,8,30,Loss,24,183,5,1,0,TEN,38,292,439,1,Loss
0.46666666700000003,0.214285714,35.93333333,2015-12-13,24,15,home,22,TEN,256,268,20,71,30,8,Win,183,24,1,5,1,NYJ,38,439,292,0,Win
0.571428571,0.375,35.78333333,2015-12-13,22,22,away,13,CIN,270,321,82,69,33,20,Win,84,64,2,3,3,PIT,53,354,385,1,Win
0.375,0.571428571,24.21666667,2015-12-13,22,22,home,-13,PIT,321,270,27,56,20,33,Loss,64,84,3,2,1,CIN,53,385,354,3,Loss
0.25,0.222222222,30.8,2015-12-13,17,24,away,-35,JAX,227,226,85,69,16,51,Loss,95,154,3,3,2,IND,67,322,380,2,Loss
0.222222222,0.25,29.2,2015-12-13,24,17,home,35,IND,226,227,40,62,51,16,Win,154,95,3,3,2,JAX,67,380,322,2,Win
0.333333333,0.545454545,31.13333333,2015-12-13,15,18,away,-7,KCC,236,179,48,66,3,10,Loss,44,150,5,2,2,LAC,13,280,329,1,Loss
0.545454545,0.333333333,28.86666667,2015-12-13,18,15,home,7,LAC,179,236,53,50,10,3,Win,150,44,2,5,1,KCC,13,329,280,2,Win
0.583333333,0.454545455,34.36666667,2015-12-13,24,20,away,3,CHI,275,290,63,67,24,21,Win,99,87,3,3,1,WAS,45,374,377,1,Win
0.454545455,0.583333333,25.63333333,2015-12-13,20,24,home,-3,WAS,290,275,79,56,21,24,Loss,87,99,3,3,1,CHI,45,377,374,1,Loss
0.28571428600000004,0.5,28.5,2015-12-13,15,20,away,-38,CAR,176,282,54,62,0,38,Loss,54,142,5,2,0,ATL,38,230,424,4,Loss
0.5,0.28571428600000004,31.5,2015-12-13,20,15,home,38,ATL,282,176,60,61,38,0,Win,142,54,2,5,4,CAR,38,424,230,0,Win
0.666666667,0.272727273,35.71666667,2015-12-13,28,16,away,29,BAL,301,274,42,69,35,6,Win,123,28,0,1,2,SEA,41,424,302,1,Win
0.272727273,0.666666667,24.28333333,2015-12-13,16,28,home,-29,SEA,274,301,94,55,6,35,Loss,28,123,1,0,1,BAL,41,302,424,2,Loss
0.2,0.222222222,24.03333333,2015-12-13,8,20,away,3,DEN,99,276,70,55,15,12,Win,27,34,3,5,2,OAK,27,126,310,0,Win
0.222222222,0.2,35.96666667,2015-12-13,20,8,home,-3,OAK,276,99,27,77,12,15,Loss,34,27,5,3,0,DEN,27,310,126,2,Loss
0.090909091,0.5,22.2,2015-12-13,11,29,away,-21,GBP,99,205,30,51,7,28,Loss,171,230,2,2,0,DAL,35,270,435,1,Loss
0.5,0.090909091,37.8,2015-12-13,29,11,home,21,DAL,205,99,69,81,28,7,Win,230,171,2,2,1,GBP,35,435,270,0,Win
0.4375,0.214285714,35.23333333,2015-12-13,18,7,away,21,HOU,197,102,46,64,27,6,Win,116,87,3,6,1,NEP,33,313,189,1,Win
0.214285714,0.4375,24.76666667,2015-12-13,7,18,home,-21,NEP,102,197,36,52,6,27,Loss,87,116,6,3,1,HOU,33,189,313,1,Loss
0.454545455,0.4375,30.51666667,2015-12-14,25,16,away,7,MIA,337,235,25,62,31,24,Win,92,128,0,1,1,NYG,55,429,363,1,Win
0.4375,0.454545455,29.48333333,2015-12-14,16,25,home,-7,NYG,235,337,123,64,24,31,Loss,128,92,1,0,1,MIA,55,363,429,1,Loss
0.3,0.2,31.33333333,2015-12-17,30,16,away,-8,LAR,363,221,56,77,23,31,Loss,146,98,0,2,0,TBB,54,509,319,2,Loss
0.2,0.3,28.66666667,2015-12-17,16,30,home,8,TBB,221,363,35,52,31,23,Win,98,146,2,0,2,LAR,54,319,509,0,Win
0.35714285700000004,0.181818182,32.28333333,2015-12-19,20,15,away,3,DAL,299,176,61,67,19,16,Win,73,133,2,2,4,NYJ,35,372,309,1,Win
0.181818182,0.35714285700000004,27.71666667,2015-12-19,15,20,home,-3,NYJ,176,299,54,56,16,19,Loss,133,73,2,2,1,DAL,35,309,372,4,Loss
0.41666666700000005,0.666666667,27.83333333,2015-12-20,21,20,away,-21,MIN,199,221,39,62,17,38,Loss,94,129,5,1,0,CHI,55,293,350,2,Loss
0.666666667,0.41666666700000005,32.16666667,2015-12-20,20,21,home,21,CHI,221,199,45,57,38,17,Win,129,94,1,5,2,MIN,55,350,293,0,Win
0.5,0.0,34.53333333,2015-12-20,22,21,away,6,JAX,245,285,43,69,23,17,Win,83,85,1,2,1,ATL,40,328,370,1,Win
0.0,0.5,25.46666667,2015-12-20,21,22,home,-6,ATL,285,245,62,60,17,23,Loss,85,83,2,1,1,JAX,40,370,328,1,Loss
0.333333333,0.307692308,33.93333333,2015-12-20,20,14,away,6,IND,150,140,48,68,16,10,Win,155,50,3,3,2,HOU,26,305,190,2,Win
0.307692308,0.333333333,26.06666667,2015-12-20,14,20,home,-6,HOU,140,150,94,54,10,16,Loss,50,155,3,3,2,IND,26,190,305,2,Loss
0.529411765,0.4,30.86666667,2015-12-20,28,21,away,3,NYG,309,245,88,77,38,35,Win,171,161,3,0,2,CAR,73,480,406,1,Win
0.4,0.529411765,29.13333333,2015-12-20,21,28,home,-3,CAR,245,309,47,73,35,38,Loss,161,171,0,3,1,NYG,73,406,480,2,Loss
0.25,0.4375,30.38333333,2015-12-20,15,17,away,-17,NEP,223,253,29,60,16,33,Loss,59,93,5,2,1,TEN,49,282,346,3,Loss
0.4375,0.25,29.61666667,2015-12-20,17,15,home,17,TEN,253,223,35,63,33,16,Win,93,59,2,5,3,NEP,49,346,282,1,Win
0.384615385,0.636363636,30.93333333,2015-12-20,21,23,away,-10,WAS,212,308,56,63,25,35,Loss,240,123,5,1,1,BUF,60,452,431,0,Loss
0.636363636,0.384615385,29.06666667,2015-12-20,23,21,home,10,BUF,308,212,6,56,35,25,Win,123,240,1,5,0,WAS,60,431,452,1,Win
0.384615385,0.307692308,32.31666667,2015-12-20,15,19,away,20,BAL,164,273,55,56,34,14,Win,113,93,3,2,3,KCC,48,277,366,0,Win
0.307692308,0.384615385,27.68333333,2015-12-20,19,15,home,-20,KCC,273,164,63,67,14,34,Loss,93,113,2,3,0,BAL,48,366,277,3,Loss
0.5,0.75,25.45,2015-12-20,15,28,away,-17,SEA,136,241,40,52,13,30,Loss,94,182,3,2,0,CLE,43,230,423,1,Loss
0.75,0.5,34.55,2015-12-20,28,15,home,17,CLE,241,136,30,68,30,13,Win,182,94,2,3,1,SEA,43,423,230,0,Win
0.307692308,0.294117647,29.43333333,2015-12-20,18,20,away,10,OAK,190,252,75,69,30,20,Win,103,120,2,3,2,GBP,50,293,372,2,Win
0.294117647,0.307692308,30.56666667,2015-12-20,20,18,home,-10,GBP,252,190,95,75,20,30,Loss,120,103,3,2,2,OAK,50,372,293,2,Loss
0.529411765,0.46666666700000003,28.73333333,2015-12-20,20,28,away,-7,PIT,281,354,127,71,27,34,Loss,104,23,2,3,2,DEN,61,385,377,2,Loss
0.46666666700000003,0.529411765,31.26666667,2015-12-20,28,20,home,7,DEN,354,281,63,75,34,27,Win,23,104,3,2,2,PIT,61,377,385,2,Win
0.14285714300000002,0.642857143,21.11666667,2015-12-20,13,26,away,-16,LAC,187,302,72,56,14,30,Loss,44,140,3,1,2,MIA,44,231,442,1,Loss
0.642857143,0.14285714300000002,38.88333333,2015-12-20,26,13,home,16,MIA,302,187,48,73,30,14,Win,140,44,1,3,1,LAC,44,442,231,2,Win
0.28571428600000004,0.14285714300000002,30.98333333,2015-12-20,14,17,away,10,SFO,174,263,45,61,24,14,Win,68,55,4,4,4,CIN,38,242,318,1,Win
0.14285714300000002,0.28571428600000004,29.01666667,2015-12-20,17,14,home,-10,CIN,263,174,98,71,14,24,Loss,55,68,4,4,1,SFO,38,318,242,4,Loss
0.571428571,0.5,37.46666667,2015-12-20,28,19,away,23,PHI,263,350,10,74,40,17,Win,230,74,2,2,4,ARI,57,493,424,0,Win
0.5,0.571428571,22.53333333,2015-12-20,19,28,home,-23,ARI,350,263,38,63,17,40,Loss,74,230,2,2,0,PHI,57,424,493,4,Loss
0.5,0.35714285700000004,29.6,2015-12-21,24,27,away,8,NOS,246,330,92,51,35,27,Win,150,69,3,1,0,DET,62,396,399,1,Win
0.35714285700000004,0.5,30.4,2015-12-21,27,24,home,-8,DET,330,246,28,71,27,35,Loss,69,150,1,3,1,NOS,62,399,396,0,Loss
0.3125,0.26666666699999997,35.06666667,2015-12-24,19,14,away,-3,OAK,271,175,75,75,0,3,Loss,72,106,1,3,1,LAC,3,343,281,1,Loss
0.26666666699999997,0.3125,33.35,2015-12-24,14,19,home,3,LAC,175,271,121,65,3,0,Win,106,72,3,1,1,OAK,3,281,343,1,Win
0.35714285700000004,0.36842105299999994,34.25,2015-12-26,25,23,away,14,PHI,351,353,70,74,38,24,Win,67,45,2,5,2,WAS,62,418,398,0,Win
0.36842105299999994,0.35714285700000004,25.75,2015-12-26,23,25,home,-14,WAS,353,351,45,77,24,38,Loss,45,67,5,2,0,PHI,62,398,418,2,Loss
0.1,0.384615385,28.55,2015-12-27,16,24,away,-6,NYJ,221,285,7,55,0,6,Loss,63,143,2,1,1,NEP,6,284,428,1,Loss
0.384615385,0.1,34.06666667,2015-12-27,24,16,home,6,NEP,285,221,39,69,6,0,Win,143,63,1,2,1,NYJ,6,428,284,1,Win
0.4375,0.25,36.21666667,2015-12-27,19,13,away,28,TEN,202,227,28,69,34,6,Win,128,30,1,1,4,HOU,40,330,257,1,Win
0.25,0.4375,23.78333333,2015-12-27,13,19,home,-28,HOU,227,202,43,63,6,34,Loss,30,128,1,1,1,TEN,40,257,330,4,Loss
0.4,0.333333333,31.06666667,2015-12-27,21,16,away,-4,KCC,136,122,83,68,13,17,Loss,232,136,0,1,1,CLE,30,368,258,1,Loss
0.333333333,0.4,28.93333333,2015-12-27,16,21,home,4,CLE,122,136,33,50,17,13,Win,136,232,1,0,1,KCC,30,258,368,1,Win
0.5,0.4,27.18333333,2015-12-27,20,22,away,6,MIA,168,279,60,54,18,12,Win,100,82,2,6,1,IND,30,268,361,0,Win
0.4,0.5,32.81666667,2015-12-27,22,20,home,-6,IND,279,168,50,69,12,18,Loss,82,100,6,2,0,MIA,30,361,268,1,Loss
0.111111111,0.333333333,23.5,2015-12-27,20,26,away,-15,DET,201,284,65,59,17,32,Loss,121,87,3,2,0,SFO,49,322,371,1,Loss
0.333333333,0.111111111,36.5,2015-12-27,26,20,home,15,SFO,284,201,71,67,32,17,Win,87,121,2,3,1,DET,49,371,322,0,Win
0.5,0.428571429,28.5,2015-12-27,14,19,away,-10,BUF,186,172,65,56,6,16,Loss,121,236,0,3,2,DAL,22,307,408,2,Loss
0.428571429,0.5,31.5,2015-12-27,19,14,home,10,DAL,172,186,62,61,16,6,Win,236,121,3,0,2,BUF,22,408,307,2,Win
0.4,0.25,37.05,2015-12-27,21,19,away,5,TBB,153,285,25,67,26,21,Win,174,104,1,1,3,CHI,47,327,389,0,Win
0.25,0.4,22.95,2015-12-27,19,21,home,-5,CHI,285,153,47,55,21,26,Loss,104,174,1,1,0,TBB,47,389,327,3,Loss
0.4,0.6,24.36666667,2015-12-27,18,21,away,-7,ATL,113,296,40,52,13,20,Loss,155,77,2,2,1,CAR,33,268,373,1,Loss
0.6,0.4,35.63333333,2015-12-27,21,18,home,7,CAR,296,113,20,62,20,13,Win,77,155,2,2,1,ATL,33,373,268,1,Win
0.25,0.5,25.66666667,2015-12-27,21,22,away,-3,BAL,198,265,25,57,17,20,Loss,110,121,3,1,0,PIT,37,308,386,3,Loss
0.5,0.25,34.33333333,2015-12-27,22,21,home,3,PIT,265,198,121,73,20,17,Win,121,110,1,3,3,BAL,37,386,308,0,Win
0.666666667,0.615384615,22.11666667,2015-12-27,21,29,away,-11,NOS,347,402,55,52,27,38,Loss,65,135,2,1,0,JAX,65,412,537,2,Loss
0.615384615,0.666666667,37.88333333,2015-12-27,29,21,home,11,JAX,402,347,40,72,38,27,Win,135,65,1,2,2,NOS,65,537,412,0,Win
0.41666666700000005,0.470588235,27.9,2015-12-27,14,18,away,6,SEA,103,253,60,53,23,17,Win,102,59,0,4,3,LAR,40,205,312,0,Win
0.470588235,0.41666666700000005,32.1,2015-12-27,18,14,home,-6,LAR,253,103,83,67,17,23,Loss,59,102,4,0,0,SEA,40,312,205,3,Loss
0.294117647,0.5,29.73333333,2015-12-27,16,19,away,-30,ARI,77,260,59,64,8,38,Loss,101,121,9,2,2,GBP,46,178,381,4,Loss
0.5,0.294117647,30.26666667,2015-12-27,19,16,home,30,GBP,260,77,119,56,38,8,Win,121,101,2,9,4,ARI,46,381,178,2,Win
0.090909091,0.375,25.05,2015-12-27,15,17,away,-32,MIN,272,150,48,58,17,49,Loss,91,218,4,3,0,NYG,66,363,368,3,Loss
0.375,0.090909091,34.95,2015-12-27,17,15,home,32,NYG,150,272,10,68,49,17,Win,218,91,3,4,3,MIN,66,368,363,0,Win
0.588235294,0.363636364,37.46666667,2015-12-28,22,22,away,-3,DEN,186,277,45,70,0,3,Loss,108,113,2,3,1,CIN,3,294,390,1,Loss
0.363636364,0.588235294,27.83333333,2015-12-28,22,22,home,3,CIN,277,186,40,63,3,0,Win,113,108,3,2,1,DEN,3,390,294,1,Win
0.272727273,0.45,20.78333333,2016-01-03,15,18,away,-5,BUF,178,182,41,55,17,22,Loss,122,113,1,2,1,NYJ,39,300,295,3,Loss
0.45,0.272727273,39.21666667,2016-01-03,18,15,home,5,NYJ,182,178,45,73,22,17,Win,113,122,2,1,3,BUF,39,295,300,1,Win
0.28571428600000004,0.470588235,28.91666667,2016-01-03,12,20,away,-10,MIA,126,342,41,54,10,20,Loss,70,96,2,1,0,NEP,30,196,438,0,Loss
0.470588235,0.28571428600000004,31.08333333,2016-01-03,20,12,home,10,NEP,342,126,93,73,20,10,Win,96,70,1,2,0,MIA,30,438,196,0,Win
0.6,0.666666667,29.56666667,2016-01-03,24,25,away,3,ATL,323,327,45,65,20,17,Win,67,87,0,1,2,NOS,37,390,414,1,Win
0.666666667,0.6,30.43333333,2016-01-03,25,24,home,-3,NOS,327,323,32,63,17,20,Loss,87,67,1,0,1,ATL,37,414,390,2,Loss
0.6,0.0,29.21666667,2016-01-03,22,17,away,-8,CIN,282,147,38,78,16,24,Loss,59,145,1,3,0,BAL,40,341,292,2,Loss
0.0,0.6,30.78333333,2016-01-03,17,22,home,8,BAL,147,282,72,57,24,16,Win,145,59,3,1,2,CIN,40,292,341,0,Win
0.25,0.25,26.05,2016-01-03,16,22,away,16,CLE,349,177,45,55,28,12,Win,30,86,0,7,4,PIT,40,379,263,3,Win
0.25,0.25,33.95,2016-01-03,22,16,home,-16,PIT,177,349,47,76,12,28,Loss,86,30,7,0,3,CLE,40,263,379,4,Loss
0.083333333,0.470588235,24.38333333,2016-01-03,11,25,away,-24,HOU,183,242,53,54,6,30,Loss,32,160,8,2,1,JAX,36,215,402,4,Loss
0.470588235,0.083333333,35.61666667,2016-01-03,25,11,home,24,JAX,242,183,55,74,30,6,Win,160,32,2,8,4,HOU,36,402,215,1,Win
0.28571428600000004,0.41176470600000004,26.71666667,2016-01-03,14,20,away,-6,IND,94,200,60,58,24,30,Loss,137,127,4,1,1,TEN,54,231,327,1,Loss
0.41176470600000004,0.28571428600000004,33.28333333,2016-01-03,20,14,home,6,TEN,200,94,71,71,30,24,Win,127,137,1,4,1,IND,54,327,231,1,Win
0.5,0.2,33.96666667,2016-01-03,19,27,away,11,DAL,291,412,20,63,34,23,Win,146,100,1,4,4,WAS,57,437,512,0,Win
0.2,0.5,26.03333333,2016-01-03,27,19,home,-11,WAS,412,291,44,68,23,34,Loss,100,146,4,1,0,DAL,57,512,437,4,Loss
0.7692307690000001,0.46666666700000003,28.1,2016-01-03,23,30,away,5,NYG,315,294,11,65,35,30,Win,120,208,1,2,1,PHI,65,435,502,2,Win
0.46666666700000003,0.7692307690000001,31.9,2016-01-03,30,23,home,-5,PHI,294,315,10,81,30,35,Loss,208,120,2,1,2,NYG,65,502,435,1,Loss
0.4,0.583333333,32.5,2016-01-03,22,16,away,4,CHI,282,231,21,64,24,20,Win,67,111,4,5,3,DET,44,349,342,0,Win
0.583333333,0.4,27.5,2016-01-03,16,22,home,-4,DET,231,282,15,52,20,24,Loss,111,67,5,4,0,CHI,44,342,349,3,Loss
0.5,0.7,28.16666667,2016-01-03,21,23,away,-28,CAR,309,255,65,71,10,38,Loss,77,111,2,4,2,TBB,48,386,366,3,Loss
0.7,0.5,31.83333333,2016-01-03,23,21,home,28,TBB,255,309,33,62,38,10,Win,111,77,4,2,3,CAR,48,366,386,2,Win
0.214285714,0.46153846200000004,25.08333333,2016-01-03,14,23,away,-6,KCC,157,150,59,55,17,23,Loss,48,189,6,1,2,OAK,40,205,339,1,Loss
0.46153846200000004,0.214285714,34.91666667,2016-01-03,23,14,home,6,OAK,150,157,55,65,23,17,Win,189,48,1,6,1,KCC,40,339,205,2,Win
0.333333333,0.454545455,34.53333333,2016-01-03,15,21,away,-7,DEN,207,293,45,67,20,27,Loss,110,210,3,2,5,LAC,47,317,503,1,Loss
0.454545455,0.333333333,25.46666667,2016-01-03,21,15,home,7,LAC,293,207,35,65,27,20,Win,210,110,2,3,1,DEN,47,503,317,5,Win
0.533333333,0.41666666700000005,36.61666667,2016-01-03,22,16,away,30,ARI,209,205,70,69,36,6,Win,145,27,1,2,3,SEA,42,354,232,0,Win
0.41666666700000005,0.533333333,23.38333333,2016-01-03,16,22,home,-30,SEA,205,209,43,58,6,36,Loss,27,145,2,1,0,ARI,42,232,354,3,Loss
0.23076923100000002,0.444444444,38.5,2016-01-03,21,21,away,-3,SFO,231,350,105,71,0,3,Loss,133,108,0,1,1,LAR,3,364,458,0,Loss
0.444444444,0.23076923100000002,33.05,2016-01-03,21,21,home,3,LAR,350,231,60,78,3,0,Win,108,133,1,0,0,SFO,3,458,364,1,Win
0.181818182,0.133333333,24.3,2016-01-03,14,19,away,7,GBP,91,274,37,49,20,13,Win,151,76,3,5,2,MIN,33,242,350,2,Win
0.133333333,0.181818182,35.7,2016-01-03,19,14,home,-7,MIN,274,91,54,75,13,20,Loss,76,151,5,3,2,GBP,33,350,242,2,Loss
0.363636364,0.428571429,34.41666667,2016-01-09,18,14,away,30,HOU,173,112,52,62,30,0,Win,141,114,3,3,5,KCC,30,314,226,1,Win
0.428571429,0.363636364,25.58333333,2016-01-09,14,18,home,-30,KCC,112,173,29,62,0,30,Loss,114,141,3,3,1,HOU,30,226,314,5,Loss
0.153846154,0.333333333,30.61666667,2016-01-09,21,19,away,2,CIN,202,188,142,69,18,16,Win,167,91,4,3,4,PIT,34,369,279,2,Loss
0.333333333,0.153846154,29.38333333,2016-01-09,19,21,home,-2,PIT,188,202,79,68,16,18,Loss,91,167,3,4,2,CIN,34,279,369,4,Loss
0.35714285700000004,0.23076923100000002,27.56666667,2016-01-10,13,14,away,1,MIN,129,125,65,56,10,9,Win,97,58,2,3,1,SEA,19,226,183,1,Win
0.23076923100000002,0.35714285700000004,32.43333333,2016-01-10,14,13,home,-1,SEA,125,129,46,56,9,10,Loss,58,97,3,2,1,MIN,19,183,226,1,Win
0.272727273,0.333333333,29.55,2016-01-10,24,20,away,17,WAS,205,270,23,69,35,18,Win,141,84,1,6,1,GBP,53,346,354,1,Win
0.333333333,0.272727273,30.45,2016-01-10,20,24,home,-17,GBP,270,205,55,70,18,35,Loss,84,141,6,1,1,WAS,53,354,346,1,Loss
0.6,0.5,37.85,2016-01-16,27,21,away,-7,NEP,243,302,40,83,20,27,Loss,135,38,1,0,0,KCC,47,378,340,1,Loss
0.5,0.6,22.15,2016-01-16,21,27,home,7,KCC,302,243,24,56,27,20,Win,38,135,0,1,1,NEP,47,340,378,0,Win
0.46666666700000003,0.384615385,30.23333333,2016-01-16,18,20,away,-6,ARI,251,328,55,67,0,6,Loss,135,40,1,3,2,GBP,6,386,368,1,Loss
0.384615385,0.46666666700000003,30.85,2016-01-16,20,18,home,6,GBP,328,251,26,63,6,0,Win,40,135,3,1,1,ARI,6,368,386,2,Win
0.454545455,0.533333333,24.36666667,2016-01-17,23,19,away,-7,CAR,325,151,20,65,24,31,Loss,78,144,5,1,0,SEA,55,403,295,2,Loss
0.533333333,0.454545455,35.63333333,2016-01-17,19,23,home,7,SEA,151,325,25,64,31,24,Win,144,78,1,5,2,CAR,55,295,403,0,Win
0.166666667,0.2,28.45,2016-01-17,16,19,away,-7,DEN,311,215,38,59,16,23,Loss,85,109,3,1,0,PIT,39,396,324,1,Loss
0.2,0.166666667,31.55,2016-01-17,19,16,home,7,PIT,215,311,49,71,23,16,Win,109,85,1,3,1,DEN,39,324,396,0,Win
0.133333333,0.352941176,30.2,2016-01-24,20,12,away,-2,DEN,292,145,53,77,18,20,Loss,44,99,4,3,1,NEP,38,336,244,2,Loss
0.352941176,0.133333333,29.8,2016-01-24,12,20,home,2,NEP,145,292,51,65,20,18,Win,99,44,3,4,2,DEN,38,244,336,1,Win
0.3,0.571428571,23.35,2016-01-24,21,21,away,-34,CAR,227,324,51,60,15,49,Loss,60,152,3,1,1,ARI,64,287,476,7,Loss
0.571428571,0.3,36.65,2016-01-24,21,21,home,34,ARI,324,227,45,66,49,15,Win,152,60,1,3,7,CAR,64,476,287,1,Win
0.2,0.071428571,32.78333333,2016-02-07,21,11,away,-14,DEN,197,104,102,75,10,24,Loss,118,90,7,5,2,CAR,34,315,194,4,Loss
0.071428571,0.2,27.21666667,2016-02-07,11,21,home,14,CAR,104,197,51,56,24,10,Win,90,118,5,7,4,DEN,34,194,315,2,Win
0.6,0.5,32.31666667,2016-09-08,21,21,away,-1,DEN,176,159,85,68,20,21,Loss,157,148,3,2,3,CAR,41,333,307,1,Win
0.5,0.6,27.68333333,2016-09-08,21,21,home,1,CAR,159,176,22,57,21,20,Win,148,157,2,3,1,DEN,41,307,333,3,Loss
0.333333333,0.23076923100000002,27.61666667,2016-09-11,20,19,away,7,ATL,281,322,48,60,31,24,Win,90,52,0,3,0,TBB,55,371,374,1,Win
0.23076923100000002,0.333333333,32.38333333,2016-09-11,19,20,home,-7,TBB,322,281,74,64,24,31,Loss,52,90,3,0,1,ATL,55,374,371,0,Loss
0.428571429,0.571428571,29.58333333,2016-09-11,15,19,away,9,TEN,236,252,39,61,25,16,Win,65,64,0,2,3,MIN,41,301,316,0,Win
0.571428571,0.428571429,30.41666667,2016-09-11,19,15,home,-9,MIN,252,236,10,65,16,25,Loss,64,65,2,0,0,TEN,41,316,301,3,Loss
0.2,0.333333333,20.66666667,2016-09-11,14,23,away,-19,PHI,168,270,15,50,10,29,Loss,120,133,3,2,0,CLE,39,288,403,1,Loss
0.333333333,0.2,39.33333333,2016-09-11,23,14,home,19,CLE,270,168,46,73,29,10,Win,133,120,2,3,1,PHI,39,403,288,0,Win
0.272727273,0.333333333,25.11666667,2016-09-11,18,22,away,1,NYJ,324,188,44,56,23,22,Win,57,152,7,1,1,CIN,45,381,340,1,Win
0.333333333,0.272727273,34.88333333,2016-09-11,22,18,home,-1,CIN,188,324,95,66,22,23,Loss,152,57,1,7,1,NYJ,45,340,381,1,Loss
0.363636364,0.363636364,30.41666667,2016-09-11,25,27,away,1,NOS,319,419,141,64,35,34,Win,167,88,0,1,1,OAK,69,486,507,0,Win
0.363636364,0.363636364,29.58333333,2016-09-11,27,25,home,-1,OAK,419,319,53,65,34,35,Loss,88,167,1,0,0,NOS,69,507,486,1,Loss
0.46666666700000003,0.35714285700000004,34.01666667,2016-09-11,25,26,away,-6,KCC,233,330,30,69,0,6,Loss,155,83,1,3,1,LAC,6,388,413,0,Loss
0.35714285700000004,0.46666666700000003,31.1,2016-09-11,26,25,home,6,LAC,330,233,46,70,6,0,Win,83,155,3,1,0,KCC,6,413,388,1,Win
0.23076923100000002,0.4,27.11666667,2016-09-11,11,18,away,-6,BAL,95,225,89,48,7,13,Loss,65,83,2,4,1,BUF,20,160,308,0,Loss
0.4,0.23076923100000002,32.88333333,2016-09-11,18,11,home,6,BUF,225,95,35,65,13,7,Win,83,65,4,2,0,BAL,20,308,160,1,Win
0.307692308,0.6,23.68333333,2016-09-11,14,17,away,-9,HOU,185,215,30,54,14,23,Loss,73,129,5,2,1,CHI,37,258,344,1,Loss
0.6,0.307692308,36.31666667,2016-09-11,17,14,home,9,CHI,215,185,69,72,23,14,Win,129,73,2,5,1,HOU,37,344,258,1,Win
0.5,0.26666666699999997,28.61666667,2016-09-11,18,20,away,4,JAX,199,300,24,60,27,23,Win,95,48,1,3,1,GBP,50,294,348,0,Win
0.26666666699999997,0.5,31.38333333,2016-09-11,20,18,home,-4,GBP,300,199,79,68,23,27,Loss,48,95,3,1,0,JAX,50,348,294,1,Loss
0.214285714,0.3125,25.46666667,2016-09-11,11,21,away,-2,SEA,150,240,40,54,10,12,Loss,64,112,5,3,2,MIA,22,214,352,0,Loss
0.3125,0.214285714,34.53333333,2016-09-11,21,11,home,2,MIA,240,150,69,78,12,10,Win,112,64,3,5,0,SEA,22,352,214,2,Win
0.5,0.588235294,23.28333333,2016-09-11,18,24,away,1,DAL,203,227,40,54,20,19,Win,113,101,2,0,0,NYG,39,316,328,1,Loss
0.588235294,0.5,36.71666667,2016-09-11,24,18,home,-1,NYG,227,203,50,75,19,20,Loss,101,113,0,2,1,DAL,39,328,316,0,Loss
0.5555555560000001,0.5625,30.6,2016-09-11,28,25,away,4,IND,332,368,70,64,39,35,Win,116,82,1,2,0,DET,74,448,450,0,Win
0.5625,0.5555555560000001,29.4,2016-09-11,25,28,home,-4,DET,368,332,45,68,35,39,Loss,82,116,2,1,0,IND,74,450,448,0,Win
0.625,0.5,33.98333333,2016-09-11,19,21,away,2,ARI,257,252,69,66,23,21,Win,106,92,2,3,0,NEP,44,363,344,2,Loss
0.5,0.625,26.01666667,2016-09-11,21,19,home,-2,NEP,252,257,58,59,21,23,Loss,92,106,3,2,2,ARI,44,344,363,0,Win
0.642857143,0.3,33.3,2016-09-12,23,18,away,22,WAS,290,329,81,68,38,16,Win,147,55,1,0,2,PIT,54,437,384,1,Win
0.3,0.642857143,26.7,2016-09-12,18,23,home,-22,PIT,329,290,55,55,16,38,Loss,55,147,0,1,1,WAS,54,384,437,2,Loss
0.2,0.470588235,27.83333333,2016-09-12,10,28,away,-28,SFO,120,170,102,60,0,28,Loss,65,150,2,0,1,LAR,28,185,320,2,Loss
0.470588235,0.2,32.16666667,2016-09-12,28,10,home,28,LAR,170,120,10,77,28,0,Win,150,65,0,2,2,SFO,28,320,185,1,Win
0.615384615,0.3,39.2,2016-09-15,28,16,away,6,BUF,370,307,50,71,37,31,Win,123,86,1,0,1,NYJ,68,493,393,1,Win
0.3,0.615384615,20.8,2016-09-15,16,28,home,-6,NYJ,307,370,59,50,31,37,Loss,86,123,0,1,1,BUF,68,393,493,1,Loss
0.28571428600000004,0.46666666700000003,24.1,2016-09-18,16,26,away,-19,CAR,237,353,50,64,27,46,Loss,65,176,2,1,4,SFO,73,302,529,3,Loss
0.46666666700000003,0.28571428600000004,35.9,2016-09-18,26,16,home,19,SFO,353,237,65,78,46,27,Win,176,65,1,2,3,CAR,73,529,302,4,Win
0.5,0.41666666700000005,32.85,2016-09-18,24,24,away,4,WAS,278,350,39,64,27,23,Win,102,82,4,2,1,DAL,50,380,432,1,Win
0.41666666700000005,0.5,27.15,2016-09-18,24,24,home,-4,DAL,350,278,51,65,23,27,Loss,82,102,2,4,1,WAS,50,432,380,1,Loss
0.25,0.41176470600000004,27.08333333,2016-09-18,21,19,away,-8,PIT,366,250,31,73,16,24,Loss,46,124,1,1,2,CIN,40,412,374,2,Loss
0.41176470600000004,0.25,32.91666667,2016-09-18,19,21,home,8,CIN,250,366,54,74,24,16,Win,124,46,1,1,2,PIT,40,374,412,2,Win
0.23076923100000002,0.46666666700000003,25.88333333,2016-09-18,16,22,away,-3,NYG,247,353,76,59,13,16,Loss,41,64,2,2,3,NOS,29,288,417,0,Win
0.46666666700000003,0.23076923100000002,34.11666667,2016-09-18,22,16,home,3,NOS,353,247,25,75,16,13,Win,64,41,2,2,0,NYG,29,417,288,3,Win
0.5,0.5,23.23333333,2016-09-18,23,29,away,-7,NEP,387,302,49,61,24,31,Loss,70,161,0,2,1,MIA,55,457,463,4,Loss
0.5,0.5,36.76666667,2016-09-18,29,23,home,7,MIA,302,387,65,75,31,24,Win,161,70,2,0,4,NEP,55,463,457,1,Win
0.214285714,0.26666666699999997,26.01666667,2016-09-18,14,15,away,-7,HOU,172,254,77,60,12,19,Loss,119,97,4,2,2,KCC,31,291,351,3,Loss
0.26666666699999997,0.214285714,33.98333333,2016-09-18,15,14,home,7,KCC,254,172,44,69,19,12,Win,97,119,2,4,3,HOU,31,351,291,2,Win
0.41666666700000005,0.4375,30.85,2016-09-18,22,22,away,1,DET,224,238,83,60,16,15,Win,139,137,3,4,1,TEN,31,363,375,1,Win
0.4375,0.41666666700000005,29.15,2016-09-18,22,22,home,-1,TEN,238,224,138,67,15,16,Loss,137,139,4,3,1,DET,31,375,363,1,Loss
0.625,0.533333333,30.98333333,2016-09-18,22,17,away,5,CLE,302,242,29,71,25,20,Win,80,145,0,3,2,BAL,45,382,387,2,Win
0.533333333,0.625,29.01666667,2016-09-18,17,22,home,-5,BAL,242,302,59,59,20,25,Loss,145,80,3,0,2,CLE,45,387,382,2,Loss
0.307692308,0.25,30.05,2016-09-18,17,17,away,-6,LAR,239,219,114,61,3,9,Loss,67,64,2,3,0,SEA,12,306,283,1,Loss
0.25,0.307692308,29.95,2016-09-18,17,17,home,6,SEA,219,239,78,58,9,3,Win,64,67,3,2,1,LAR,12,283,306,0,Win
0.384615385,0.428571429,30.95,2016-09-18,21,20,away,-33,ARI,221,311,39,76,7,40,Loss,85,105,3,1,0,TBB,47,306,416,5,Loss
0.428571429,0.384615385,29.05,2016-09-18,20,21,home,33,TBB,311,221,30,65,40,7,Win,105,85,1,3,5,ARI,47,416,306,0,Win
0.181818182,0.538461538,25.13333333,2016-09-18,20,25,away,-24,LAC,319,207,93,63,14,38,Loss,69,150,2,3,1,JAX,52,388,357,3,Loss
0.538461538,0.181818182,34.86666667,2016-09-18,25,20,home,24,JAX,207,319,23,63,38,14,Win,150,69,3,2,3,LAC,52,357,388,1,Win
0.5,0.41666666700000005,27.25,2016-09-18,27,29,away,7,OAK,389,299,72,64,35,28,Win,139,155,1,1,0,ATL,63,528,454,1,Win
0.41666666700000005,0.5,32.75,2016-09-18,29,27,home,-7,ATL,299,389,58,71,28,35,Loss,155,139,1,1,1,OAK,63,454,528,0,Loss
0.428571429,0.454545455,29.31666667,2016-09-18,19,24,away,-14,DEN,170,266,94,66,20,34,Loss,83,134,5,1,1,IND,54,253,400,2,Loss
0.454545455,0.428571429,30.68333333,2016-09-18,24,19,home,14,IND,266,170,54,65,34,20,Win,134,83,1,5,2,DEN,54,400,253,1,Win
0.46153846200000004,0.28571428600000004,29.7,2016-09-18,20,15,away,-3,MIN,180,254,72,64,14,17,Loss,83,30,5,4,1,GBP,31,263,284,3,Loss
0.28571428600000004,0.46153846200000004,30.3,2016-09-18,15,20,home,3,GBP,254,180,137,57,17,14,Win,30,83,4,5,3,MIN,31,284,263,1,Win
0.2,0.4,36.08333333,2016-09-19,21,16,away,15,CHI,180,220,34,68,29,14,Win,100,64,2,3,3,PHI,43,280,284,0,Win
0.4,0.2,23.91666667,2016-09-19,16,21,home,-15,PHI,220,180,60,50,14,29,Loss,64,100,3,2,0,CHI,43,284,280,3,Loss
0.4,0.28571428600000004,31.36666667,2016-09-22,19,15,away,-27,NEP,175,97,43,70,0,27,Loss,109,185,2,1,0,HOU,27,284,282,3,Loss
0.28571428600000004,0.4,28.63333333,2016-09-22,15,19,home,27,HOU,97,175,15,59,27,0,Win,185,109,1,2,3,NEP,27,282,284,0,Win
0.333333333,0.307692308,34.0,2016-09-25,25,16,away,-15,BUF,260,89,50,77,18,33,Loss,88,208,5,4,1,ARI,51,348,297,5,Loss
0.307692308,0.333333333,26.0,2016-09-25,16,25,home,15,ARI,89,260,75,61,33,18,Win,208,88,4,5,5,BUF,51,297,348,1,Win
0.384615385,0.166666667,29.05,2016-09-25,17,19,away,7,TEN,245,212,58,61,17,10,Win,123,181,1,1,3,OAK,27,368,393,1,Win
0.166666667,0.384615385,30.95,2016-09-25,19,17,home,-7,OAK,212,245,70,63,10,17,Loss,181,123,1,1,1,TEN,27,393,368,3,Loss
0.4375,0.444444444,33.43333333,2016-09-25,20,28,away,2,NYG,313,337,70,68,29,27,Win,90,120,2,2,3,WAS,56,403,457,1,Win
0.444444444,0.4375,26.56666667,2016-09-25,28,20,home,-2,WAS,337,313,128,61,27,29,Loss,120,90,2,2,1,NYG,56,457,403,3,Loss
0.26666666699999997,0.2,37.36666667,2016-09-25,21,23,away,-6,MIA,261,311,91,74,0,6,Loss,169,115,4,1,3,CLE,6,430,426,1,Loss
0.2,0.26666666699999997,29.2,2016-09-25,23,21,home,6,CLE,311,261,67,65,6,0,Win,115,169,1,4,1,MIA,6,426,430,3,Win
0.23076923100000002,0.375,31.1,2016-09-25,18,14,away,2,JAX,199,168,58,64,19,17,Win,84,48,2,4,3,BAL,36,283,216,3,Win
0.375,0.23076923100000002,28.9,2016-09-25,14,18,home,-2,BAL,168,199,75,63,17,19,Loss,48,84,4,2,3,JAX,36,216,283,3,Loss
0.571428571,0.5,35.11666667,2016-09-25,22,17,away,-7,GBP,368,201,86,67,27,34,Loss,50,123,3,2,0,DET,61,418,324,1,Loss
0.5,0.571428571,24.88333333,2016-09-25,17,22,home,7,DET,201,368,45,50,34,27,Win,123,50,2,3,1,GBP,61,324,418,0,Win
0.5,0.41666666700000005,27.9,2016-09-25,21,20,away,12,CIN,303,189,41,60,29,17,Win,52,143,2,4,2,DEN,46,355,332,1,Win
0.41666666700000005,0.5,32.1,2016-09-25,20,21,home,-12,DEN,189,303,69,64,17,29,Loss,143,52,4,2,1,CIN,46,332,355,2,Loss
0.25,0.375,25.13333333,2016-09-25,13,18,away,12,CAR,153,201,42,54,22,10,Win,58,105,2,8,3,MIN,32,211,306,0,Win
0.375,0.25,34.86666667,2016-09-25,18,13,home,-12,MIN,201,153,65,72,10,22,Loss,105,58,8,2,0,CAR,32,306,211,3,Loss
0.46153846200000004,0.5,26.4,2016-09-25,18,30,away,5,TBB,183,389,69,60,37,32,Win,137,83,1,2,2,LAR,69,320,472,2,Win
0.5,0.46153846200000004,33.6,2016-09-25,30,18,home,-5,LAR,389,183,80,82,32,37,Loss,83,137,2,1,2,TBB,69,472,320,2,Loss
0.26666666699999997,0.642857143,24.05,2016-09-25,12,18,away,-19,SEA,119,291,35,56,18,37,Loss,135,127,0,2,2,SFO,55,254,418,1,Loss
0.642857143,0.26666666699999997,35.95,2016-09-25,18,12,home,19,SFO,291,119,50,65,37,18,Win,127,135,2,0,1,SEA,55,418,254,2,Win
0.5,0.46666666700000003,27.91666667,2016-09-25,17,18,away,-21,KCC,188,221,15,66,3,24,Loss,117,72,0,2,1,NYJ,27,305,293,8,Loss
0.46666666700000003,0.5,32.08333333,2016-09-25,18,17,home,21,NYJ,221,188,59,62,24,3,Win,72,117,2,0,8,KCC,27,293,305,1,Win
0.363636364,0.222222222,27.28333333,2016-09-25,17,24,away,-4,IND,315,317,80,58,22,26,Loss,37,93,2,2,2,LAC,48,352,410,3,Loss
0.222222222,0.363636364,32.71666667,2016-09-25,24,17,home,4,LAC,317,315,66,65,26,22,Win,93,37,2,2,3,IND,48,410,352,2,Win
0.363636364,0.4,25.06666667,2016-09-25,15,25,away,-31,PHI,222,301,77,58,3,34,Loss,29,125,4,0,0,PIT,37,251,426,2,Loss
0.4,0.363636364,34.93333333,2016-09-25,25,15,home,31,PIT,301,222,99,61,34,3,Win,125,29,0,4,2,PHI,37,426,251,0,Win
0.2,0.454545455,24.68333333,2016-09-25,21,25,away,-14,DAL,312,248,45,64,17,31,Loss,78,199,1,0,1,CHI,48,390,447,2,Loss
0.454545455,0.2,35.31666667,2016-09-25,25,21,home,14,CHI,248,312,45,65,31,17,Win,199,78,0,1,2,DAL,48,447,390,1,Win
0.454545455,0.538461538,27.43333333,2016-09-26,26,32,away,13,NOS,225,359,35,63,45,32,Win,217,115,2,2,2,ATL,77,442,474,0,Win
0.538461538,0.454545455,32.56666667,2016-09-26,32,26,home,-13,ATL,359,225,75,79,32,45,Loss,115,217,2,2,0,NOS,77,474,442,2,Loss
0.181818182,0.2,21.96666667,2016-09-29,8,19,away,-15,CIN,160,285,68,43,7,22,Loss,62,77,5,1,0,MIA,29,222,362,2,Loss
0.2,0.181818182,38.03333333,2016-09-29,19,8,home,15,MIA,285,160,40,69,22,7,Win,77,62,1,5,2,CIN,29,362,222,0,Win
0.529411765,0.272727273,32.65,2016-10-02,23,23,away,-3,JAX,190,195,78,73,27,30,Loss,94,136,6,3,0,IND,57,284,331,1,Loss
0.272727273,0.529411765,27.35,2016-10-02,23,23,home,3,IND,195,190,145,65,30,27,Win,136,94,3,6,1,JAX,57,331,284,0,Win
0.46666666700000003,0.41666666700000005,31.7,2016-10-02,16,21,away,-7,HOU,196,244,93,62,20,27,Loss,124,115,1,1,2,TEN,47,320,359,1,Loss
0.41666666700000005,0.46666666700000003,28.3,2016-10-02,21,16,home,7,TEN,244,196,59,62,27,20,Win,115,124,1,1,1,HOU,47,359,320,2,Win
0.666666667,0.5,28.95,2016-10-02,26,24,away,-11,WAS,217,156,101,69,20,31,Loss,163,145,1,3,1,CLE,51,380,301,3,Loss
0.5,0.666666667,31.05,2016-10-02,24,26,home,11,CLE,156,217,75,56,31,20,Win,145,163,3,1,3,WAS,51,301,380,1,Win
0.3,0.46666666700000003,30.75,2016-10-02,21,20,away,10,NYJ,288,247,71,60,27,17,Win,66,58,2,4,3,SEA,44,354,305,0,Win
0.46666666700000003,0.3,29.25,2016-10-02,20,21,home,-10,SEA,247,288,60,65,17,27,Loss,58,66,4,2,0,NYJ,44,305,354,3,Loss
0.46666666700000003,0.083333333,36.18333333,2016-10-02,24,13,away,16,NEP,244,187,60,73,16,0,Win,134,90,2,3,1,BUF,16,378,277,0,Win
0.083333333,0.46666666700000003,23.81666667,2016-10-02,13,24,home,-16,BUF,187,244,74,52,0,16,Loss,90,134,3,2,0,NEP,16,277,378,1,Loss
0.4375,0.615384615,26.18333333,2016-10-02,20,25,away,-15,ATL,329,481,55,64,33,48,Loss,49,90,1,3,1,CAR,81,378,571,2,Loss
0.615384615,0.4375,33.81666667,2016-10-02,25,20,home,15,CAR,481,329,77,65,48,33,Win,90,49,3,1,2,ATL,81,571,378,1,Win
0.25,0.294117647,25.26666667,2016-10-02,13,25,away,1,BAL,199,282,93,54,28,27,Win,62,130,0,2,1,OAK,55,261,412,1,Loss
0.294117647,0.25,34.73333333,2016-10-02,25,13,home,-1,OAK,282,199,105,80,27,28,Loss,130,62,2,0,1,BAL,55,412,261,1,Win
0.333333333,0.384615385,26.76666667,2016-10-02,16,23,away,-3,CHI,197,294,76,56,14,17,Loss,66,114,2,2,0,DET,31,263,408,2,Loss
0.384615385,0.333333333,33.23333333,2016-10-02,23,16,home,3,DET,294,197,55,67,17,14,Win,114,66,2,2,2,CHI,31,408,263,0,Win
0.23076923100000002,0.3125,31.4,2016-10-02,22,15,away,20,TBB,218,143,88,67,27,7,Win,89,72,4,5,3,DEN,34,307,215,0,Win
0.3125,0.23076923100000002,28.6,2016-10-02,15,22,home,-20,DEN,143,218,69,66,7,27,Loss,72,89,5,4,0,TBB,34,215,307,3,Loss
0.428571429,0.46153846200000004,27.85,2016-10-02,12,26,away,4,ARI,247,302,84,55,17,13,Win,41,118,2,3,5,LAR,30,288,420,1,Win
0.46153846200000004,0.428571429,32.15,2016-10-02,26,12,home,-4,LAR,302,247,45,75,13,17,Loss,118,41,3,2,1,ARI,30,420,288,5,Loss
0.611111111,0.46153846200000004,32.65,2016-10-02,21,21,away,1,LAC,192,308,34,72,35,34,Win,83,38,2,3,3,NOS,69,275,346,2,Win
0.46153846200000004,0.611111111,27.35,2016-10-02,21,21,home,-1,NOS,308,192,46,67,34,35,Loss,38,83,3,2,2,LAC,69,346,275,3,Loss
0.428571429,0.571428571,36.45,2016-10-02,26,14,away,7,SFO,234,189,45,73,24,17,Win,194,106,2,1,1,DAL,41,428,295,0,Win
0.571428571,0.428571429,23.55,2016-10-02,14,26,home,-7,DAL,189,234,32,53,17,24,Loss,106,194,1,2,0,SFO,41,295,428,1,Loss
0.470588235,0.545454545,30.6,2016-10-02,22,18,away,-29,PIT,270,287,40,72,14,43,Loss,87,149,4,2,0,KCC,57,357,436,2,Loss
0.545454545,0.470588235,29.4,2016-10-02,18,22,home,29,KCC,287,270,68,55,43,14,Win,149,87,2,4,2,PIT,57,436,357,0,Win
0.166666667,0.5,24.46666667,2016-10-03,18,22,away,-14,MIN,261,262,69,63,10,24,Loss,78,104,0,0,0,NYG,34,339,366,2,Loss
0.5,0.166666667,35.53333333,2016-10-03,22,18,home,14,NYG,262,261,37,69,24,10,Win,104,78,0,0,2,MIN,34,366,339,0,Win
0.3125,0.28571428600000004,31.73333333,2016-10-06,17,25,away,12,SFO,116,135,50,66,33,21,Win,172,151,1,7,3,ARI,54,288,286,0,Win
0.28571428600000004,0.3125,28.26666667,2016-10-06,25,17,home,-12,ARI,135,116,34,74,21,33,Loss,151,172,7,1,0,SFO,54,286,288,3,Loss
0.529411765,0.384615385,34.65,2016-10-09,24,17,away,20,CLE,403,235,61,77,33,13,Win,98,27,1,2,1,NEP,46,501,262,0,Win
0.384615385,0.529411765,25.35,2016-10-09,17,24,home,-20,NEP,235,403,35,59,13,33,Loss,27,98,2,1,0,CLE,46,262,501,1,Loss
0.454545455,0.333333333,29.6,2016-10-09,18,21,away,-1,DET,230,164,111,57,23,24,Loss,116,80,3,4,1,PHI,47,346,244,2,Win
0.333333333,0.454545455,30.4,2016-10-09,21,18,home,1,PHI,164,230,18,56,24,23,Win,80,116,4,3,2,DET,47,244,346,1,Loss
0.222222222,0.25,30.08333333,2016-10-09,25,20,away,-6,IND,397,298,80,62,23,29,Loss,125,98,0,5,0,CHI,52,522,396,1,Loss
0.25,0.222222222,29.91666667,2016-10-09,20,25,home,6,CHI,298,397,68,65,29,23,Win,98,125,5,0,1,IND,52,396,522,0,Win
0.41666666700000005,0.363636364,36.73333333,2016-10-09,23,8,away,13,MIA,163,149,40,70,30,17,Win,235,51,0,6,2,TEN,47,398,200,0,Win
0.363636364,0.41666666700000005,23.26666667,2016-10-09,8,23,home,-13,TEN,149,163,83,41,17,30,Loss,51,235,6,0,0,MIA,47,200,398,2,Loss
0.25,0.2,29.58333333,2016-10-09,18,18,away,6,BAL,250,188,46,62,16,10,Win,60,118,1,3,1,WAS,26,310,306,2,Win
0.2,0.25,30.41666667,2016-10-09,18,18,home,-6,WAS,188,250,65,69,10,16,Loss,118,60,3,1,2,BAL,26,306,310,1,Loss
0.076923077,0.5,22.53333333,2016-10-09,16,22,away,-18,MIN,155,255,15,60,13,31,Loss,59,96,4,2,0,HOU,44,214,351,1,Loss
0.5,0.076923077,37.46666667,2016-10-09,22,16,home,18,HOU,255,155,97,69,31,13,Win,96,59,2,4,1,MIN,44,351,214,0,Win
0.181818182,0.5,28.16666667,2016-10-09,16,30,away,-18,PIT,244,375,18,58,13,31,Loss,72,61,3,1,1,NYJ,44,316,436,0,Loss
0.5,0.181818182,31.83333333,2016-10-09,30,16,home,18,NYJ,375,244,10,72,31,13,Win,61,72,1,3,0,PIT,44,436,316,1,Win
0.166666667,0.25,28.86666667,2016-10-09,19,18,away,7,DEN,250,183,78,62,23,16,Win,122,84,2,6,1,ATL,39,372,267,1,Win
0.25,0.166666667,31.13333333,2016-10-09,18,19,home,-7,ATL,183,250,57,65,16,23,Loss,84,122,6,2,1,DEN,39,267,372,1,Loss
0.41666666700000005,0.5,32.28333333,2016-10-09,27,21,away,-14,DAL,249,222,49,64,14,28,Loss,96,180,4,1,1,CIN,42,345,402,0,Loss
0.5,0.41666666700000005,27.71666667,2016-10-09,21,27,home,14,CIN,222,249,45,54,28,14,Win,180,96,1,4,0,DAL,42,402,345,1,Win
0.333333333,0.333333333,24.43333333,2016-10-09,15,23,away,11,LAR,112,243,60,52,30,19,Win,193,102,2,4,3,BUF,49,305,345,0,Win
0.333333333,0.333333333,35.56666667,2016-10-09,23,15,home,-11,BUF,243,112,40,64,19,30,Loss,102,193,4,2,0,LAR,49,345,305,3,Loss
0.25,0.35714285700000004,23.7,2016-10-09,17,20,away,-3,OAK,351,300,38,51,31,34,Loss,72,89,2,3,1,LAC,65,423,389,4,Loss
0.35714285700000004,0.25,36.3,2016-10-09,20,17,home,3,LAC,300,351,36,68,34,31,Win,89,72,3,2,4,OAK,65,389,423,1,Win
0.307692308,0.473684211,23.36666667,2016-10-09,14,23,away,-7,GBP,178,259,51,54,16,23,Loss,43,147,4,0,2,NYG,39,221,406,1,Loss
0.473684211,0.307692308,36.63333333,2016-10-09,23,14,home,7,NYG,259,178,57,77,23,16,Win,147,43,0,4,1,GBP,39,406,221,2,Win
0.4,0.125,34.15,2016-10-10,20,20,away,3,CAR,202,278,40,69,17,14,Win,113,136,2,0,4,TBB,31,315,414,0,Win
0.125,0.4,25.85,2016-10-10,20,20,home,-3,TBB,278,202,60,53,14,17,Loss,136,113,0,2,0,CAR,31,414,315,4,Loss
0.4,0.23076923100000002,26.53333333,2016-10-13,16,16,away,-8,LAC,220,166,103,68,13,21,Loss,84,99,2,2,2,DEN,34,304,265,2,Loss
0.23076923100000002,0.4,33.46666667,2016-10-13,16,16,home,8,DEN,166,220,20,60,21,13,Win,99,84,2,2,2,LAC,34,265,304,2,Win
0.23076923100000002,0.615384615,24.81666667,2016-10-16,16,29,away,-29,BUF,167,179,52,60,16,45,Loss,133,313,3,3,2,SFO,61,300,492,1,Loss
0.615384615,0.23076923100000002,35.18333333,2016-10-16,29,16,home,29,SFO,179,167,71,74,45,16,Win,313,133,3,3,1,BUF,61,492,300,2,Win
0.333333333,0.538461538,25.78333333,2016-10-16,12,26,away,-7,WAS,145,263,114,48,20,27,Loss,94,230,5,0,1,PHI,47,239,493,0,Loss
0.538461538,0.333333333,34.21666667,2016-10-16,26,12,home,7,PHI,263,145,75,67,27,20,Win,230,94,0,5,0,WAS,47,493,239,1,Win
0.214285714,0.538461538,28.98333333,2016-10-16,16,19,away,-2,TEN,301,270,69,63,26,28,Loss,40,137,6,2,1,CLE,54,341,407,0,Loss
0.538461538,0.214285714,31.01666667,2016-10-16,19,16,home,2,CLE,270,301,96,57,28,26,Win,137,40,2,6,0,TEN,54,407,341,1,Win
0.27777777800000003,0.28571428600000004,35.06666667,2016-10-16,22,19,away,-4,NYG,293,397,111,76,23,27,Loss,98,38,2,1,3,BAL,50,391,435,0,Loss
0.28571428600000004,0.27777777800000003,24.93333333,2016-10-16,19,22,home,4,BAL,397,293,119,64,27,23,Win,38,98,1,2,0,NYG,50,435,391,3,Loss
0.272727273,0.5,31.08333333,2016-10-16,32,23,away,-3,NOS,303,460,51,76,38,41,Loss,103,63,2,1,1,CAR,79,406,523,2,Loss
0.5,0.272727273,28.91666667,2016-10-16,23,32,home,3,CAR,460,303,126,71,41,38,Win,63,103,1,2,2,NOS,79,523,406,1,Win
0.2,0.41176470600000004,24.21666667,2016-10-16,20,22,away,1,CHI,263,297,50,55,17,16,Win,54,92,2,1,0,JAX,33,317,389,2,Loss
0.41176470600000004,0.2,35.78333333,2016-10-16,22,20,home,-1,JAX,297,263,87,77,16,17,Loss,92,54,1,2,2,CHI,33,389,317,0,Win
0.666666667,0.545454545,27.8,2016-10-16,23,20,away,-3,DET,311,265,62,55,28,31,Loss,76,83,1,1,0,LAR,59,387,348,1,Loss
0.545454545,0.666666667,32.2,2016-10-16,20,23,home,3,LAR,265,311,62,58,31,28,Win,83,76,1,1,1,DET,59,348,387,0,Win
0.272727273,0.5,23.5,2016-10-16,15,24,away,-15,MIA,169,252,65,53,15,30,Loss,128,222,2,0,0,PIT,45,297,474,2,Loss
0.5,0.272727273,36.5,2016-10-16,24,15,home,15,PIT,252,169,95,68,30,15,Win,222,128,0,2,2,MIA,45,474,297,0,Win
0.41666666700000005,0.4,32.05,2016-10-16,20,25,away,-18,NEP,237,358,46,65,17,35,Loss,120,79,2,3,0,CIN,52,357,437,0,Loss
0.4,0.41666666700000005,27.95,2016-10-16,25,20,home,18,CIN,358,237,55,61,35,17,Win,79,120,3,2,0,NEP,52,437,357,0,Win
0.538461538,0.4,36.75,2016-10-16,22,16,away,16,OAK,223,221,10,64,26,10,Win,183,64,1,2,2,KCC,36,406,285,0,Win
0.4,0.538461538,23.25,2016-10-16,16,22,home,-16,KCC,221,223,25,53,10,26,Loss,64,183,2,1,0,OAK,36,285,406,2,Loss
0.272727273,0.35714285700000004,29.85,2016-10-16,22,22,away,-2,SEA,310,261,66,64,24,26,Loss,52,72,4,1,0,ATL,50,362,333,2,Loss
0.35714285700000004,0.272727273,30.15,2016-10-16,22,22,home,2,ATL,261,310,30,65,26,24,Win,72,52,1,4,2,SEA,50,333,362,0,Win
0.272727273,0.538461538,29.83333333,2016-10-16,24,24,away,14,GBP,233,294,60,62,30,16,Win,191,78,2,1,4,DAL,46,424,372,2,Win
0.538461538,0.272727273,30.16666667,2016-10-16,24,24,home,-14,DAL,294,233,23,67,16,30,Loss,78,191,1,2,2,GBP,46,372,424,4,Loss
0.35714285700000004,0.454545455,36.55,2016-10-16,19,26,away,-3,HOU,231,256,42,67,0,3,Loss,161,158,3,1,1,IND,3,392,414,1,Loss
0.454545455,0.35714285700000004,30.28333333,2016-10-16,26,19,home,3,IND,256,231,59,68,3,0,Win,158,161,1,3,1,HOU,3,414,392,1,Loss
0.153846154,0.545454545,23.96666667,2016-10-17,11,28,away,-25,ARI,197,225,83,52,3,28,Loss,33,171,1,0,0,NYJ,31,230,396,2,Loss
0.545454545,0.153846154,36.03333333,2016-10-17,28,11,home,25,NYJ,225,197,64,70,28,3,Win,171,33,0,1,2,ARI,31,396,230,0,Win
0.25,0.5625,20.4,2016-10-20,13,32,away,-16,GBP,120,303,108,45,10,26,Loss,69,103,1,2,1,CHI,36,189,406,2,Loss
0.5625,0.25,39.6,2016-10-20,32,13,home,16,CHI,303,120,56,81,26,10,Win,103,69,2,1,2,GBP,36,406,189,1,Win
0.307692308,0.473684211,24.95,2016-10-23,13,20,away,7,LAR,196,271,33,57,17,10,Win,36,74,0,3,4,NYG,27,232,345,1,Win
0.473684211,0.307692308,35.05,2016-10-23,20,13,home,-7,NYG,271,196,43,76,10,17,Loss,74,36,3,0,1,LAR,27,345,232,4,Loss
0.642857143,0.333333333,32.63333333,2016-10-23,27,20,away,-6,KCC,359,214,75,71,21,27,Loss,104,112,1,0,0,NOS,48,463,326,2,Loss
0.333333333,0.642857143,27.36666667,2016-10-23,20,27,home,6,NOS,214,359,30,52,27,21,Win,112,104,0,1,2,KCC,48,326,463,0,Win
0.4,0.6,32.5,2016-10-23,26,26,away,8,TEN,341,207,131,65,34,26,Win,81,124,2,3,1,IND,60,422,331,0,Win
0.6,0.4,27.5,2016-10-23,26,26,home,-8,IND,207,341,38,68,26,34,Loss,124,81,3,2,0,TEN,60,331,422,1,Loss
0.473684211,0.363636364,32.13333333,2016-10-23,18,15,away,-11,PHI,189,138,56,74,10,21,Loss,93,101,6,0,4,MIN,31,282,239,4,Loss
0.363636364,0.473684211,27.86666667,2016-10-23,15,18,home,11,MIN,138,189,53,54,21,10,Win,101,93,0,6,4,PHI,31,239,282,4,Win
0.428571429,0.5,31.8,2016-10-23,22,23,away,-14,CIN,172,288,35,63,17,31,Loss,180,271,2,3,1,CLE,48,352,559,2,Loss
0.5,0.428571429,28.2,2016-10-23,23,22,home,14,CLE,288,172,30,61,31,17,Win,271,180,3,2,2,CIN,48,559,352,1,Win
0.6,0.333333333,34.98333333,2016-10-23,26,19,away,-3,DET,283,250,20,70,17,20,Loss,130,94,2,3,0,WAS,37,413,344,2,Loss
0.333333333,0.6,25.01666667,2016-10-23,19,26,home,3,WAS,250,283,30,51,20,17,Win,94,130,3,2,2,DET,37,344,413,0,Win
0.444444444,0.307692308,33.45,2016-10-23,21,19,away,17,JAX,200,239,117,71,33,16,Win,144,105,0,1,3,OAK,49,344,344,0,Win
0.307692308,0.444444444,26.55,2016-10-23,19,21,home,-17,OAK,239,200,112,60,16,33,Loss,105,144,1,0,0,JAX,49,344,344,3,Loss
0.23076923100000002,0.41666666700000005,22.96666667,2016-10-23,16,26,away,-3,MIA,200,198,45,54,25,28,Loss,67,256,4,1,0,BUF,53,267,454,0,Loss
0.41666666700000005,0.23076923100000002,37.03333333,2016-10-23,26,16,home,3,BUF,198,200,116,67,28,25,Win,256,67,1,4,0,MIA,53,454,267,0,Win
0.214285714,0.375,23.38333333,2016-10-23,11,16,away,-8,NYJ,234,189,35,57,16,24,Loss,11,155,2,5,2,BAL,40,245,344,3,Loss
0.375,0.214285714,36.61666667,2016-10-23,16,11,home,8,BAL,189,234,25,66,24,16,Win,155,11,5,2,3,NYJ,40,344,245,2,Win
0.428571429,0.4,33.81666667,2016-10-23,27,20,away,17,SFO,264,113,78,73,34,17,Win,249,160,2,4,3,TBB,51,513,273,1,Win
0.4,0.428571429,26.18333333,2016-10-23,20,27,home,-17,TBB,113,264,31,66,17,34,Loss,160,249,4,2,1,SFO,51,273,513,3,Loss
0.5625,0.5,35.48333333,2016-10-23,26,21,away,3,ATL,348,256,14,75,3,0,Win,78,130,4,3,1,LAC,3,426,386,2,Win
0.5,0.5625,30.5,2016-10-23,21,26,home,-3,LAC,256,348,70,63,0,3,Loss,130,78,3,4,2,ATL,3,386,426,1,Loss
0.583333333,0.3125,27.51666667,2016-10-23,21,17,away,11,PIT,222,281,40,55,27,16,Win,140,94,0,0,1,NEP,43,362,375,2,Win
0.3125,0.583333333,32.48333333,2016-10-23,17,21,home,-11,NEP,281,222,85,69,16,27,Loss,94,140,0,0,2,PIT,43,375,362,1,Loss
0.214285714,0.47619047600000003,28.65,2016-10-23,11,23,away,0,ARI,205,311,90,57,3,3,Tie,52,132,1,4,0,SEA,6,257,443,0,Loss
0.47619047600000003,0.214285714,46.35,2016-10-23,23,11,home,0,SEA,311,205,45,90,3,3,Tie,132,52,4,1,0,ARI,6,443,257,0,Win
0.38888888899999996,0.272727273,29.36666667,2016-10-24,14,19,away,-18,DEN,131,157,15,67,9,27,Loss,140,190,1,0,0,HOU,36,271,347,2,Loss
0.272727273,0.38888888899999996,30.63333333,2016-10-24,19,14,home,18,HOU,157,131,83,60,27,9,Win,190,140,0,1,2,DEN,36,347,271,0,Win
0.46153846200000004,0.6,25.58333333,2016-10-27,27,25,away,-14,TEN,322,280,75,67,22,36,Loss,48,214,2,0,0,JAX,58,370,494,1,Loss
0.6,0.46153846200000004,34.41666667,2016-10-27,25,27,home,14,JAX,280,322,54,66,36,22,Win,214,48,0,2,1,TEN,58,494,370,0,Win
0.470588235,0.533333333,39.7,2016-10-30,30,35,away,0,CIN,446,263,106,88,0,0,Tie,100,152,1,3,2,WAS,0,546,415,1,Tie
0.533333333,0.470588235,35.3,2016-10-30,35,30,home,0,WAS,263,446,85,81,0,0,Tie,152,100,3,1,1,CIN,0,415,546,2,Tie
0.4375,0.307692308,33.6,2016-10-30,20,18,away,16,IND,334,172,40,71,30,14,Win,88,105,3,6,2,KCC,44,422,277,0,Win
0.307692308,0.4375,26.4,2016-10-30,18,20,home,-16,KCC,172,334,45,62,14,30,Loss,105,88,6,3,0,IND,44,277,422,2,Loss
0.38888888899999996,0.307692308,44.2,2016-10-30,27,18,away,6,TBB,498,168,200,85,6,0,Win,128,102,2,2,0,OAK,6,626,270,1,Win
0.307692308,0.38888888899999996,29.05,2016-10-30,18,27,home,-6,OAK,168,498,64,61,0,6,Loss,102,128,2,2,1,TBB,6,270,626,0,Loss
0.454545455,0.6,23.8,2016-10-30,15,28,away,-5,NOS,285,252,76,54,20,25,Loss,74,123,1,2,1,SEA,45,359,375,1,Loss
0.6,0.454545455,36.2,2016-10-30,28,15,home,5,SEA,252,285,10,72,25,20,Win,123,74,2,1,1,NOS,45,375,359,1,Win
0.272727273,0.4,26.03333333,2016-10-30,19,20,away,-7,HOU,231,164,75,56,13,20,Loss,58,105,1,3,1,DET,33,289,269,0,Loss
0.4,0.272727273,33.96666667,2016-10-30,20,19,home,7,DET,164,231,49,63,20,13,Win,105,58,3,1,0,HOU,33,269,289,1,Win
0.46666666700000003,0.5,33.68333333,2016-10-30,21,22,away,3,CLE,222,339,37,71,31,28,Win,171,68,2,1,2,NYJ,59,393,407,0,Win
0.5,0.46666666700000003,26.31666667,2016-10-30,22,21,home,-3,NYJ,339,222,10,70,28,31,Loss,68,171,1,2,0,CLE,59,407,393,2,Loss
0.692307692,0.307692308,29.85,2016-10-30,23,25,away,16,BUF,285,209,116,61,41,25,Win,72,167,5,2,0,NEP,66,357,376,0,Win
0.307692308,0.692307692,30.15,2016-10-30,25,23,home,-16,NEP,209,285,84,68,25,41,Loss,167,72,2,5,0,BUF,66,376,357,0,Loss
0.333333333,0.428571429,29.2,2016-10-30,22,19,away,-10,CAR,316,208,88,64,20,30,Loss,24,141,8,1,1,ARI,50,340,349,2,Loss
0.428571429,0.333333333,30.8,2016-10-30,19,22,home,10,ARI,208,316,40,64,30,20,Win,141,24,1,8,2,CAR,50,349,340,1,Win
0.41176470600000004,0.333333333,33.13333333,2016-10-30,21,15,away,-8,DEN,246,267,52,77,19,27,Loss,123,57,4,1,3,LAC,46,369,324,3,Loss
0.333333333,0.41176470600000004,26.86666667,2016-10-30,15,21,home,8,LAC,267,246,45,64,27,19,Win,57,123,1,4,3,DEN,46,324,369,3,Win
0.6,0.444444444,31.28333333,2016-10-30,24,25,away,-1,ATL,223,277,68,60,32,33,Loss,108,90,3,2,0,GBP,65,331,367,0,Loss
0.444444444,0.6,28.71666667,2016-10-30,25,24,home,1,GBP,277,223,46,56,33,32,Win,90,108,2,3,0,ATL,65,367,331,0,Loss
0.4,0.28571428600000004,33.25,2016-10-30,21,26,away,-6,DAL,194,273,40,71,0,6,Loss,97,187,3,2,1,PHI,6,291,460,1,Loss
0.28571428600000004,0.4,33.95,2016-10-30,26,21,home,6,PHI,273,194,84,76,6,0,Win,187,97,2,3,1,DAL,6,460,291,1,Win
0.153846154,0.5,27.31666667,2016-10-31,15,19,away,-10,CHI,201,245,10,60,10,20,Loss,57,158,5,1,0,MIN,30,258,403,0,Loss
0.5,0.153846154,32.68333333,2016-10-31,19,15,home,10,MIN,245,201,20,61,20,10,Win,158,57,1,5,0,CHI,30,403,258,0,Win
0.6,0.571428571,33.46666667,2016-11-03,31,23,away,15,TBB,325,326,34,70,43,28,Win,136,70,2,2,2,ATL,71,461,396,1,Win
0.571428571,0.6,26.53333333,2016-11-03,23,31,home,-15,ATL,326,325,85,70,28,43,Loss,70,136,2,2,1,TBB,71,396,461,2,Loss
0.5,0.428571429,33.51666667,2016-11-06,18,22,away,6,MIN,214,259,57,62,6,0,Win,97,78,1,2,0,DET,6,311,337,1,Win
0.428571429,0.5,33.13333333,2016-11-06,22,18,home,-6,DET,259,214,54,67,0,6,Loss,78,97,2,1,1,MIN,6,337,311,0,Loss
0.2,0.307692308,32.66666667,2016-11-06,21,16,away,-5,NYG,347,248,43,74,23,28,Loss,96,54,2,1,2,PHI,51,443,302,2,Loss
0.307692308,0.2,27.33333333,2016-11-06,16,21,home,5,PHI,248,347,30,61,28,23,Win,54,96,1,2,2,NYG,51,302,443,2,Win
0.3,0.454545455,29.63333333,2016-11-06,18,20,away,-4,MIA,191,137,77,53,23,27,Loss,140,137,3,1,0,NYJ,50,331,274,2,Loss
0.454545455,0.3,30.36666667,2016-11-06,20,18,home,4,NYJ,137,191,85,62,27,23,Win,137,140,1,3,2,MIA,50,274,331,0,Win
0.384615385,0.071428571,29.65,2016-11-06,25,10,away,-5,KCC,244,169,46,75,14,19,Loss,205,62,2,2,0,JAX,33,449,231,4,Loss
0.071428571,0.384615385,30.35,2016-11-06,10,25,home,5,JAX,169,244,75,57,19,14,Win,62,205,2,2,4,KCC,33,231,449,0,Win
0.666666667,0.111111111,39.65,2016-11-06,29,13,away,25,CLE,255,177,38,70,35,10,Win,168,45,0,4,0,DAL,45,423,222,0,Win
0.111111111,0.666666667,20.35,2016-11-06,13,29,home,-25,DAL,177,255,33,44,10,35,Loss,45,168,4,0,0,CLE,45,222,423,0,Loss
0.25,0.235294118,27.83333333,2016-11-06,15,13,away,-7,BAL,241,224,99,65,14,21,Loss,36,50,2,3,1,PIT,35,277,274,1,Loss
0.235294118,0.25,32.16666667,2016-11-06,13,15,home,7,PIT,224,241,94,63,21,14,Win,50,36,3,2,1,BAL,35,274,277,1,Win
0.647058824,0.222222222,38.88333333,2016-11-06,29,19,away,18,SFO,323,393,40,82,41,23,Win,248,93,1,1,4,NOS,64,571,486,0,Win
0.222222222,0.647058824,21.11666667,2016-11-06,19,29,home,-18,NOS,393,323,78,57,23,41,Loss,93,248,1,1,0,SFO,64,486,571,4,Loss
0.4,0.28571428600000004,34.2,2016-11-06,16,18,away,3,LAR,185,280,35,62,13,10,Win,59,59,5,4,1,CAR,23,244,339,0,Win
0.28571428600000004,0.4,25.8,2016-11-06,18,16,home,-3,CAR,280,185,109,67,10,13,Loss,59,59,4,5,0,LAR,23,339,244,1,Loss
0.5,0.333333333,30.05,2016-11-06,22,25,away,5,GBP,270,289,35,66,31,26,Win,85,116,2,3,1,IND,57,355,405,2,Win
0.333333333,0.5,29.95,2016-11-06,25,22,home,-5,IND,289,270,25,65,26,31,Loss,116,85,3,2,2,GBP,57,405,355,1,Loss
0.454545455,0.454545455,23.51666667,2016-11-06,24,31,away,-8,LAC,313,268,57,62,35,43,Loss,80,208,0,1,0,TEN,78,393,476,3,Loss
0.454545455,0.454545455,36.48333333,2016-11-06,31,24,home,8,TEN,268,313,107,73,43,35,Win,208,80,1,0,3,LAC,78,476,393,0,Win
0.272727273,0.35714285700000004,18.53333333,2016-11-06,13,30,away,-10,OAK,266,179,104,51,20,30,Loss,33,218,2,2,0,DEN,50,299,397,2,Loss
0.35714285700000004,0.272727273,41.46666667,2016-11-06,30,13,home,10,DEN,179,266,72,76,30,20,Win,218,33,2,2,2,OAK,50,397,299,0,Win
0.705882353,0.28571428600000004,40.28333333,2016-11-07,30,19,away,-6,SEA,263,245,115,82,25,31,Loss,162,33,5,4,0,BUF,56,425,278,1,Loss
0.28571428600000004,0.705882353,19.71666667,2016-11-07,19,30,home,6,BUF,245,263,75,42,31,25,Win,33,162,4,5,1,SEA,56,278,425,0,Win
0.2,0.583333333,21.4,2016-11-10,11,29,away,-21,BAL,111,277,35,48,7,28,Loss,33,119,4,2,2,CLE,35,144,396,3,Loss
0.583333333,0.2,38.6,2016-11-10,29,11,home,21,CLE,277,111,61,77,28,7,Win,119,33,2,4,3,BAL,35,396,144,2,Win
0.46666666700000003,0.588235294,27.83333333,2016-11-13,16,23,away,3,JAX,92,247,89,61,24,21,Win,181,80,1,2,2,HOU,45,273,327,0,Win
0.588235294,0.46666666700000003,32.16666667,2016-11-13,23,16,home,-3,HOU,247,92,49,73,21,24,Loss,80,181,2,1,0,JAX,45,327,273,2,Loss
0.578947368,0.444444444,39.36666667,2016-11-13,24,19,away,2,NOS,234,293,10,83,25,23,Win,103,80,6,1,4,DEN,48,337,373,2,Win
0.444444444,0.578947368,20.63333333,2016-11-13,19,24,home,-2,DEN,293,234,25,51,23,25,Loss,80,103,1,6,2,NOS,48,373,337,4,Loss
0.352941176,0.333333333,34.48333333,2016-11-13,16,17,away,3,NYJ,155,157,55,67,9,6,Win,125,139,3,1,1,LAR,15,280,296,0,Win
0.333333333,0.352941176,25.51666667,2016-11-13,17,16,home,-3,LAR,157,155,31,58,6,9,Loss,139,125,1,3,0,NYJ,15,296,280,1,Loss
0.181818182,0.35714285700000004,21.83333333,2016-11-13,11,25,away,-9,PHI,255,221,67,48,15,24,Loss,48,208,2,2,1,ATL,39,303,429,1,Loss
0.35714285700000004,0.181818182,38.16666667,2016-11-13,25,11,home,9,ATL,221,255,77,76,24,15,Win,208,48,2,2,1,PHI,39,429,303,1,Win
0.166666667,0.428571429,24.8,2016-11-13,18,22,away,3,CAR,165,242,45,61,20,17,Win,91,99,3,2,2,KCC,37,256,341,1,Win
0.428571429,0.166666667,35.2,2016-11-13,22,18,home,-3,KCC,242,165,53,69,17,20,Loss,99,91,2,3,1,CAR,37,341,256,2,Loss
0.181818182,0.533333333,22.85,2016-11-13,15,22,away,-26,TBB,161,280,74,54,10,36,Loss,122,80,4,4,1,CHI,46,283,360,4,Loss
0.533333333,0.181818182,37.15,2016-11-13,22,15,home,26,CHI,280,161,85,68,36,10,Win,80,122,4,4,4,TBB,46,360,283,1,Win
0.454545455,0.5,30.06666667,2016-11-13,22,23,away,-6,WAS,284,260,35,64,20,26,Loss,47,128,3,1,1,MIN,46,331,388,1,Loss
0.5,0.454545455,29.93333333,2016-11-13,23,22,home,6,MIN,260,284,35,62,26,20,Win,128,47,1,3,1,WAS,46,388,331,1,Win
0.26666666699999997,0.5,30.48333333,2016-11-13,21,19,away,-22,TEN,333,292,107,73,25,47,Loss,69,154,5,1,0,GBP,72,402,446,3,Loss
0.5,0.26666666699999997,29.51666667,2016-11-13,19,21,home,22,GBP,292,333,65,59,47,25,Win,154,69,1,5,3,TEN,72,446,402,0,Win
0.4,0.545454545,27.01666667,2016-11-13,17,29,away,7,LAC,231,309,81,50,31,24,Win,106,70,1,3,4,MIA,55,337,379,1,Win
0.545454545,0.4,32.98333333,2016-11-13,29,17,home,-7,MIA,309,231,29,71,24,31,Loss,70,106,3,1,1,LAC,55,379,337,4,Loss
0.41176470600000004,0.5,27.7,2016-11-13,15,26,away,-3,ARI,198,363,100,61,20,23,Loss,83,80,3,2,4,SFO,43,281,443,1,Loss
0.5,0.41176470600000004,32.3,2016-11-13,26,15,home,3,SFO,363,198,10,74,23,20,Win,80,83,2,3,1,ARI,43,443,281,4,Win
0.538461538,0.4,30.4,2016-11-13,20,30,away,5,PIT,295,400,98,59,35,30,Win,127,48,2,1,0,DAL,65,422,448,1,Win
0.4,0.538461538,29.6,2016-11-13,30,20,home,-5,DAL,400,295,40,66,30,35,Loss,48,127,1,2,1,PIT,65,448,422,0,Loss
0.5,0.6,30.41666667,2016-11-13,23,25,away,7,NEP,324,304,60,66,31,24,Win,96,81,3,2,2,SEA,55,420,385,0,Win
0.6,0.5,29.58333333,2016-11-13,25,23,home,-7,SEA,304,324,61,62,24,31,Loss,81,96,2,3,0,NEP,55,385,420,2,Loss
0.181818182,0.428571429,28.61666667,2016-11-14,12,23,away,-1,NYG,186,229,60,55,20,21,Loss,78,122,3,1,2,CIN,41,264,351,1,Loss
0.428571429,0.181818182,31.38333333,2016-11-14,23,12,home,1,CIN,229,186,15,72,21,20,Win,122,78,1,3,1,NYG,41,351,264,2,Win
0.307692308,0.41176470600000004,32.25,2016-11-17,28,17,away,-3,CAR,264,173,48,72,20,23,Loss,107,50,3,2,0,NOS,43,371,223,2,Loss
0.41176470600000004,0.307692308,27.75,2016-11-17,17,28,home,3,NOS,173,264,45,62,23,20,Win,50,107,2,3,2,CAR,43,223,371,0,Win
0.41666666700000005,0.26666666699999997,33.96666667,2016-11-20,24,17,away,15,CLE,167,176,70,64,24,9,Win,146,33,0,8,2,PIT,33,313,209,0,Win
0.26666666699999997,0.41666666700000005,26.03333333,2016-11-20,17,24,home,-15,PIT,176,167,52,62,9,24,Loss,33,146,8,0,0,CLE,33,209,313,2,Loss
0.333333333,0.583333333,24.35,2016-11-20,17,27,away,-10,DAL,267,299,136,52,17,27,Loss,101,118,1,1,0,BAL,44,368,417,0,Loss
0.583333333,0.333333333,35.65,2016-11-20,27,17,home,10,BAL,299,267,45,67,27,17,Win,118,101,1,1,0,DAL,44,417,368,0,Win
0.28571428600000004,0.35714285700000004,32.91666667,2016-11-20,16,14,away,-7,DET,202,263,25,62,19,26,Loss,83,14,0,3,2,JAX,45,285,277,3,Loss
0.35714285700000004,0.28571428600000004,27.08333333,2016-11-20,14,16,home,7,JAX,263,202,32,57,26,19,Win,14,83,3,0,3,DET,45,277,285,2,Win
0.35714285700000004,0.41666666700000005,31.01666667,2016-11-20,20,18,away,-7,IND,254,251,109,70,17,24,Loss,97,76,5,2,1,TEN,41,351,327,0,Loss
0.41666666700000005,0.35714285700000004,28.98333333,2016-11-20,18,20,home,7,TEN,251,254,70,58,24,17,Win,76,97,2,5,0,IND,41,327,351,1,Win
0.25,0.533333333,32.18333333,2016-11-20,20,23,away,4,CIN,159,207,75,63,16,12,Win,183,93,2,1,2,BUF,28,342,300,1,Win
0.533333333,0.25,27.81666667,2016-11-20,23,20,home,-4,BUF,207,159,25,71,12,16,Loss,93,183,1,2,1,CIN,28,300,342,2,Loss
0.6875,0.5,35.3,2016-11-20,27,19,away,2,KCC,326,261,42,74,19,17,Win,116,82,1,0,2,TBB,36,442,343,1,Win
0.5,0.6875,24.7,2016-11-20,19,27,home,-2,TBB,261,326,30,52,17,19,Loss,82,116,0,1,1,KCC,36,343,442,2,Loss
0.333333333,0.35714285700000004,30.48333333,2016-11-20,17,19,away,-6,NYG,222,227,40,59,16,22,Loss,93,102,4,0,0,CHI,38,315,329,1,Loss
0.35714285700000004,0.333333333,29.51666667,2016-11-20,19,17,home,6,CHI,227,222,35,65,22,16,Win,102,93,0,4,1,NYG,38,329,315,0,Win
0.307692308,0.46153846200000004,31.03333333,2016-11-20,24,16,away,-6,MIN,155,145,96,70,24,30,Loss,135,72,4,2,1,ARI,54,290,217,2,Loss
0.46153846200000004,0.307692308,28.96666667,2016-11-20,16,24,home,6,ARI,145,155,73,54,30,24,Win,72,135,2,4,2,MIN,54,217,290,1,Win
0.090909091,0.153846154,28.68333333,2016-11-20,17,12,away,4,LAR,142,125,82,57,14,10,Win,98,102,4,1,1,MIA,24,240,227,1,Win
0.153846154,0.090909091,31.31666667,2016-11-20,12,17,home,-4,MIA,125,142,70,60,10,14,Loss,102,98,1,4,1,LAR,24,227,240,1,Loss
0.5,0.35714285700000004,29.28333333,2016-11-20,28,20,away,13,SFO,273,177,40,71,30,17,Win,171,122,1,5,0,NEP,47,444,299,0,Win
0.35714285700000004,0.5,30.71666667,2016-11-20,20,28,home,-13,NEP,177,273,68,62,17,30,Loss,122,171,5,1,0,SFO,47,299,444,0,Loss
0.375,0.333333333,31.1,2016-11-20,20,18,away,-11,SEA,195,287,48,73,15,26,Loss,113,152,2,1,0,PHI,41,308,439,2,Loss
0.333333333,0.375,28.9,2016-11-20,18,20,home,11,PHI,287,195,48,63,26,15,Win,152,113,1,2,2,SEA,41,439,308,0,Win
0.46666666700000003,0.642857143,30.38333333,2016-11-20,19,21,away,-18,WAS,340,364,59,65,24,42,Loss,84,151,2,2,0,GBP,66,424,515,2,Loss
0.642857143,0.46666666700000003,29.61666667,2016-11-20,21,19,home,18,GBP,364,340,40,62,42,24,Win,151,84,2,2,2,WAS,66,515,424,0,Win
0.5,0.363636364,36.45,2016-11-21,22,16,away,-7,OAK,230,295,101,74,20,27,Loss,124,30,2,0,1,HOU,47,354,325,2,Loss
0.363636364,0.5,23.55,2016-11-21,16,22,home,7,HOU,295,230,21,51,27,20,Win,30,124,0,2,2,OAK,47,325,354,1,Win
0.2,0.428571429,31.51666667,2016-11-24,17,18,away,-3,DET,224,214,40,53,13,16,Loss,82,94,0,2,0,MIN,29,306,308,1,Loss
0.428571429,0.2,28.48333333,2016-11-24,18,17,home,3,MIN,214,224,16,61,16,13,Win,94,82,2,0,1,DET,29,308,306,0,Win
0.533333333,0.5,33.4,2016-11-24,25,24,away,-5,DAL,449,190,30,72,26,31,Loss,56,163,0,1,0,WAS,57,505,353,0,Loss
0.5,0.533333333,26.6,2016-11-24,24,25,home,5,WAS,190,449,25,55,31,26,Win,163,56,1,0,0,DAL,57,353,505,0,Win
0.636363636,0.533333333,28.25,2016-11-24,16,18,away,21,IND,221,219,67,50,28,7,Win,148,91,0,3,2,PIT,35,369,310,0,Win
0.533333333,0.636363636,31.75,2016-11-24,18,16,home,-21,PIT,219,221,10,63,7,28,Loss,91,148,3,0,0,IND,35,310,369,2,Loss
0.454545455,0.529411765,29.41666667,2016-11-27,18,25,away,6,CHI,226,316,118,52,27,21,Win,149,95,0,0,2,TEN,48,375,411,0,Win
0.529411765,0.454545455,30.58333333,2016-11-27,25,18,home,-6,TEN,316,226,48,76,21,27,Loss,95,149,0,0,0,CHI,48,411,375,2,Loss
0.533333333,0.41666666700000005,33.58333333,2016-11-27,20,15,away,-7,BUF,118,151,60,65,21,28,Loss,183,153,2,5,0,JAX,49,301,304,0,Loss
0.41666666700000005,0.533333333,26.41666667,2016-11-27,15,20,home,7,JAX,151,118,31,52,28,21,Win,153,183,5,2,0,BUF,49,304,301,0,Win
0.3125,0.3125,28.71666667,2016-11-27,22,16,away,-5,BAL,261,219,15,71,14,19,Loss,64,92,3,2,1,CIN,33,325,311,2,Loss
0.3125,0.3125,31.28333333,2016-11-27,16,22,home,5,CIN,219,261,69,68,19,14,Win,92,64,2,3,2,BAL,33,311,325,1,Win
0.363636364,0.444444444,25.63333333,2016-11-27,23,28,away,-19,ATL,274,244,60,61,19,38,Loss,58,116,2,3,1,ARI,57,332,360,1,Loss
0.444444444,0.363636364,34.36666667,2016-11-27,28,23,home,19,ARI,244,274,23,67,38,19,Win,116,58,3,2,1,ATL,57,360,332,1,Win
0.307692308,0.214285714,26.15,2016-11-27,13,21,away,14,CLE,192,285,100,55,27,13,Win,104,58,1,7,3,NYG,40,296,343,1,Win
0.214285714,0.307692308,33.85,2016-11-27,21,13,home,-14,NYG,285,192,35,72,13,27,Loss,58,104,7,1,1,CLE,40,343,296,3,Loss
0.2,0.46153846200000004,24.06666667,2016-11-27,13,27,away,-28,NOS,178,346,62,52,21,49,Loss,69,209,3,2,1,LAR,70,247,555,2,Loss
0.46153846200000004,0.2,35.93333333,2016-11-27,27,13,home,28,LAR,346,178,45,71,49,21,Win,209,69,2,3,2,NOS,70,555,247,1,Win
0.5,0.5,29.46666667,2016-11-27,25,19,away,-7,MIA,282,263,65,73,24,31,Loss,193,95,2,2,0,SFO,55,475,358,2,Loss
0.5,0.5,30.53333333,2016-11-27,19,25,home,7,SFO,263,282,42,58,31,24,Win,95,193,2,2,2,MIA,55,358,475,0,Win
0.363636364,0.363636364,29.98333333,2016-11-27,18,22,away,8,HOU,235,239,78,49,21,13,Win,67,114,1,1,4,LAC,34,302,353,1,Win
0.363636364,0.363636364,30.01666667,2016-11-27,22,18,home,-8,LAC,239,235,58,65,13,21,Loss,114,67,1,1,1,HOU,34,353,302,4,Loss
0.090909091,0.363636364,26.35,2016-11-27,16,19,away,-9,TBB,118,220,27,61,5,14,Loss,127,118,6,0,2,SEA,19,245,338,3,Loss
0.363636364,0.090909091,33.65,2016-11-27,19,16,home,9,SEA,220,118,68,63,14,5,Win,118,127,0,6,3,TBB,19,338,245,2,Win
0.3,0.533333333,26.38333333,2016-11-27,19,22,away,-3,OAK,229,310,67,56,32,35,Loss,129,56,2,1,2,CAR,67,358,366,2,Loss
0.533333333,0.3,33.61666667,2016-11-27,22,19,home,3,CAR,310,229,46,71,35,32,Win,56,129,1,2,2,OAK,67,366,358,2,Win
0.28571428600000004,0.454545455,30.6,2016-11-27,26,16,away,5,NYJ,286,269,15,71,22,17,Win,91,64,0,1,2,NEP,39,377,333,0,Win
0.454545455,0.28571428600000004,29.4,2016-11-27,16,26,home,-5,NEP,269,286,66,56,17,22,Loss,64,91,1,0,0,NYJ,39,333,377,2,Loss
0.294117647,0.45,37.65,2016-11-27,23,21,away,3,DEN,190,340,71,76,6,3,Win,83,124,6,5,1,KCC,9,273,464,0,Loss
0.45,0.294117647,37.31666667,2016-11-27,21,23,home,-3,KCC,340,190,97,77,3,6,Loss,124,83,5,6,0,DEN,9,464,273,1,Win
0.7142857140000001,0.454545455,35.38333333,2016-11-28,25,20,away,14,PHI,313,211,51,67,27,13,Win,74,81,0,4,1,GBP,40,387,292,0,Win
0.454545455,0.7142857140000001,24.61666667,2016-11-28,20,25,home,-14,GBP,211,313,42,58,13,27,Loss,81,74,4,0,0,PHI,40,292,387,1,Loss
0.111111111,0.375,26.71666667,2016-12-01,13,21,away,2,MIN,124,231,78,49,17,15,Win,140,87,3,3,1,DAL,32,264,318,2,Win
0.375,0.111111111,33.28333333,2016-12-01,21,13,home,-2,DAL,231,124,57,69,15,17,Loss,87,140,3,3,2,MIN,32,318,264,1,Win
0.3,0.6,28.13333333,2016-12-04,17,32,away,1,ATL,266,290,128,48,29,28,Win,123,128,1,2,1,KCC,57,389,418,1,Win
0.6,0.3,31.86666667,2016-12-04,32,17,home,-1,KCC,290,266,30,66,28,29,Loss,128,123,2,1,1,ATL,57,418,389,1,Win
0.41666666700000005,0.46153846200000004,36.86666667,2016-12-04,24,20,away,15,NOS,337,319,39,67,28,13,Win,85,50,2,1,3,DET,41,422,369,0,Win
0.46153846200000004,0.41666666700000005,23.13333333,2016-12-04,20,24,home,-15,DET,319,337,83,57,13,28,Loss,50,85,1,2,0,NOS,41,369,422,3,Loss
0.083333333,0.25,22.05,2016-12-04,7,20,away,-16,NEP,126,269,30,49,10,26,Loss,36,133,4,0,0,LAR,36,162,402,2,Loss
0.25,0.083333333,37.95,2016-12-04,20,7,home,16,LAR,269,126,46,75,26,10,Win,133,36,0,4,2,NEP,36,402,162,0,Win
0.076923077,0.333333333,25.43333333,2016-12-04,10,19,away,10,JAX,102,179,32,54,20,10,Win,104,154,2,1,3,DEN,30,206,333,0,Win
0.333333333,0.076923077,34.56666667,2016-12-04,19,10,home,-10,DEN,179,102,65,81,10,20,Loss,154,104,1,2,0,JAX,30,333,206,3,Loss
0.4,0.333333333,31.51666667,2016-12-04,17,16,away,-8,GBP,184,200,12,64,13,21,Loss,123,109,2,1,1,HOU,34,307,309,1,Loss
0.333333333,0.4,28.48333333,2016-12-04,16,17,home,8,HOU,200,184,30,57,21,13,Win,109,123,1,2,1,GBP,34,309,307,1,Win
0.470588235,0.5,31.96666667,2016-12-04,22,21,away,-18,CIN,306,332,88,80,14,32,Loss,53,80,1,0,2,PHI,46,359,412,3,Loss
0.5,0.470588235,28.03333333,2016-12-04,21,22,home,18,PHI,332,306,23,64,32,14,Win,80,53,0,1,3,CIN,46,412,359,2,Win
0.307692308,0.454545455,30.76666667,2016-12-04,16,28,away,-32,BAL,215,386,57,58,6,38,Loss,62,110,2,0,2,MIA,44,277,496,3,Loss
0.454545455,0.307692308,29.23333333,2016-12-04,28,16,home,32,MIA,386,215,68,70,38,6,Win,110,62,0,2,3,BAL,44,496,277,2,Win
0.28571428600000004,0.428571429,28.7,2016-12-04,10,19,away,-20,CHI,6,184,106,55,6,26,Loss,141,142,6,1,1,SFO,32,147,326,0,Loss
0.428571429,0.28571428600000004,31.3,2016-12-04,19,10,home,20,SFO,184,6,40,59,26,6,Win,142,141,1,6,0,CHI,32,326,147,1,Win
0.6,0.384615385,30.25,2016-12-04,24,24,away,-14,OAK,170,260,73,69,24,38,Loss,212,139,4,0,0,BUF,62,382,399,2,Loss
0.384615385,0.6,29.75,2016-12-04,24,24,home,14,BUF,260,170,65,67,38,24,Win,139,212,0,4,2,OAK,62,399,382,0,Win
0.363636364,0.46666666700000003,25.86666667,2016-12-04,16,20,away,-10,PIT,178,272,24,55,14,24,Loss,56,117,2,2,2,NYG,38,234,389,2,Loss
0.46666666700000003,0.363636364,34.13333333,2016-12-04,20,16,home,10,NYG,272,178,115,69,24,14,Win,117,56,2,2,2,PIT,38,389,234,2,Win
0.454545455,0.625,26.23333333,2016-12-04,19,24,away,-8,ARI,246,281,35,57,23,31,Loss,87,88,2,2,0,WAS,54,333,369,2,Loss
0.625,0.454545455,33.76666667,2016-12-04,24,19,home,8,WAS,281,246,51,72,31,23,Win,88,87,2,2,2,ARI,54,369,333,0,Win
0.384615385,0.5,31.68333333,2016-12-04,20,18,away,7,LAC,268,211,35,61,28,21,Win,81,119,1,2,2,TBB,49,349,330,1,Win
0.5,0.384615385,28.31666667,2016-12-04,18,20,home,-7,TBB,211,268,45,53,21,28,Loss,119,81,2,1,1,LAC,49,330,349,2,Loss
0.41666666700000005,0.5,25.98333333,2016-12-04,14,29,away,-33,SEA,182,294,63,54,7,40,Loss,89,240,0,3,1,CAR,47,271,534,2,Loss
0.5,0.41666666700000005,34.01666667,2016-12-04,29,14,home,33,CAR,294,182,37,71,40,7,Win,240,89,3,0,2,SEA,47,534,271,1,Win
0.538461538,0.272727273,38.4,2016-12-05,27,13,away,31,NYJ,282,214,28,70,41,10,Win,139,36,1,1,3,IND,51,421,250,1,Win
0.272727273,0.538461538,21.6,2016-12-05,13,27,home,-31,IND,214,282,90,52,10,41,Loss,36,139,1,1,1,NYJ,51,250,421,3,Loss
0.27777777800000003,0.454545455,31.75,2016-12-08,18,14,away,-8,KCC,109,258,82,73,13,21,Loss,135,65,1,1,3,OAK,34,244,323,0,Loss
0.454545455,0.27777777800000003,28.25,2016-12-08,14,18,home,8,OAK,258,109,73,54,21,13,Win,65,135,1,1,0,KCC,34,323,244,3,Win
0.428571429,0.333333333,38.68333333,2016-12-11,24,14,away,7,BUF,220,208,45,73,27,20,Win,240,67,0,5,1,PIT,47,460,275,3,Win
0.333333333,0.428571429,21.31666667,2016-12-11,14,24,home,-7,PIT,208,220,46,48,20,27,Loss,67,240,5,0,3,BUF,47,275,460,1,Loss
0.272727273,0.375,27.55,2016-12-11,19,16,away,-3,TEN,330,73,87,64,10,13,Loss,18,180,3,2,0,DEN,23,348,253,2,Loss
0.375,0.272727273,32.45,2016-12-11,16,19,home,3,DEN,73,330,55,65,13,10,Win,180,18,2,3,2,TEN,23,253,348,0,Win
0.28571428600000004,0.5,23.36666667,2016-12-11,16,24,away,5,PHI,227,288,86,46,27,22,Win,107,95,2,4,2,WAS,49,334,383,1,Win
0.5,0.28571428600000004,36.63333333,2016-12-11,24,16,home,-5,WAS,288,227,54,76,22,27,Loss,95,107,4,2,1,PHI,49,383,334,2,Loss
0.307692308,0.307692308,29.93333333,2016-12-11,21,15,away,-3,MIA,125,231,54,63,23,26,Loss,175,83,3,1,3,ARI,49,300,314,4,Loss
0.307692308,0.307692308,30.06666667,2016-12-11,15,21,home,3,ARI,231,125,118,57,26,23,Win,83,175,1,3,4,MIA,49,314,300,3,Win
0.384615385,0.333333333,27.38333333,2016-12-11,17,17,away,-12,CAR,220,146,32,64,16,28,Loss,58,126,5,2,1,LAC,44,278,272,5,Loss
0.333333333,0.384615385,32.61666667,2016-12-11,17,17,home,12,LAC,146,220,35,67,28,16,Win,126,58,2,5,5,CAR,44,272,278,1,Win
0.533333333,0.428571429,34.88333333,2016-12-11,21,13,away,13,CLE,147,85,43,70,23,10,Win,213,169,4,3,1,CIN,33,360,254,0,Win
0.428571429,0.533333333,25.11666667,2016-12-11,13,21,home,-13,CIN,85,147,34,53,10,23,Loss,169,213,3,4,0,CLE,33,254,360,1,Loss
0.4,0.5,25.71666667,2016-12-11,16,25,away,-3,DET,204,209,139,50,17,20,Loss,92,114,1,3,2,CHI,37,296,323,0,Win
0.5,0.4,34.28333333,2016-12-11,25,16,home,3,CHI,209,204,55,66,20,17,Win,114,92,3,1,0,DET,37,323,296,2,Win
0.35714285700000004,0.41666666700000005,36.08333333,2016-12-11,20,21,away,5,IND,131,265,124,67,22,17,Win,185,83,2,1,3,HOU,39,316,348,1,Loss
0.41666666700000005,0.35714285700000004,23.91666667,2016-12-11,21,20,home,-5,HOU,265,131,59,61,17,22,Loss,83,185,1,2,1,IND,39,348,316,3,Loss
0.272727273,0.4375,31.11666667,2016-12-11,22,18,away,9,JAX,292,230,93,63,25,16,Win,85,85,0,4,0,MIN,41,377,315,1,Win
0.4375,0.272727273,28.88333333,2016-12-11,18,22,home,-9,MIN,230,292,114,65,16,25,Loss,85,85,4,0,1,JAX,41,315,377,0,Loss
0.444444444,0.166666667,41.91666667,2016-12-11,24,17,away,6,SFO,216,116,56,81,6,0,Win,188,248,6,2,0,NYJ,6,404,364,1,Win
0.166666667,0.444444444,24.5,2016-12-11,17,24,home,-6,NYJ,116,216,25,55,0,6,Loss,248,188,2,6,1,SFO,6,364,404,0,Loss
0.307692308,0.46153846200000004,26.75,2016-12-11,14,21,away,-5,TBB,248,166,104,58,11,16,Loss,46,104,1,2,0,NOS,27,294,270,3,Loss
0.46153846200000004,0.307692308,33.25,2016-12-11,21,14,home,5,NOS,166,248,65,63,16,11,Win,104,46,2,1,3,TBB,27,270,294,0,Win
0.307692308,0.428571429,27.13333333,2016-12-11,18,21,away,28,LAR,220,208,40,57,42,14,Win,66,104,2,3,5,ATL,56,286,312,0,Win
0.428571429,0.307692308,32.86666667,2016-12-11,21,18,home,-28,ATL,208,220,105,67,14,42,Loss,104,66,3,2,0,LAR,56,312,286,5,Loss
0.5,0.363636364,31.83333333,2016-12-11,22,18,away,-28,GBP,218,237,63,68,10,38,Loss,136,93,3,1,0,SEA,48,354,330,6,Loss
0.363636364,0.5,28.16666667,2016-12-11,18,22,home,28,SEA,237,218,50,56,38,10,Win,93,136,1,3,6,GBP,48,330,354,0,Win
0.066666667,0.14285714300000002,29.13333333,2016-12-11,13,12,away,-3,NYG,152,167,54,65,7,10,Loss,108,93,3,3,3,DAL,17,260,260,3,Loss
0.14285714300000002,0.066666667,30.86666667,2016-12-11,12,13,home,3,DAL,167,152,50,64,10,7,Win,93,108,3,3,3,NYG,17,260,260,3,Loss
0.375,0.5,30.76666667,2016-12-12,17,20,away,-7,NEP,306,401,47,68,23,30,Loss,42,95,2,1,3,BAL,53,348,496,1,Loss
0.5,0.375,29.23333333,2016-12-12,20,17,home,7,BAL,401,306,48,65,30,23,Win,95,42,1,2,1,NEP,53,496,348,3,Win
0.25,0.46666666700000003,27.48333333,2016-12-15,13,19,away,-21,SEA,136,227,76,56,3,24,Loss,47,72,4,2,1,LAR,27,183,299,0,Loss
0.46666666700000003,0.25,32.51666667,2016-12-15,19,13,home,21,LAR,227,136,86,58,24,3,Win,72,47,2,4,0,SEA,27,299,183,1,Win
0.41666666700000005,0.333333333,27.46666667,2016-12-17,13,20,away,21,NYJ,236,244,70,46,34,13,Win,67,116,1,3,4,MIA,47,303,360,1,Win
0.333333333,0.41666666700000005,32.53333333,2016-12-17,20,13,home,-21,MIA,244,236,42,72,13,34,Loss,116,67,3,1,1,NYJ,47,360,303,4,Loss
0.3,0.375,32.78333333,2016-12-18,20,29,away,3,CHI,225,354,64,58,30,27,Win,226,95,4,1,4,GBP,57,451,449,0,Win
0.375,0.3,27.21666667,2016-12-18,29,20,home,-3,GBP,354,225,40,63,27,30,Loss,95,226,1,4,0,CHI,57,449,451,4,Loss
0.23076923100000002,0.28571428600000004,23.3,2016-12-18,9,23,away,-1,HOU,83,308,91,50,20,21,Loss,67,79,2,0,2,JAX,41,150,387,1,Loss
0.28571428600000004,0.23076923100000002,36.7,2016-12-18,23,9,home,1,JAX,308,83,71,78,21,20,Win,79,67,0,2,1,HOU,41,387,150,2,Win
0.272727273,0.444444444,25.68333333,2016-12-18,16,29,away,-20,BUF,162,171,51,54,13,33,Loss,107,280,5,1,0,CLE,46,269,451,0,Loss
0.444444444,0.272727273,34.31666667,2016-12-18,29,16,home,20,CLE,171,162,42,66,33,13,Win,280,107,1,5,0,BUF,46,451,269,0,Win
0.444444444,0.363636364,36.63333333,2016-12-18,27,18,away,-1,BAL,159,189,30,81,26,27,Loss,169,151,1,3,2,PHI,53,328,340,1,Win
0.363636364,0.444444444,23.36666667,2016-12-18,18,27,home,1,PHI,189,159,62,57,27,26,Win,151,169,3,1,1,BAL,53,340,328,2,Loss
0.428571429,0.28571428600000004,30.58333333,2016-12-18,21,13,away,2,KCC,241,159,25,63,19,17,Win,148,157,1,1,1,TEN,36,389,316,3,Loss
0.28571428600000004,0.428571429,29.41666667,2016-12-18,13,21,home,-2,TEN,159,241,40,57,17,19,Loss,157,148,1,1,3,KCC,36,316,389,1,Win
0.35714285700000004,0.46666666700000003,29.73333333,2016-12-18,16,17,away,-11,NYG,268,186,15,59,6,17,Loss,56,114,1,2,0,DET,23,324,300,2,Loss
0.46666666700000003,0.35714285700000004,30.26666667,2016-12-18,17,16,home,11,DET,186,268,46,62,17,6,Win,114,56,2,1,2,NYG,23,300,324,0,Win
0.538461538,0.333333333,37.03333333,2016-12-18,27,20,away,28,MIN,250,248,55,68,34,6,Win,161,34,0,5,3,IND,40,411,282,0,Win
0.333333333,0.538461538,22.96666667,2016-12-18,20,27,home,-28,IND,248,250,27,56,6,34,Loss,34,161,5,0,0,MIN,40,282,411,3,Loss
0.384615385,0.5,32.53333333,2016-12-18,26,19,away,4,CIN,285,146,104,66,24,20,Win,97,76,1,1,1,PIT,44,382,222,0,Win
0.5,0.384615385,27.46666667,2016-12-18,19,26,home,-4,PIT,146,285,86,56,20,24,Loss,76,97,1,1,0,CIN,44,222,382,1,Loss
0.642857143,0.5,37.21666667,2016-12-18,33,26,away,7,ARI,358,309,46,83,48,41,Win,130,116,3,1,2,NOS,89,488,425,1,Win
0.5,0.642857143,22.78333333,2016-12-18,26,33,home,-7,NOS,309,358,52,56,41,48,Loss,116,130,1,3,1,ARI,89,425,488,2,Loss
0.46153846200000004,0.5555555560000001,23.98333333,2016-12-18,15,29,away,-28,ATL,165,302,20,55,13,41,Loss,107,248,2,1,1,SFO,54,272,550,1,Loss
0.5555555560000001,0.46153846200000004,36.01666667,2016-12-18,29,15,home,28,SFO,302,165,27,66,41,13,Win,248,107,1,2,1,ATL,54,550,272,1,Win
0.294117647,0.166666667,33.6,2016-12-18,20,15,away,13,DEN,177,251,30,73,16,3,Win,136,58,2,4,3,NEP,19,313,309,0,Win
0.166666667,0.294117647,26.4,2016-12-18,15,20,home,-13,NEP,251,177,49,61,3,16,Loss,58,136,4,2,0,DEN,19,309,313,3,Loss
0.307692308,0.533333333,32.28333333,2016-12-18,18,14,away,3,LAC,200,190,15,61,19,16,Win,145,73,2,3,2,OAK,35,345,263,2,Loss
0.533333333,0.307692308,27.71666667,2016-12-18,14,18,home,-3,OAK,190,200,44,55,16,19,Loss,73,145,3,2,2,LAC,35,263,345,2,Win
0.333333333,0.384615385,23.93333333,2016-12-18,16,24,away,-6,DAL,224,264,35,59,20,26,Loss,52,185,4,3,1,TBB,46,276,449,4,Loss
0.384615385,0.333333333,36.06666667,2016-12-18,24,16,home,6,TBB,264,224,91,71,26,20,Win,185,52,3,4,4,DAL,46,449,276,1,Win
0.26666666699999997,0.166666667,34.65,2016-12-19,22,18,away,11,WAS,290,306,62,72,26,15,Win,148,29,2,1,3,CAR,41,438,335,0,Win
0.166666667,0.26666666699999997,25.35,2016-12-19,18,22,home,-11,CAR,306,290,70,61,15,26,Loss,29,148,1,2,0,WAS,41,335,438,3,Loss
0.454545455,0.333333333,34.06666667,2016-12-22,24,15,away,-5,PHI,356,168,50,88,19,24,Loss,114,118,0,0,1,NYG,43,470,286,3,Loss
0.333333333,0.454545455,25.93333333,2016-12-22,15,24,home,5,NYG,168,356,5,55,24,19,Win,118,114,0,0,3,PHI,43,286,470,1,Win
0.41666666700000005,0.444444444,33.66666667,2016-12-24,22,30,away,3,BUF,233,317,15,68,3,0,Win,261,272,0,2,0,MIA,3,494,589,1,Win
0.444444444,0.41666666700000005,40.55,2016-12-24,30,22,home,-3,MIA,317,233,35,90,0,3,Loss,272,261,2,0,1,BUF,3,589,494,0,Tie
0.090909091,0.611111111,25.28333333,2016-12-24,14,21,away,-38,NEP,128,211,77,55,3,41,Loss,111,114,2,1,0,NYJ,44,239,325,4,Loss
0.611111111,0.090909091,34.71666667,2016-12-24,21,14,home,38,NYJ,211,128,20,70,41,3,Win,114,111,1,2,4,NEP,44,325,239,0,Win
0.35714285700000004,0.333333333,27.48333333,2016-12-24,19,25,away,-21,JAX,205,331,49,67,17,38,Loss,58,84,3,2,1,TEN,55,263,415,1,Loss
0.333333333,0.35714285700000004,32.51666667,2016-12-24,25,19,home,21,TEN,331,205,45,69,38,17,Win,84,58,2,3,1,JAX,55,415,263,1,Win
0.333333333,0.46153846200000004,31.01666667,2016-12-24,22,19,away,-13,GBP,353,308,70,74,25,38,Loss,93,40,4,4,0,MIN,63,446,348,2,Loss
0.46153846200000004,0.333333333,28.98333333,2016-12-24,19,22,home,13,MIN,308,353,21,58,38,25,Win,40,93,4,4,2,GBP,63,348,446,0,Win
0.333333333,0.4,27.51666667,2016-12-24,19,23,away,-3,CLE,322,127,92,65,17,20,Loss,34,124,0,9,0,LAC,37,356,251,1,Loss
0.4,0.333333333,32.48333333,2016-12-24,23,19,home,3,LAC,127,322,44,66,20,17,Win,124,34,9,0,1,CLE,37,251,356,0,Win
0.615384615,0.7,32.58333333,2016-12-24,21,31,away,20,CHI,270,318,73,64,41,21,Win,208,140,0,1,5,WAS,62,478,458,0,Win
0.7,0.615384615,27.41666667,2016-12-24,31,21,home,-20,WAS,318,270,52,67,21,41,Loss,140,208,1,0,0,CHI,62,458,478,5,Loss
0.428571429,0.26666666699999997,32.75,2016-12-24,21,17,away,17,CAR,256,183,45,61,33,16,Win,152,119,4,2,2,ATL,49,408,302,0,Win
0.26666666699999997,0.428571429,27.25,2016-12-24,17,21,home,-17,ATL,183,256,24,68,16,33,Loss,119,152,2,4,0,CAR,49,302,408,2,Loss
0.5,0.6,23.91666667,2016-12-24,20,27,away,-8,OAK,288,253,22,53,25,33,Loss,102,210,0,1,0,IND,58,390,463,3,Loss
0.6,0.5,36.08333333,2016-12-24,27,20,home,8,IND,253,288,97,72,33,25,Win,210,102,1,0,3,OAK,58,463,390,0,Win
0.583333333,0.41666666700000005,28.4,2016-12-24,23,25,away,-7,NOS,260,294,63,58,24,31,Loss,89,123,2,2,0,TBB,55,349,417,2,Loss
0.41666666700000005,0.583333333,31.6,2016-12-24,25,23,home,7,TBB,294,260,59,67,31,24,Win,123,89,2,2,2,NOS,55,417,349,0,Win
0.111111111,0.470588235,26.3,2016-12-24,21,24,away,3,SEA,276,313,85,57,34,31,Win,94,78,1,6,1,ARI,65,370,391,1,Win
0.470588235,0.111111111,33.7,2016-12-24,24,21,home,-3,ARI,313,276,40,78,31,34,Loss,78,94,6,1,1,SEA,65,391,370,1,Loss
0.375,0.307692308,31.05,2016-12-24,21,13,away,1,LAR,253,78,100,70,22,21,Win,70,99,4,4,2,SFO,43,323,177,2,Loss
0.307692308,0.375,28.95,2016-12-24,13,21,home,-1,SFO,78,253,45,57,21,22,Loss,99,70,4,4,2,LAR,43,177,323,2,Loss
0.4375,0.28571428600000004,28.9,2016-12-24,15,17,away,-2,HOU,244,155,60,63,10,12,Loss,50,95,3,4,0,CIN,22,294,250,1,Loss
0.28571428600000004,0.4375,31.1,2016-12-24,17,15,home,2,CIN,155,244,25,57,12,10,Win,95,50,4,3,1,HOU,22,250,294,0,Win
0.529411765,0.428571429,34.61666667,2016-12-25,22,23,away,-4,PIT,246,279,95,72,27,31,Loss,122,127,2,0,2,BAL,58,368,406,1,Loss
0.428571429,0.529411765,25.38333333,2016-12-25,23,22,home,4,BAL,279,246,45,55,31,27,Win,127,122,0,2,1,PIT,58,406,368,2,Win
0.26666666699999997,0.529411765,21.98333333,2016-12-25,14,23,away,-23,KCC,183,246,70,57,10,33,Loss,63,238,0,0,1,DEN,43,246,484,3,Loss
0.529411765,0.26666666699999997,38.01666667,2016-12-25,23,14,home,23,DEN,246,183,65,74,33,10,Win,238,63,0,0,3,KCC,43,484,246,1,Win
0.41666666700000005,0.5,30.71666667,2016-12-26,23,23,away,-21,DAL,229,211,62,70,21,42,Loss,90,164,4,1,0,DET,63,319,375,2,Loss
0.5,0.41666666700000005,29.28333333,2016-12-26,23,23,home,21,DET,211,229,47,52,42,21,Win,164,90,1,4,2,DAL,63,375,319,0,Win
0.5,0.125,29.3,2017-01-01,22,25,away,-17,CIN,263,218,41,70,10,27,Loss,72,153,3,1,0,BAL,37,335,371,2,Loss
0.125,0.5,30.7,2017-01-01,25,22,home,17,BAL,218,263,20,67,27,10,Win,153,72,1,3,2,CIN,37,371,335,0,Win
0.2,0.6,29.13333333,2017-01-01,20,16,away,-7,TEN,243,133,35,74,17,24,Loss,46,103,4,4,1,HOU,41,289,236,1,Loss
0.6,0.2,30.86666667,2017-01-01,16,20,home,7,HOU,133,243,50,59,24,17,Win,103,46,4,4,1,TEN,41,236,289,1,Win
0.26666666699999997,0.333333333,32.4,2017-01-01,18,18,away,-1,TBB,207,188,45,67,16,17,Loss,128,112,3,3,2,CAR,33,335,300,3,Loss
0.333333333,0.26666666699999997,27.6,2017-01-01,18,18,home,1,CAR,188,207,30,63,17,16,Win,112,128,3,3,3,TBB,33,300,335,2,Win
0.28571428600000004,0.2,29.6,2017-01-01,23,24,away,-4,IND,288,290,54,71,20,24,Loss,182,94,2,4,2,JAX,44,470,384,2,Loss
0.2,0.28571428600000004,30.4,2017-01-01,24,23,home,4,JAX,290,288,35,67,24,20,Win,94,182,4,2,2,IND,44,384,470,2,Win
0.583333333,0.583333333,31.36666667,2017-01-01,22,16,away,21,MIA,276,205,64,63,35,14,Win,120,75,0,0,2,NEP,49,396,280,0,Win
0.583333333,0.583333333,28.63333333,2017-01-01,16,22,home,-21,NEP,205,276,73,57,14,35,Loss,75,120,0,0,0,MIA,49,280,396,2,Loss
0.222222222,0.5,29.8,2017-01-01,19,21,away,-28,MIN,140,250,49,59,10,38,Loss,183,124,2,0,1,CHI,48,323,374,5,Loss
0.5,0.222222222,30.2,2017-01-01,21,19,home,28,CHI,250,140,15,62,38,10,Win,124,183,0,2,5,MIN,48,374,323,1,Win
0.375,0.307692308,28.55,2017-01-01,14,18,away,-20,NYJ,162,202,0,62,10,30,Loss,68,127,3,1,0,BUF,40,230,329,3,Loss
0.307692308,0.375,31.45,2017-01-01,18,14,home,20,BUF,202,162,15,61,30,10,Win,127,68,1,3,3,NYJ,40,329,230,0,Win
0.41666666700000005,0.428571429,24.3,2017-01-01,15,24,away,-14,PHI,126,232,35,53,13,27,Loss,69,114,3,2,0,DAL,40,195,346,2,Loss
0.428571429,0.41666666700000005,35.7,2017-01-01,24,15,home,14,DAL,232,126,61,75,27,13,Win,114,69,2,3,2,PHI,40,346,195,0,Win
0.533333333,0.214285714,38.9,2017-01-01,27,21,away,-3,PIT,206,243,37,77,3,6,Loss,231,69,4,4,1,CLE,9,437,312,4,Loss
0.214285714,0.533333333,33.15,2017-01-01,21,27,home,3,CLE,243,206,43,69,6,3,Win,69,231,4,4,4,PIT,9,312,437,1,Win
0.4375,0.545454545,30.25,2017-01-01,26,25,away,-6,ATL,341,323,70,75,32,38,Loss,132,142,2,1,0,NOS,70,473,465,1,Loss
0.545454545,0.4375,29.75,2017-01-01,25,26,home,6,NOS,323,341,63,59,38,32,Win,142,132,1,2,1,ATL,70,465,473,0,Win
0.352941176,0.333333333,35.86666667,2017-01-01,17,16,away,9,WAS,171,246,42,68,19,10,Win,161,38,1,4,3,NYG,29,332,284,0,Win
0.333333333,0.352941176,24.13333333,2017-01-01,16,17,home,-9,NYG,246,171,42,54,10,19,Loss,38,161,4,1,0,WAS,29,284,332,3,Loss
0.28571428600000004,0.14285714300000002,27.96666667,2017-01-01,21,9,away,38,LAR,260,71,51,67,44,6,Win,84,52,1,7,3,ARI,50,344,123,2,Win
0.14285714300000002,0.28571428600000004,32.03333333,2017-01-01,9,21,home,-38,ARI,71,260,61,57,6,44,Loss,52,84,7,1,2,LAR,50,123,344,3,Loss
0.181818182,0.333333333,24.58333333,2017-01-01,11,18,away,-18,DEN,164,206,125,50,6,24,Loss,57,143,2,0,1,OAK,30,221,349,3,Loss
0.333333333,0.181818182,35.41666667,2017-01-01,18,11,home,18,OAK,206,164,43,67,24,6,Win,143,57,0,2,3,DEN,30,349,221,1,Win
0.666666667,0.3,30.8,2017-01-01,26,26,away,10,LAC,262,269,19,60,37,27,Win,103,129,1,0,2,KCC,64,365,398,1,Win
0.3,0.666666667,29.2,2017-01-01,26,26,home,-10,KCC,269,262,50,64,27,37,Loss,129,103,0,1,1,LAC,64,398,365,2,Loss
0.25,0.181818182,29.56666667,2017-01-01,18,14,away,2,SFO,289,191,34,65,25,23,Win,87,62,2,5,2,SEA,48,376,253,0,Win
0.181818182,0.25,30.43333333,2017-01-01,14,18,home,-2,SEA,191,289,25,58,23,25,Loss,62,87,5,2,0,SFO,48,253,376,2,Loss
0.538461538,0.41666666700000005,34.15,2017-01-01,28,24,away,7,DET,295,332,75,71,31,24,Win,153,76,1,2,1,GBP,55,448,408,0,Win
0.41666666700000005,0.538461538,25.85,2017-01-01,24,28,home,-7,GBP,332,295,30,64,24,31,Loss,76,153,2,1,0,DET,55,408,448,1,Loss
0.125,0.26666666699999997,26.51666667,2017-01-07,16,19,away,-13,HOU,139,168,63,69,14,27,Loss,64,123,3,0,0,OAK,41,203,291,3,Loss
0.26666666699999997,0.125,33.48333333,2017-01-07,19,16,home,13,OAK,168,139,65,69,27,14,Win,123,64,0,3,3,HOU,41,291,203,0,Win
0.181818182,0.5625,23.35,2017-01-07,13,24,away,-20,SEA,182,210,68,50,6,26,Loss,49,177,3,3,0,DET,32,231,387,0,Loss
0.5625,0.181818182,36.65,2017-01-07,24,13,home,20,DET,210,182,40,71,26,6,Win,177,49,3,3,0,SEA,32,387,231,0,Win
0.428571429,0.444444444,32.03333333,2017-01-08,18,19,away,-18,PIT,253,188,64,62,12,30,Loss,52,179,5,1,2,MIA,42,305,367,3,Loss
0.444444444,0.428571429,27.96666667,2017-01-08,19,18,home,18,MIA,188,253,60,54,30,12,Win,179,52,1,5,3,PIT,42,367,305,2,Win
0.3125,0.35714285700000004,25.48333333,2017-01-08,15,23,away,-25,GBP,295,331,42,63,13,38,Loss,70,75,2,5,0,NYG,51,365,406,2,Loss
0.35714285700000004,0.3125,34.51666667,2017-01-08,23,15,home,25,NYG,331,295,21,70,38,13,Win,75,70,5,2,2,GBP,51,406,365,0,Win
0.454545455,0.5,26.68333333,2017-01-14,17,28,away,-16,ATL,208,323,40,54,20,36,Loss,101,99,3,3,0,SEA,56,309,422,2,Loss
0.5,0.454545455,33.31666667,2017-01-14,28,17,home,16,SEA,323,208,10,69,36,20,Win,99,101,3,3,2,ATL,56,422,309,0,Win
0.1875,0.35714285700000004,32.5,2017-01-14,14,20,away,-18,NEP,180,279,75,66,16,34,Loss,105,98,3,2,3,HOU,50,285,377,3,Loss
0.35714285700000004,0.1875,27.5,2017-01-14,20,14,home,18,HOU,279,180,50,67,34,16,Win,98,105,2,3,3,NEP,50,377,285,3,Win
0.545454545,0.545454545,29.76666667,2017-01-15,27,25,away,3,DAL,326,291,22,63,34,31,Win,87,138,3,2,1,GBP,65,413,429,1,Win
0.545454545,0.545454545,30.23333333,2017-01-15,25,27,home,-3,GBP,291,326,50,64,31,34,Loss,138,87,2,3,1,DAL,65,429,413,1,Loss
0.46666666700000003,0.222222222,34.21666667,2017-01-15,20,16,away,2,KCC,218,166,53,66,18,16,Win,171,61,1,1,2,PIT,34,389,227,1,Win
0.222222222,0.46666666700000003,25.78333333,2017-01-15,16,20,home,-2,PIT,166,218,60,49,16,18,Loss,61,171,1,1,1,KCC,34,227,389,2,Loss
0.4,0.7692307690000001,26.35,2017-01-22,24,30,away,-23,ATL,268,392,63,64,21,44,Loss,99,101,2,0,0,GBP,65,367,493,2,Loss
0.7692307690000001,0.4,33.65,2017-01-22,30,24,home,23,GBP,392,268,31,68,44,21,Win,101,99,0,2,2,ATL,65,493,367,0,Win
0.6,0.647058824,28.56666667,2017-01-22,22,26,away,-19,NEP,314,374,19,67,17,36,Loss,54,57,0,2,0,PIT,53,368,431,2,Loss
0.647058824,0.6,31.43333333,2017-01-22,26,22,home,19,PIT,374,314,10,71,36,17,Win,57,54,2,0,2,NEP,53,431,368,0,Win
0.5,0.125,40.51666667,2017-02-05,37,17,away,6,ATL,442,240,23,93,6,0,Win,104,104,5,5,1,NEP,6,546,344,2,Win
0.125,0.5,23.45,2017-02-05,17,37,home,-6,NEP,240,442,65,46,0,6,Loss,104,104,5,5,2,ATL,6,344,546,1,Loss
0.363636364,0.333333333,30.23333333,2017-09-07,26,25,away,15,NEP,352,247,139,65,42,27,Win,185,124,3,3,0,KCC,69,537,371,1,Win
0.333333333,0.363636364,29.76666667,2017-09-07,25,26,home,-15,KCC,247,352,55,74,27,42,Loss,124,185,3,3,1,NEP,69,371,537,0,Loss
0.4,0.5,26.66666667,2017-09-10,24,19,away,-12,DET,263,285,55,67,23,35,Loss,45,82,1,1,1,ARI,58,308,367,4,Loss
0.5,0.4,33.33333333,2017-09-10,19,24,home,12,ARI,285,263,100,69,35,23,Win,82,45,1,1,4,DET,58,367,308,1,Win
0.454545455,0.384615385,30.56666667,2017-09-10,18,20,away,6,CHI,308,176,73,55,23,17,Win,64,125,2,4,0,ATL,40,372,301,0,Win
0.384615385,0.454545455,29.43333333,2017-09-10,20,18,home,-6,ATL,176,308,40,63,17,23,Loss,125,64,4,2,0,CHI,40,301,372,0,Loss
0.428571429,0.307692308,34.0,2017-09-10,17,14,away,20,CIN,111,144,85,60,20,0,Win,157,77,1,5,5,BAL,20,268,221,1,Win
0.307692308,0.428571429,26.0,2017-09-10,14,17,home,-20,BAL,144,111,66,58,0,20,Loss,77,157,5,1,1,CIN,20,221,268,5,Loss
0.28571428600000004,0.470588235,26.93333333,2017-09-10,11,23,away,-9,BUF,176,218,62,55,12,21,Loss,38,190,1,2,1,NYJ,33,214,408,2,Loss
0.470588235,0.28571428600000004,33.06666667,2017-09-10,23,11,home,9,NYJ,218,176,50,72,21,12,Win,190,38,2,1,2,BUF,33,408,214,1,Win
0.384615385,0.25,28.83333333,2017-09-10,16,20,away,3,CLE,255,180,143,54,21,18,Win,35,57,1,7,1,PIT,39,290,237,1,Win
0.25,0.384615385,31.16666667,2017-09-10,20,16,home,-3,PIT,180,255,61,62,18,21,Loss,57,35,7,1,1,CLE,39,237,290,1,Loss
0.25,0.41666666700000005,30.08333333,2017-09-10,19,23,away,22,HOU,125,110,89,60,29,7,Win,155,93,0,10,4,JAX,36,280,203,0,Win
0.41666666700000005,0.25,29.91666667,2017-09-10,23,19,home,-22,JAX,110,125,94,69,7,29,Loss,93,155,10,0,0,HOU,36,203,280,4,Loss
0.41666666700000005,0.5,31.65,2017-09-10,22,21,away,10,TEN,250,255,49,63,26,16,Win,109,95,2,1,0,OAK,42,359,350,0,Win
0.5,0.41666666700000005,28.35,2017-09-10,21,22,home,-10,OAK,255,250,49,63,16,26,Loss,95,109,1,2,0,TEN,42,350,359,0,Loss
0.571428571,0.272727273,34.26666667,2017-09-10,19,16,away,13,WAS,298,200,76,65,30,17,Win,58,64,2,4,4,PHI,47,356,264,2,Win
0.272727273,0.571428571,25.73333333,2017-09-10,16,19,home,-13,PHI,200,298,15,61,17,30,Loss,64,58,4,2,2,WAS,47,264,356,4,Loss
0.0,0.35714285700000004,25.58333333,2017-09-10,10,19,away,-37,LAR,150,310,20,49,9,46,Loss,75,63,4,1,1,IND,55,225,373,3,Loss
0.35714285700000004,0.0,34.41666667,2017-09-10,19,10,home,37,IND,310,150,50,64,46,9,Win,63,75,1,4,3,LAR,55,373,225,1,Win
0.538461538,0.181818182,34.35,2017-09-10,20,13,away,20,SFO,171,166,40,63,23,3,Win,116,51,0,4,2,CAR,26,287,217,2,Win
0.181818182,0.538461538,25.65,2017-09-10,13,20,home,-20,CAR,166,171,74,54,3,23,Loss,51,116,4,0,2,SFO,26,217,287,2,Loss
0.25,0.5625,20.78333333,2017-09-10,12,26,away,-8,GBP,135,286,50,48,9,17,Loss,90,84,3,4,1,SEA,26,225,370,1,Loss
0.5625,0.25,39.21666667,2017-09-10,26,12,home,8,SEA,286,135,70,74,17,9,Win,84,90,4,3,1,GBP,26,370,225,1,Win
0.333333333,0.533333333,25.76666667,2017-09-10,13,22,away,-16,DAL,198,263,55,53,3,19,Loss,35,129,3,1,0,NYG,22,233,392,1,Loss
0.533333333,0.333333333,34.23333333,2017-09-10,22,13,home,16,NYG,263,198,50,71,19,3,Win,129,35,1,3,1,DAL,22,392,233,0,Win
0.363636364,0.642857143,28.73333333,2017-09-11,19,23,away,-10,MIN,284,341,52,59,19,29,Loss,60,129,1,1,0,NOS,48,344,470,0,Loss
0.642857143,0.363636364,31.26666667,2017-09-11,23,19,home,10,NOS,341,284,50,63,29,19,Win,129,60,1,1,0,MIN,48,470,344,0,Win
0.25,0.533333333,25.78333333,2017-09-11,17,22,away,-3,DEN,185,181,40,56,21,24,Loss,64,140,1,4,2,LAC,45,249,321,1,Loss
0.533333333,0.25,34.21666667,2017-09-11,22,17,home,3,LAC,181,185,62,68,24,21,Win,140,64,4,1,1,DEN,45,321,249,2,Win
0.26666666699999997,0.26666666699999997,32.25,2017-09-14,14,12,away,4,CIN,98,213,61,62,13,9,Win,168,82,3,3,1,HOU,22,266,295,0,Win
0.26666666699999997,0.26666666699999997,27.75,2017-09-14,12,14,home,-4,HOU,213,98,45,62,9,13,Loss,82,168,3,3,0,CIN,22,295,266,1,Loss
0.4,0.444444444,28.81666667,2017-09-17,17,18,away,3,IND,306,190,41,65,3,0,Win,83,76,4,4,1,ARI,3,389,266,1,Win
0.444444444,0.4,33.15,2017-09-17,18,17,home,-3,ARI,190,306,70,70,0,3,Loss,76,83,4,4,1,IND,3,266,389,1,Loss
0.166666667,0.363636364,26.6,2017-09-17,20,24,away,-14,BAL,293,201,65,66,10,24,Loss,93,136,3,2,2,CLE,34,386,337,5,Loss
0.363636364,0.166666667,33.4,2017-09-17,24,20,home,14,CLE,201,293,45,68,24,10,Win,136,93,2,3,5,BAL,34,337,386,2,Win
0.307692308,0.4375,21.11666667,2017-09-17,10,19,away,-6,CAR,107,178,44,51,3,9,Loss,69,77,3,6,0,BUF,12,176,255,0,Loss
0.4375,0.307692308,38.88333333,2017-09-17,19,10,home,6,BUF,178,107,40,66,9,3,Win,77,69,6,3,0,CAR,12,255,176,0,Win
0.5,0.533333333,26.81666667,2017-09-17,19,22,away,-22,TBB,290,194,59,62,7,29,Loss,20,117,1,2,1,CHI,36,310,311,4,Loss
0.533333333,0.5,33.18333333,2017-09-17,22,19,home,22,CHI,194,290,34,67,29,7,Win,117,20,2,1,4,TBB,36,311,310,1,Win
0.46153846200000004,0.46153846200000004,30.76666667,2017-09-17,21,20,away,21,JAX,211,211,70,64,37,16,Win,179,99,1,2,3,TEN,53,390,310,1,Win
0.46153846200000004,0.46153846200000004,29.23333333,2017-09-17,20,21,home,-21,TEN,211,211,99,61,16,37,Loss,99,179,2,1,1,JAX,53,310,390,3,Loss
0.533333333,0.41666666700000005,30.81666667,2017-09-17,27,16,away,-7,KCC,299,232,30,69,20,27,Loss,107,112,6,4,0,PHI,47,406,344,2,Loss
0.41666666700000005,0.533333333,29.18333333,2017-09-17,16,27,home,7,PHI,232,299,40,51,27,20,Win,112,107,4,6,2,KCC,47,344,406,0,Win
0.333333333,0.23076923100000002,25.63333333,2017-09-17,14,22,away,-17,PIT,146,233,131,60,9,26,Loss,91,102,2,2,0,MIN,35,237,335,1,Loss
0.23076923100000002,0.333333333,34.36666667,2017-09-17,22,14,home,17,MIN,233,146,72,69,26,9,Win,102,91,2,2,1,PIT,35,335,237,0,Win
0.5,0.333333333,35.1,2017-09-17,29,20,away,16,NOS,436,348,66,72,36,20,Win,119,81,2,1,0,NEP,56,555,429,0,Win
0.333333333,0.5,24.9,2017-09-17,20,29,home,-16,NEP,348,436,35,63,20,36,Loss,81,119,1,2,0,NOS,56,429,555,0,Loss
0.384615385,0.25,33.36666667,2017-09-17,21,24,away,2,LAC,225,323,23,68,19,17,Win,111,44,2,1,0,MIA,36,336,367,0,Win
0.25,0.384615385,26.63333333,2017-09-17,24,21,home,-2,MIA,323,225,56,54,17,19,Loss,44,111,1,2,0,LAC,36,367,336,0,Loss
0.583333333,0.666666667,28.96666667,2017-09-17,17,21,away,-25,OAK,145,230,47,53,20,45,Loss,126,180,4,0,0,NYJ,65,271,410,2,Loss
0.666666667,0.583333333,31.03333333,2017-09-17,21,17,home,25,NYJ,230,145,79,55,45,20,Win,180,126,0,4,2,OAK,65,410,271,0,Win
0.214285714,0.6,26.16666667,2017-09-17,16,26,away,-25,DEN,228,202,69,66,17,42,Loss,40,178,2,2,2,DAL,59,268,380,2,Loss
0.6,0.214285714,33.83333333,2017-09-17,26,16,home,25,DAL,202,228,61,73,42,17,Win,178,40,2,2,2,DEN,59,380,268,2,Win
0.384615385,0.41666666700000005,36.31666667,2017-09-17,21,14,away,7,LAR,156,235,25,68,27,20,Win,229,97,2,2,2,WAS,47,385,332,0,Win
0.41666666700000005,0.384615385,23.68333333,2017-09-17,14,21,home,-7,WAS,235,156,75,49,20,27,Loss,97,229,2,2,0,LAR,47,332,385,2,Loss
0.166666667,0.42105263200000004,23.03333333,2017-09-17,11,21,away,-3,SEA,89,181,66,48,9,12,Loss,159,131,2,3,0,SFO,21,248,312,1,Loss
0.42105263200000004,0.166666667,36.96666667,2017-09-17,21,11,home,3,SFO,181,89,71,79,12,9,Win,131,159,3,2,1,SEA,21,312,248,0,Win
0.41666666700000005,0.454545455,31.38333333,2017-09-17,24,19,away,-11,ATL,308,223,70,68,23,34,Loss,59,141,3,3,0,GBP,57,367,364,2,Loss
0.454545455,0.41666666700000005,28.61666667,2017-09-17,19,24,home,11,GBP,223,308,34,58,34,23,Win,141,59,3,3,2,ATL,57,364,367,0,Win
0.46666666700000003,0.333333333,32.78333333,2017-09-18,12,14,away,14,NYG,119,208,50,56,24,10,Win,138,62,3,5,1,DET,34,257,270,1,Win
0.333333333,0.46666666700000003,27.21666667,2017-09-18,14,12,home,-14,DET,208,119,50,55,10,24,Loss,62,138,5,3,1,NYG,34,270,257,1,Loss
0.666666667,0.5,29.71666667,2017-09-21,26,25,away,2,SFO,292,308,52,60,41,39,Win,126,113,0,4,2,LAR,80,418,421,2,Win
0.5,0.666666667,30.28333333,2017-09-21,25,26,home,-2,LAR,308,292,55,74,39,41,Loss,113,126,4,0,2,SFO,80,421,418,2,Loss
0.272727273,0.25,25.95,2017-09-24,12,24,away,-37,JAX,52,244,88,54,7,44,Loss,134,166,2,0,0,BAL,51,186,410,3,Loss
0.25,0.272727273,34.05,2017-09-24,24,12,home,37,BAL,244,52,70,68,44,7,Win,166,134,0,2,3,JAX,51,410,186,0,Win
0.444444444,0.23076923100000002,32.58333333,2017-09-24,26,21,away,4,DET,277,253,68,65,30,26,Win,151,71,2,2,0,ATL,56,428,324,3,Win
0.23076923100000002,0.444444444,27.41666667,2017-09-24,21,26,home,-4,ATL,253,277,98,66,26,30,Loss,71,151,2,2,3,DET,56,324,428,0,Loss
0.428571429,0.375,29.56666667,2017-09-24,21,16,away,-10,BUF,255,197,79,66,16,26,Loss,111,75,3,4,0,DEN,42,366,272,2,Loss
0.375,0.428571429,30.43333333,2017-09-24,16,21,home,10,DEN,197,255,69,63,26,16,Win,75,111,4,3,2,BUF,42,272,366,0,Win
0.5,0.5,31.15,2017-09-24,21,18,away,21,CAR,213,156,10,57,34,13,Win,149,132,1,4,3,NOS,47,362,288,0,Win
0.5,0.5,28.85,2017-09-24,18,21,home,-21,NOS,156,213,5,59,13,34,Loss,132,149,4,1,0,CAR,47,288,362,3,Loss
0.363636364,0.333333333,27.56666667,2017-09-24,19,18,away,-6,CHI,212,84,40,59,0,6,Loss,70,222,3,2,2,PIT,6,282,306,2,Loss
0.333333333,0.363636364,33.98333333,2017-09-24,18,19,home,6,PIT,84,212,73,62,6,0,Win,222,70,2,3,2,CHI,6,306,282,2,Win
0.384615385,0.470588235,26.55,2017-09-24,25,16,away,-3,IND,235,243,113,69,28,31,Loss,111,92,1,3,1,CLE,59,346,335,3,Loss
0.470588235,0.384615385,33.45,2017-09-24,16,25,home,3,CLE,243,235,99,63,31,28,Win,92,111,3,1,3,IND,59,335,346,1,Win
0.428571429,0.46153846200000004,33.63333333,2017-09-24,23,21,away,-3,NEP,292,337,60,67,33,36,Loss,125,59,2,5,1,HOU,69,417,396,2,Loss
0.46153846200000004,0.428571429,26.36666667,2017-09-24,21,23,home,3,HOU,337,292,69,60,36,33,Win,59,125,5,2,2,NEP,69,396,417,1,Win
0.083333333,0.307692308,23.86666667,2017-09-24,16,16,away,-14,NYJ,195,233,51,63,6,20,Loss,30,103,3,2,1,MIA,26,225,336,2,Loss
0.307692308,0.083333333,36.13333333,2017-09-24,16,16,home,14,MIA,233,195,94,59,20,6,Win,103,30,2,3,2,NYJ,26,336,225,1,Win
0.166666667,0.538461538,22.23333333,2017-09-24,20,25,away,-17,MIN,316,369,37,51,17,34,Loss,26,125,2,0,0,TBB,51,342,494,3,Loss
0.538461538,0.166666667,37.76666667,2017-09-24,25,20,home,17,TBB,369,316,53,70,34,17,Win,125,26,0,2,3,MIN,51,494,342,0,Win
0.3,0.35714285700000004,22.46666667,2017-09-24,21,24,away,-3,PHI,366,161,137,64,24,27,Loss,49,193,0,3,1,NYG,51,415,354,2,Loss
0.35714285700000004,0.3,37.53333333,2017-09-24,24,21,home,3,NYG,161,366,103,73,27,24,Win,193,49,3,0,2,PHI,51,354,415,1,Win
0.28571428600000004,0.28571428600000004,27.31666667,2017-09-24,24,21,away,-6,TEN,364,225,98,72,27,33,Loss,69,195,1,0,0,SEA,60,433,420,0,Loss
0.28571428600000004,0.28571428600000004,32.68333333,2017-09-24,21,24,home,6,SEA,225,364,45,67,33,27,Win,195,69,0,1,0,TEN,60,420,433,0,Win
0.333333333,0.46666666700000003,34.28333333,2017-09-24,21,22,away,-3,GBP,191,280,68,60,0,3,Loss,110,64,3,6,1,CIN,3,301,344,1,Win
0.46666666700000003,0.333333333,29.35,2017-09-24,22,21,home,3,CIN,280,191,33,65,3,0,Win,64,110,6,3,1,GBP,3,344,301,1,Win
0.333333333,0.384615385,30.43333333,2017-09-24,16,24,away,14,LAC,122,226,122,51,24,10,Win,189,104,5,2,3,KCC,34,311,330,0,Win
0.384615385,0.333333333,29.56666667,2017-09-24,24,16,home,-14,KCC,226,122,61,68,10,24,Loss,104,189,2,5,0,LAC,34,330,311,3,Loss
0.0,0.46666666700000003,21.9,2017-09-24,7,18,away,-17,WAS,96,356,35,48,10,27,Loss,32,116,4,1,2,OAK,37,128,472,3,Loss
0.46666666700000003,0.0,38.1,2017-09-24,18,7,home,17,OAK,356,96,77,65,27,10,Win,116,32,1,4,3,WAS,37,472,128,2,Win
0.222222222,0.444444444,23.75,2017-09-25,15,22,away,11,ARI,174,283,76,45,28,17,Win,99,49,1,6,0,DAL,45,273,332,0,Win
0.444444444,0.222222222,36.25,2017-09-25,22,15,home,-11,DAL,283,174,50,75,17,28,Loss,49,99,6,1,0,ARI,45,332,273,0,Loss
0.41666666700000005,0.5,31.85,2017-09-28,20,17,away,-21,GBP,205,169,62,64,14,35,Loss,103,91,1,2,0,CHI,49,308,260,4,Loss
0.5,0.41666666700000005,28.15,2017-09-28,17,20,home,21,CHI,169,205,55,53,35,14,Win,91,103,2,1,4,GBP,49,260,308,0,Win
0.46153846200000004,0.125,34.46666667,2017-10-01,22,11,away,20,MIA,261,128,71,70,20,0,Win,86,58,1,4,1,NOS,20,347,186,0,Win
0.125,0.46153846200000004,25.53333333,2017-10-01,11,22,home,-20,NOS,128,261,90,47,0,20,Loss,58,86,4,1,0,MIA,20,186,347,1,Loss
0.46153846200000004,0.384615385,28.75,2017-10-01,15,25,away,6,ATL,164,242,55,59,23,17,Win,117,147,3,1,3,BUF,40,281,389,0,Win
0.384615385,0.46153846200000004,31.25,2017-10-01,25,15,home,-6,BUF,242,164,45,72,17,23,Loss,147,117,1,3,0,ATL,40,389,281,3,Loss
0.46666666700000003,0.384615385,35.48333333,2017-10-01,22,18,away,17,BAL,208,206,60,73,26,9,Win,173,82,1,4,3,PIT,35,381,288,1,Win
0.384615385,0.46666666700000003,24.51666667,2017-10-01,18,22,home,-17,PIT,206,208,55,68,9,26,Loss,82,173,4,1,1,BAL,35,288,381,3,Loss
0.666666667,0.5,28.88333333,2017-10-01,28,24,away,3,NEP,304,293,33,60,33,30,Win,140,80,2,3,0,CAR,63,444,373,2,Win
0.5,0.666666667,31.11666667,2017-10-01,24,28,home,-3,CAR,293,304,55,67,30,33,Loss,80,140,3,2,2,NEP,63,373,444,0,Win
0.545454545,0.3125,35.03333333,2017-10-01,25,16,away,24,CLE,264,170,66,63,31,7,Win,86,45,3,2,1,CIN,38,350,215,1,Win
0.3125,0.545454545,24.96666667,2017-10-01,16,25,home,-24,CIN,170,264,28,61,7,31,Loss,45,86,2,3,1,CLE,38,215,350,1,Loss
0.384615385,0.5,30.53333333,2017-10-01,24,22,away,5,DAL,244,251,41,68,35,30,Win,168,189,1,2,2,LAR,65,412,440,0,Win
0.5,0.384615385,29.46666667,2017-10-01,22,24,home,-5,LAR,251,244,45,65,30,35,Loss,189,168,2,1,0,DAL,65,440,412,2,Loss
0.23076923100000002,0.3,36.45,2017-10-01,19,15,away,7,MIN,154,197,60,68,14,7,Win,97,87,6,2,3,DET,21,251,284,0,Win
0.3,0.23076923100000002,23.55,2017-10-01,15,19,home,-7,DET,197,154,10,54,7,14,Loss,87,97,2,6,0,MIN,21,284,251,3,Loss
0.25,0.5,20.31666667,2017-10-01,9,33,away,-43,HOU,109,272,88,41,14,57,Loss,86,173,2,2,1,TEN,71,195,445,5,Loss
0.5,0.25,39.68333333,2017-10-01,33,9,home,43,TEN,272,109,20,78,57,14,Win,173,86,2,2,5,HOU,71,445,195,1,Win
0.26666666699999997,0.352941176,35.13333333,2017-10-01,20,18,away,-3,NYJ,136,215,47,75,0,3,Loss,175,256,1,5,2,JAX,3,311,471,1,Loss
0.352941176,0.26666666699999997,34.4,2017-10-01,18,20,home,3,JAX,215,136,70,69,3,0,Win,256,175,5,1,1,NYJ,3,471,311,2,Win
0.263157895,0.3125,33.21666667,2017-10-01,20,25,away,-3,ARI,210,317,113,79,3,6,Loss,95,51,3,6,1,SFO,9,305,368,1,Loss
0.3125,0.263157895,36.25,2017-10-01,25,20,home,3,SFO,317,210,80,79,6,3,Win,51,95,6,3,1,ARI,9,368,305,1,Win
0.5625,0.5,39.3,2017-10-01,26,18,away,2,LAC,240,342,58,74,26,24,Win,214,58,1,2,1,PHI,50,454,400,0,Win
0.5,0.5625,20.7,2017-10-01,18,26,home,-2,PHI,342,240,39,53,24,26,Loss,58,214,2,1,0,LAC,50,400,454,1,Loss
0.470588235,0.272727273,34.21666667,2017-10-01,24,20,away,-2,TBB,288,323,0,77,23,25,Loss,91,111,0,1,0,NYG,48,379,434,0,Loss
0.272727273,0.470588235,25.78333333,2017-10-01,20,24,home,2,NYG,323,288,19,62,25,23,Win,111,91,1,0,0,TBB,48,434,379,0,Win
0.166666667,0.3125,27.05,2017-10-01,11,16,away,-6,DEN,230,155,75,53,10,16,Loss,24,143,3,4,0,OAK,26,254,298,1,Loss
0.3125,0.166666667,32.95,2017-10-01,16,11,home,6,OAK,155,230,40,62,16,10,Win,143,24,4,3,1,DEN,26,298,254,0,Win
0.428571429,0.666666667,27.8,2017-10-01,16,22,away,-28,SEA,139,283,31,57,18,46,Loss,98,194,3,3,2,IND,64,237,477,2,Loss
0.666666667,0.428571429,32.2,2017-10-01,22,16,home,28,IND,283,139,45,62,46,18,Win,194,98,3,3,2,SEA,64,477,237,2,Win
0.363636364,0.615384615,22.85,2017-10-02,15,29,away,-9,KCC,220,261,44,50,20,29,Loss,111,168,0,4,0,WAS,49,331,429,1,Loss
0.615384615,0.363636364,37.15,2017-10-02,29,15,home,9,WAS,261,220,15,72,29,20,Win,168,111,4,0,1,KCC,49,429,331,0,Win
0.333333333,0.307692308,30.83333333,2017-10-05,23,26,away,5,TBB,289,319,108,66,19,14,Win,113,90,3,2,0,NEP,33,402,409,2,Win
0.307692308,0.333333333,29.16666667,2017-10-05,26,23,home,-5,NEP,319,289,70,68,14,19,Loss,90,113,2,3,2,TBB,33,409,402,0,Loss
0.28571428600000004,0.642857143,24.21666667,2017-10-08,16,19,away,-27,PHI,276,297,61,60,7,34,Loss,31,122,2,1,1,ARI,41,307,419,1,Loss
0.642857143,0.28571428600000004,35.78333333,2017-10-08,19,16,home,27,ARI,297,276,60,64,34,7,Win,122,31,1,2,1,PHI,41,419,307,1,Win
0.333333333,0.4,29.98333333,2017-10-08,17,18,away,-4,CIN,139,323,71,67,16,20,Loss,82,65,6,1,3,BUF,36,221,388,1,Loss
0.4,0.333333333,30.01666667,2017-10-08,18,17,home,4,BUF,323,139,71,64,20,16,Win,65,82,1,6,1,CIN,36,388,221,3,Win
0.4375,0.384615385,35.38333333,2017-10-08,16,19,away,3,DET,334,192,100,64,27,24,Win,28,50,3,6,1,CAR,51,362,242,0,Win
0.384615385,0.4375,24.61666667,2017-10-08,19,16,home,-3,CAR,192,334,10,56,24,27,Loss,50,28,6,3,0,DET,51,242,362,1,Loss
0.333333333,0.428571429,25.56666667,2017-10-08,14,22,away,3,CLE,178,279,80,51,17,14,Win,34,140,3,1,3,NYJ,31,212,419,1,Win
0.428571429,0.333333333,34.43333333,2017-10-08,22,14,home,-3,NYJ,279,178,60,70,14,17,Loss,140,34,1,3,1,CLE,31,419,212,3,Win
0.28571428600000004,0.5,31.08333333,2017-10-08,23,25,away,-3,IND,336,288,77,70,0,3,Loss,66,159,2,4,1,SFO,3,402,447,0,Loss
0.5,0.28571428600000004,37.28333333,2017-10-08,25,23,home,3,SFO,288,336,62,73,3,0,Win,159,66,4,2,0,IND,3,447,402,1,Win
0.5,0.46666666700000003,28.86666667,2017-10-08,15,21,away,21,PIT,82,301,19,53,30,9,Win,231,70,2,2,5,JAX,39,313,371,1,Win
0.46666666700000003,0.5,31.13333333,2017-10-08,21,15,home,-21,JAX,301,82,37,77,9,30,Loss,70,231,2,2,1,PIT,39,371,313,5,Loss
0.444444444,0.333333333,31.75,2017-10-08,21,18,away,5,NYG,258,183,87,73,27,22,Win,124,152,0,5,2,LAC,49,382,335,1,Win
0.333333333,0.444444444,28.25,2017-10-08,18,21,home,-5,LAC,183,258,67,66,22,27,Loss,152,124,5,0,1,NYG,49,335,382,2,Loss
0.153846154,0.333333333,30.25,2017-10-08,14,12,away,-6,MIA,119,78,77,58,10,16,Loss,69,100,6,1,2,TEN,26,188,178,2,Loss
0.333333333,0.153846154,29.75,2017-10-08,12,14,home,6,TEN,78,119,23,59,16,10,Win,100,69,1,6,2,MIA,26,178,188,2,Win
0.5,0.5,33.71666667,2017-10-08,19,15,away,13,OAK,222,137,5,65,30,17,Win,143,108,0,3,1,BAL,47,365,245,0,Win
0.5,0.5,26.28333333,2017-10-08,15,19,home,-13,BAL,137,222,24,54,17,30,Loss,108,143,3,0,0,OAK,47,245,365,1,Loss
0.470588235,0.533333333,31.26666667,2017-10-08,15,21,away,6,LAR,179,275,40,66,16,10,Win,62,100,3,2,5,SEA,26,241,375,2,Win
0.533333333,0.470588235,28.73333333,2017-10-08,21,15,home,-6,SEA,275,179,45,71,10,16,Loss,100,62,2,3,2,LAR,26,375,241,5,Loss
0.428571429,0.583333333,24.9,2017-10-08,25,26,away,4,DAL,182,245,38,58,35,31,Win,160,163,4,1,3,GBP,66,342,408,1,Win
0.583333333,0.428571429,35.1,2017-10-08,26,25,home,-4,GBP,245,182,70,72,31,35,Loss,163,160,1,4,1,DAL,66,408,342,3,Loss
0.5625,0.3,38.28333333,2017-10-08,29,20,away,8,HOU,323,248,64,73,42,34,Win,127,144,1,3,1,KCC,76,450,392,0,Win
0.3,0.5625,21.71666667,2017-10-08,20,29,home,-8,KCC,248,323,59,57,34,42,Loss,144,127,3,1,0,HOU,76,392,450,1,Loss
0.4,0.25,31.4,2017-10-09,17,16,away,3,CHI,141,159,69,67,20,17,Win,159,115,4,1,2,MIN,37,300,274,0,Win
0.25,0.4,28.6,2017-10-09,16,17,home,-3,MIN,159,141,55,56,17,20,Loss,115,159,1,4,0,CHI,37,274,300,2,Loss
0.35714285700000004,0.25,28.56666667,2017-10-12,15,23,away,5,CAR,209,225,126,60,28,23,Win,101,80,3,2,3,PHI,51,310,305,1,Win
0.25,0.35714285700000004,31.43333333,2017-10-12,23,15,home,-5,PHI,225,209,1,79,23,28,Loss,80,101,2,3,1,CAR,51,305,310,3,Loss
0.41666666700000005,0.545454545,34.4,2017-10-15,20,19,away,3,ATL,151,239,42,64,20,17,Win,138,100,0,2,1,MIA,37,289,339,1,Win
0.545454545,0.41666666700000005,25.6,2017-10-15,19,20,home,-3,MIA,239,151,73,56,17,20,Loss,100,138,2,0,1,ATL,37,339,289,1,Loss
0.294117647,0.166666667,36.75,2017-10-15,18,16,away,3,BAL,111,166,44,75,3,0,Win,231,125,4,3,3,CHI,3,342,291,2,Win
0.166666667,0.294117647,31.15,2017-10-15,16,18,home,-3,CHI,166,111,69,70,0,3,Loss,125,231,3,4,2,BAL,3,291,342,3,Loss
0.214285714,0.384615385,30.9,2017-10-15,16,18,away,-16,HOU,113,217,72,63,17,33,Loss,134,123,4,1,1,CLE,50,247,340,3,Loss
0.384615385,0.214285714,29.1,2017-10-15,18,16,home,16,CLE,217,113,44,63,33,17,Win,123,134,1,4,3,HOU,50,340,247,1,Win
0.5,0.166666667,27.81666667,2017-10-15,18,19,away,-14,NOS,281,186,46,76,38,52,Loss,66,193,5,0,3,DET,90,347,379,5,Loss
0.166666667,0.5,32.18333333,2017-10-15,19,18,home,14,DET,186,281,118,67,52,38,Win,193,66,0,5,5,NOS,90,379,347,3,Win
0.235294118,0.333333333,27.85,2017-10-15,14,24,away,-13,MIN,155,239,92,65,10,23,Loss,72,112,4,0,2,GBP,33,227,351,3,Loss
0.333333333,0.235294118,32.15,2017-10-15,24,14,home,13,GBP,239,155,65,70,23,10,Win,112,72,0,4,3,MIN,33,351,227,2,Win
0.538461538,0.529411765,26.33333333,2017-10-15,23,23,away,7,NYJ,257,334,45,63,24,17,Win,118,74,0,4,3,NEP,41,375,408,2,Win
0.529411765,0.538461538,33.66666667,2017-10-15,23,23,home,-7,NEP,334,257,69,75,17,24,Loss,74,118,4,0,2,NYJ,41,408,375,3,Loss
0.352941176,0.5,23.13333333,2017-10-15,21,25,away,-2,WAS,250,325,40,70,24,26,Loss,85,94,3,1,2,SFO,50,335,419,1,Loss
0.5,0.352941176,36.86666667,2017-10-15,25,21,home,2,SFO,325,250,43,71,26,24,Win,94,85,1,3,1,WAS,50,419,335,2,Win
0.5,0.444444444,27.61666667,2017-10-15,21,23,away,-5,ARI,344,272,49,64,33,38,Loss,70,160,2,2,2,TBB,71,414,432,2,Loss
0.444444444,0.5,32.38333333,2017-10-15,23,21,home,5,TBB,272,344,61,59,38,33,Win,160,70,2,2,2,ARI,71,432,414,2,Win
0.307692308,0.26666666699999997,28.01666667,2017-10-15,12,19,away,10,JAX,107,220,70,56,27,17,Win,142,169,3,5,1,LAR,44,249,389,1,Win
0.26666666699999997,0.307692308,31.98333333,2017-10-15,19,12,home,-10,LAR,220,107,40,66,17,27,Loss,169,142,5,3,1,JAX,44,389,249,1,Loss
0.363636364,0.272727273,36.65,2017-10-15,23,12,away,6,KCC,245,223,57,63,19,13,Win,194,28,1,3,0,PIT,32,439,251,1,Win
0.272727273,0.363636364,23.35,2017-10-15,12,23,home,-6,PIT,223,245,48,52,13,19,Loss,28,194,3,1,1,KCC,32,251,439,0,Loss
0.428571429,0.5,32.05,2017-10-15,20,15,away,1,OAK,263,165,32,65,17,16,Win,80,109,1,1,2,LAC,33,343,274,1,Win
0.5,0.428571429,27.95,2017-10-15,15,20,home,-1,LAC,165,263,40,53,16,17,Loss,109,80,1,1,1,OAK,33,274,343,2,Loss
0.28571428600000004,0.294117647,30.6,2017-10-15,12,20,away,13,DEN,118,366,77,54,23,10,Win,148,46,3,4,3,NYG,33,266,412,0,Win
0.294117647,0.28571428600000004,29.4,2017-10-15,20,12,home,-13,NYG,366,118,46,75,10,23,Loss,46,148,4,3,0,DEN,33,412,266,3,Loss
0.222222222,0.46153846200000004,24.11666667,2017-10-16,18,25,away,-14,TEN,212,305,51,57,22,36,Loss,85,168,1,1,1,IND,58,297,473,1,Loss
0.46153846200000004,0.222222222,35.88333333,2017-10-16,25,18,home,14,IND,305,212,45,67,36,22,Win,168,85,1,1,1,TEN,58,473,297,1,Win
0.533333333,0.46153846200000004,30.6,2017-10-19,19,32,away,-1,OAK,331,417,108,60,30,31,Loss,94,88,1,0,0,KCC,61,425,505,0,Loss
0.46153846200000004,0.533333333,29.4,2017-10-19,32,19,home,1,KCC,417,331,97,73,31,30,Win,88,94,0,1,0,OAK,61,505,425,0,Win
0.25,0.684210526,20.98333333,2017-10-22,10,28,away,-33,LAR,171,228,65,47,0,33,Loss,25,197,3,1,1,ARI,33,196,425,2,Loss
0.684210526,0.25,39.01666667,2017-10-22,28,10,home,33,ARI,228,171,45,78,33,0,Win,197,25,1,3,2,LAR,33,425,196,1,Win
0.375,0.46666666700000003,27.98333333,2017-10-22,16,17,away,-8,MIN,144,188,15,64,16,24,Loss,64,169,5,0,1,BAL,40,208,357,0,Loss
0.46666666700000003,0.375,32.01666667,2017-10-22,17,16,home,8,BAL,188,144,47,64,24,16,Win,169,64,0,5,0,MIN,40,357,208,1,Win
0.545454545,0.625,33.16666667,2017-10-22,27,23,away,-3,BUF,378,261,55,70,27,30,Loss,69,173,1,1,1,TBB,57,447,434,3,Loss
0.625,0.545454545,26.83333333,2017-10-22,23,27,home,3,TBB,261,378,35,67,30,27,Win,173,69,1,1,3,BUF,57,434,447,1,Win
0.4,0.181818182,38.58333333,2017-10-22,20,5,away,-14,CHI,185,85,35,69,3,17,Loss,108,68,5,4,0,CAR,20,293,153,3,Loss
0.181818182,0.4,21.41666667,2017-10-22,5,20,home,14,CAR,85,185,40,37,17,3,Win,68,108,4,5,3,CHI,20,153,293,0,Win
0.294117647,0.23076923100000002,35.38333333,2017-10-22,16,19,away,3,CLE,189,218,35,68,3,0,Win,80,66,2,2,3,TEN,3,269,284,1,Win
0.23076923100000002,0.294117647,32.7,2017-10-22,19,16,home,-3,TEN,218,189,81,67,0,3,Loss,66,80,2,2,1,CLE,3,284,269,3,Loss
0.533333333,0.363636364,36.93333333,2017-10-22,25,16,away,9,GBP,324,79,80,75,26,17,Win,161,181,1,1,1,NOS,43,485,260,2,Win
0.363636364,0.533333333,23.06666667,2017-10-22,16,25,home,-9,NOS,79,324,54,50,17,26,Loss,181,161,1,1,2,GBP,43,260,485,1,Loss
0.571428571,0.333333333,32.78333333,2017-10-22,23,15,away,27,IND,330,136,34,65,27,0,Win,188,96,1,10,0,JAX,27,518,232,2,Win
0.333333333,0.571428571,27.21666667,2017-10-22,15,23,home,-27,JAX,136,330,55,67,0,27,Loss,96,188,10,1,2,IND,27,232,518,0,Loss
0.363636364,0.384615385,28.03333333,2017-10-22,16,25,away,-3,MIA,180,304,124,52,28,31,Loss,92,53,3,3,2,NYJ,59,272,357,2,Loss
0.384615385,0.363636364,31.96666667,2017-10-22,25,16,home,3,NYJ,304,180,76,65,31,28,Win,53,92,3,3,2,MIA,59,357,272,2,Win
0.636363636,0.46153846200000004,32.83333333,2017-10-22,27,23,away,30,SFO,236,187,36,70,40,10,Win,265,103,0,5,3,DAL,50,501,290,0,Win
0.46153846200000004,0.636363636,27.16666667,2017-10-22,23,27,home,-30,DAL,187,236,22,65,10,40,Loss,103,265,5,0,0,SFO,50,290,501,3,Loss
0.272727273,0.181818182,24.75,2017-10-22,11,21,away,-15,PIT,108,268,54,51,14,29,Loss,71,152,4,0,0,CIN,43,179,420,2,Loss
0.181818182,0.272727273,35.25,2017-10-22,21,11,home,15,CIN,268,108,5,68,29,14,Win,152,71,0,4,2,PIT,43,420,179,0,Win
0.214285714,0.25,31.06666667,2017-10-22,12,14,away,-21,LAC,182,162,68,59,0,21,Loss,69,80,5,3,0,DEN,21,251,242,3,Loss
0.25,0.214285714,28.93333333,2017-10-22,14,12,home,21,DEN,162,182,81,55,21,0,Win,80,69,3,5,3,LAC,21,242,251,0,Win
0.46153846200000004,0.166666667,35.43333333,2017-10-22,26,14,away,17,NYG,321,131,110,71,24,7,Win,104,46,1,1,1,SEA,31,425,177,1,Win
0.166666667,0.46153846200000004,24.56666667,2017-10-22,14,26,home,-17,SEA,131,321,28,57,7,24,Loss,46,104,1,1,1,NYG,31,177,425,1,Loss
0.222222222,0.538461538,25.91666667,2017-10-22,21,25,away,-16,NEP,223,241,40,56,7,23,Loss,120,162,1,2,0,ATL,30,343,403,0,Loss
0.538461538,0.222222222,34.08333333,2017-10-22,25,21,home,16,ATL,241,223,65,67,23,7,Win,162,120,2,1,0,NEP,30,403,343,0,Win
0.333333333,0.5,30.25,2017-10-23,19,23,away,-10,PHI,269,244,55,62,24,34,Loss,75,127,4,3,1,WAS,58,344,371,1,Loss
0.5,0.333333333,29.75,2017-10-23,23,19,home,10,WAS,244,269,55,61,34,24,Win,127,75,3,4,1,PHI,58,371,344,1,Win
0.26666666699999997,0.23076923100000002,28.76666667,2017-10-26,13,19,away,-40,BAL,151,121,43,66,0,40,Loss,45,174,3,0,0,MIA,40,196,295,2,Loss
0.23076923100000002,0.26666666699999997,31.23333333,2017-10-26,19,13,home,40,MIA,121,151,40,62,40,0,Win,174,45,0,3,2,BAL,40,295,196,0,Win
0.375,0.307692308,37.86666667,2017-10-29,26,16,away,17,CLE,287,161,58,78,33,16,Win,88,115,1,3,2,MIN,49,375,276,1,Win
0.307692308,0.375,22.13333333,2017-10-29,16,26,home,-17,MIN,161,287,74,59,16,33,Loss,115,88,3,1,1,CLE,49,276,375,2,Loss
0.35714285700000004,0.333333333,28.31666667,2017-10-29,18,15,away,5,NYJ,246,236,68,62,25,20,Win,140,43,1,3,1,ATL,45,386,279,2,Win
0.333333333,0.35714285700000004,31.68333333,2017-10-29,15,18,home,-5,ATL,236,246,50,58,20,25,Loss,43,140,3,1,2,NYJ,45,279,386,1,Loss
0.3,0.4,24.38333333,2017-10-29,23,17,away,-20,BUF,313,165,50,63,14,34,Loss,54,166,0,0,0,OAK,48,367,331,4,Loss
0.4,0.3,35.61666667,2017-10-29,17,23,home,20,OAK,165,313,95,64,34,14,Win,166,54,0,0,4,BUF,48,331,367,0,Win
0.470588235,0.166666667,32.18333333,2017-10-29,14,16,away,14,TBB,154,194,51,63,17,3,Win,100,85,0,3,3,CAR,20,254,279,1,Win
0.166666667,0.470588235,27.81666667,2017-10-29,16,14,home,-14,CAR,194,154,55,63,3,17,Loss,85,100,3,0,1,TBB,20,279,254,3,Loss
0.470588235,0.222222222,28.61666667,2017-10-29,17,19,away,-8,NOS,150,286,31,65,12,20,Loss,157,101,2,2,2,CHI,32,307,387,1,Loss
0.222222222,0.470588235,31.38333333,2017-10-29,19,17,home,8,CHI,286,150,51,60,20,12,Win,101,157,2,2,1,NOS,32,387,307,2,Win
0.5,0.363636364,33.21666667,2017-10-29,19,17,away,-1,CIN,216,218,45,71,23,24,Loss,115,58,4,3,2,IND,47,331,276,1,Win
0.363636364,0.5,26.78333333,2017-10-29,17,19,home,1,IND,218,216,54,53,24,23,Win,58,115,3,4,1,CIN,47,276,331,2,Win
0.3,0.473684211,23.01666667,2017-10-29,16,27,away,-8,NEP,192,317,77,52,13,21,Loss,157,97,1,3,0,LAC,34,349,414,1,Loss
0.473684211,0.3,36.98333333,2017-10-29,27,16,home,8,LAC,317,192,80,82,21,13,Win,97,157,3,1,1,NEP,34,414,349,0,Win
0.2,0.28571428600000004,27.05,2017-10-29,14,19,away,-23,PHI,144,192,69,64,10,33,Loss,94,112,4,3,1,SFO,43,238,304,2,Loss
0.28571428600000004,0.2,32.95,2017-10-29,19,14,home,23,SFO,192,144,35,66,33,10,Win,112,94,3,4,2,PHI,43,304,238,1,Win
0.2,0.41666666700000005,30.36666667,2017-10-29,25,21,away,-3,SEA,367,446,93,69,38,41,Loss,142,33,5,2,1,HOU,79,509,479,3,Loss
0.41666666700000005,0.2,29.63333333,2017-10-29,21,25,home,3,HOU,446,367,120,64,41,38,Win,33,142,2,5,3,SEA,79,479,509,1,Win
0.35714285700000004,0.307692308,33.31666667,2017-10-29,18,16,away,14,WAS,138,236,89,63,33,19,Win,169,49,2,4,3,DAL,52,307,285,1,Win
0.307692308,0.35714285700000004,26.68333333,2017-10-29,16,18,home,-14,DAL,236,138,32,58,19,33,Loss,49,169,4,2,1,WAS,52,285,307,3,Loss
0.5,0.166666667,28.38333333,2017-10-29,17,21,away,5,DET,317,411,37,60,20,15,Win,75,71,0,2,1,PIT,35,392,482,2,Win
0.166666667,0.5,31.61666667,2017-10-29,21,17,home,-5,PIT,411,317,57,69,15,20,Loss,71,75,2,0,2,DET,35,482,392,1,Loss
0.384615385,0.166666667,31.38333333,2017-10-30,23,16,away,-10,KCC,187,197,53,70,19,29,Loss,177,79,3,1,2,DEN,48,364,276,5,Loss
0.166666667,0.384615385,28.61666667,2017-10-30,16,23,home,10,DEN,197,187,69,59,29,19,Win,79,177,1,3,5,KCC,48,276,364,2,Win
0.375,0.428571429,26.5,2017-11-02,21,21,away,-13,NYJ,244,137,99,69,21,34,Loss,63,194,7,1,0,BUF,55,307,331,3,Loss
0.428571429,0.375,33.5,2017-11-02,21,21,home,13,BUF,137,244,66,62,34,21,Win,194,63,1,7,3,NYJ,55,331,307,0,Win
0.333333333,0.307692308,27.13333333,2017-11-05,17,20,away,-3,CAR,302,129,70,58,17,20,Loss,53,201,2,1,2,ATL,37,355,330,1,Loss
0.307692308,0.333333333,32.86666667,2017-11-05,20,17,home,3,ATL,129,302,29,63,20,17,Win,201,53,1,2,1,CAR,37,330,355,2,Win
0.375,0.272727273,32.36666667,2017-11-05,24,14,away,-3,TEN,268,186,39,77,20,23,Loss,73,71,2,3,1,BAL,43,341,257,2,Loss
0.272727273,0.375,27.63333333,2017-11-05,14,24,home,3,BAL,186,268,39,52,23,20,Win,71,73,3,2,2,TEN,43,257,341,1,Win
0.125,0.666666667,19.76666667,2017-11-05,8,26,away,-16,JAX,119,259,77,37,7,23,Loss,29,149,2,0,1,CIN,30,148,408,0,Loss
0.666666667,0.125,40.23333333,2017-11-05,26,8,home,16,CIN,259,119,50,78,23,7,Win,149,29,0,2,0,JAX,30,408,148,1,Win
0.23076923100000002,0.384615385,30.1,2017-11-05,14,25,away,-28,PHI,191,222,105,60,23,51,Loss,35,197,3,2,1,DEN,74,226,419,2,Loss
0.384615385,0.23076923100000002,29.9,2017-11-05,25,14,home,28,DEN,222,191,35,67,51,23,Win,197,35,2,3,2,PHI,74,419,226,1,Win
0.28571428600000004,0.28571428600000004,30.98333333,2017-11-05,17,19,away,6,HOU,279,194,68,61,20,14,Win,92,94,3,2,1,IND,34,371,288,1,Win
0.28571428600000004,0.28571428600000004,29.01666667,2017-11-05,19,17,home,-6,IND,194,279,74,67,14,20,Loss,94,92,2,3,1,HOU,34,288,371,1,Loss
0.5,0.5,30.5,2017-11-05,20,17,away,34,NYG,311,208,55,61,51,17,Win,162,111,0,2,3,LAR,68,473,319,0,Win
0.5,0.5,29.5,2017-11-05,17,20,home,-34,LAR,208,311,52,66,17,51,Loss,111,162,2,0,0,NYG,68,319,473,3,Loss
0.307692308,0.538461538,27.7,2017-11-05,14,21,away,-20,NOS,113,256,50,57,10,30,Loss,87,151,4,1,2,TBB,40,200,407,1,Loss
0.538461538,0.307692308,32.3,2017-11-05,21,14,home,20,TBB,256,113,28,60,30,10,Win,151,87,1,4,1,NOS,40,407,200,2,Win
0.4375,0.352941176,36.36666667,2017-11-05,20,17,away,10,SFO,201,266,25,73,20,10,Win,167,63,0,5,2,ARI,30,368,329,2,Win
0.352941176,0.4375,23.63333333,2017-11-05,17,20,home,-10,ARI,266,201,53,73,10,20,Loss,63,167,5,0,2,SFO,30,329,368,2,Loss
0.307692308,0.35714285700000004,27.68333333,2017-11-05,16,22,away,3,SEA,193,289,62,60,17,14,Win,51,148,6,2,2,WAS,31,244,437,1,Loss
0.35714285700000004,0.307692308,32.31666667,2017-11-05,22,16,home,-3,WAS,289,193,138,75,14,17,Loss,148,51,2,6,1,SEA,31,437,244,2,Loss
0.363636364,0.583333333,28.71666667,2017-11-05,17,24,away,-11,DAL,255,244,52,55,17,28,Loss,68,131,2,1,0,KCC,45,323,375,1,Loss
0.583333333,0.363636364,31.28333333,2017-11-05,24,17,home,11,KCC,244,255,65,65,28,17,Win,131,68,1,2,1,DAL,45,375,323,0,Win
0.533333333,0.41666666700000005,30.93333333,2017-11-05,20,23,away,3,MIA,295,309,105,58,27,24,Win,84,86,1,1,1,OAK,51,379,395,2,Win
0.41666666700000005,0.533333333,29.06666667,2017-11-05,23,20,home,-3,OAK,309,295,107,61,24,27,Loss,86,84,1,1,2,MIA,51,395,379,1,Loss
0.615384615,0.222222222,36.91666667,2017-11-06,24,21,away,13,GBP,353,233,19,67,30,17,Win,64,78,1,3,0,DET,47,417,311,1,Win
0.222222222,0.615384615,23.08333333,2017-11-06,21,24,home,-13,DET,233,353,20,58,17,30,Loss,78,64,3,1,1,GBP,47,311,417,0,Loss
0.23076923100000002,0.4,30.88333333,2017-11-09,14,24,away,6,ARI,212,256,108,60,22,16,Win,75,34,5,2,1,SEA,38,287,290,0,Win
0.4,0.23076923100000002,29.11666667,2017-11-09,24,14,home,-6,SEA,256,212,58,73,16,22,Loss,34,75,2,5,0,ARI,38,290,287,1,Loss
0.5,0.181818182,41.38333333,2017-11-12,32,10,away,37,BUF,184,129,41,73,47,10,Win,298,69,0,2,1,NOS,57,482,198,1,Win
0.181818182,0.5,18.61666667,2017-11-12,10,32,home,-37,NOS,129,184,56,45,10,47,Loss,69,298,2,0,1,BUF,57,198,482,1,Loss
0.4375,0.28571428600000004,33.88333333,2017-11-12,18,14,away,7,CHI,182,268,35,65,23,16,Win,160,55,3,5,1,GBP,39,342,323,0,Win
0.28571428600000004,0.4375,26.11666667,2017-11-12,14,18,home,-7,GBP,268,182,78,57,16,23,Loss,55,160,5,3,0,CHI,39,323,342,1,Loss
0.1,0.46666666700000003,19.85,2017-11-12,15,27,away,-4,TEN,255,236,84,50,20,24,Loss,53,180,1,4,2,CIN,44,308,416,2,Loss
0.46666666700000003,0.1,40.15,2017-11-12,27,15,home,4,CIN,236,255,55,84,24,20,Win,180,53,4,1,2,TEN,44,416,308,2,Win
0.333333333,0.454545455,34.56666667,2017-11-12,26,16,away,-14,DET,212,241,60,77,24,38,Loss,201,104,4,4,1,CLE,62,413,345,2,Loss
0.454545455,0.333333333,25.43333333,2017-11-12,16,26,home,14,CLE,241,212,81,49,38,24,Win,104,201,4,4,2,DET,62,345,413,1,Win
0.384615385,0.4,29.96666667,2017-11-12,18,13,away,3,IND,228,196,70,62,20,17,Win,88,71,1,3,1,PIT,37,316,267,1,Win
0.4,0.384615385,30.03333333,2017-11-12,13,18,home,-3,PIT,196,228,82,56,17,20,Loss,71,88,3,1,1,IND,37,267,316,1,Loss
0.2,0.27777777800000003,31.78333333,2017-11-12,16,20,away,-3,JAX,235,263,77,67,0,3,Loss,87,135,0,3,2,LAC,3,322,398,2,Loss
0.27777777800000003,0.2,35.01666667,2017-11-12,20,16,home,3,LAC,263,235,106,81,3,0,Win,135,87,3,0,2,JAX,3,398,322,2,Win
0.666666667,0.35714285700000004,28.9,2017-11-12,21,24,away,8,WAS,304,313,40,60,38,30,Win,102,81,0,1,1,MIN,68,406,394,2,Win
0.35714285700000004,0.666666667,31.1,2017-11-12,24,21,home,-8,MIN,313,304,15,73,30,38,Loss,81,102,1,0,2,WAS,68,394,406,1,Loss
0.2,0.4375,28.1,2017-11-12,15,17,away,-5,TBB,219,181,77,64,10,15,Loss,56,90,6,1,1,NYJ,25,275,271,2,Loss
0.4375,0.2,31.9,2017-11-12,17,15,home,5,NYJ,181,219,50,66,15,10,Win,90,56,1,6,2,TBB,25,271,275,1,Win
0.333333333,0.375,28.48333333,2017-11-12,17,19,away,-26,LAR,194,339,60,64,7,33,Loss,89,104,3,3,0,HOU,40,283,443,4,Loss
0.375,0.333333333,31.51666667,2017-11-12,19,17,home,26,HOU,339,194,86,66,33,7,Win,104,89,3,3,4,LAR,40,443,283,0,Win
0.454545455,0.538461538,27.9,2017-11-12,18,22,away,-20,ATL,126,204,54,59,7,27,Loss,107,132,8,1,1,DAL,34,233,336,2,Loss
0.538461538,0.454545455,32.1,2017-11-12,22,18,home,20,DAL,204,126,35,64,27,7,Win,132,107,1,8,2,ATL,34,336,233,1,Win
0.35714285700000004,0.666666667,31.0,2017-11-12,19,21,away,-10,SFO,260,288,35,63,21,31,Loss,114,186,3,0,2,NYG,52,374,474,1,Loss
0.666666667,0.35714285700000004,29.0,2017-11-12,21,19,home,10,NYG,288,260,44,58,31,21,Win,186,114,0,3,1,SFO,52,474,374,2,Win
0.363636364,0.533333333,29.71666667,2017-11-12,28,17,away,25,DEN,297,221,5,67,41,16,Win,99,118,1,0,2,NEP,57,396,339,0,Win
0.533333333,0.363636364,30.28333333,2017-11-12,17,28,home,-25,NEP,221,297,28,61,16,41,Loss,118,99,0,1,0,DEN,57,339,396,2,Loss
0.583333333,0.7857142859999999,24.35,2017-11-13,17,30,away,-24,CAR,213,254,57,54,21,45,Loss,100,294,0,0,0,MIA,66,313,548,1,Loss
0.7857142859999999,0.583333333,35.65,2017-11-13,30,17,home,24,MIA,254,213,37,71,45,21,Win,294,100,0,0,1,CAR,66,548,313,0,Win
0.384615385,0.333333333,28.33333333,2017-11-16,17,25,away,-23,PIT,264,284,65,60,17,40,Loss,52,65,5,3,0,TEN,57,316,349,4,Loss
0.333333333,0.384615385,31.66666667,2017-11-16,25,17,home,23,TEN,284,264,61,69,40,17,Win,65,52,3,5,4,PIT,57,349,316,0,Win
0.23076923100000002,0.46153846200000004,31.81666667,2017-11-19,19,18,away,10,MIA,268,365,82,62,30,20,Win,53,83,1,1,5,TBB,50,321,448,0,Win
0.46153846200000004,0.23076923100000002,28.18333333,2017-11-19,18,19,home,-10,TBB,365,268,123,60,20,30,Loss,83,53,1,1,0,MIA,50,448,321,5,Loss
0.3,0.533333333,26.23333333,2017-11-19,17,22,away,-10,HOU,244,223,90,54,21,31,Loss,48,134,2,1,2,ARI,52,292,357,2,Loss
0.533333333,0.3,33.76666667,2017-11-19,22,17,home,10,ARI,223,244,42,67,31,21,Win,134,48,1,2,2,HOU,52,357,292,2,Win
0.214285714,0.307692308,30.05,2017-11-19,14,16,away,23,GBP,161,190,30,57,23,0,Win,58,75,3,6,5,BAL,23,219,265,1,Win
0.307692308,0.214285714,29.95,2017-11-19,16,14,home,-23,BAL,190,161,53,67,0,23,Loss,75,58,6,3,1,GBP,23,265,219,5,Loss
0.3,0.333333333,30.6,2017-11-19,20,25,away,3,CHI,287,176,49,58,27,24,Win,65,222,3,1,1,DET,51,352,398,1,Win
0.333333333,0.3,29.4,2017-11-19,25,20,home,-3,DET,176,287,64,61,24,27,Loss,222,65,1,3,1,CHI,51,398,352,1,Loss
0.3,0.23076923100000002,36.91666667,2017-11-19,15,11,away,12,CLE,145,134,40,76,19,7,Win,139,50,2,5,5,JAX,26,284,184,1,Win
0.23076923100000002,0.3,23.08333333,2017-11-19,11,15,home,-12,JAX,134,145,0,55,7,19,Loss,50,139,5,2,1,CLE,26,184,284,5,Loss
0.272727273,0.23076923100000002,37.26666667,2017-11-19,22,20,away,-3,NYG,229,205,87,71,0,3,Loss,134,112,1,0,1,KCC,3,363,317,3,Loss
0.23076923100000002,0.272727273,30.83333333,2017-11-19,20,22,home,3,KCC,205,229,48,68,3,0,Win,112,134,0,1,3,NYG,3,317,363,1,Win
0.272727273,0.5,22.63333333,2017-11-19,15,27,away,-17,MIN,209,280,60,56,7,24,Loss,45,171,2,0,0,LAR,31,254,451,1,Loss
0.5,0.272727273,37.36666667,2017-11-19,27,15,home,17,LAR,280,209,65,73,24,7,Win,171,45,0,2,1,MIN,31,451,254,0,Win
0.333333333,0.333333333,32.18333333,2017-11-19,24,27,away,-3,NOS,300,375,67,67,0,3,Loss,156,160,2,2,1,WAS,3,456,535,0,Loss
0.333333333,0.333333333,30.4,2017-11-19,27,24,home,3,WAS,375,300,54,66,3,0,Win,160,156,2,2,0,NOS,3,535,456,1,Win
0.428571429,0.5,23.91666667,2017-11-19,18,28,away,-30,LAC,220,283,48,62,24,54,Loss,173,146,1,1,0,BUF,78,393,429,6,Loss
0.5,0.428571429,36.08333333,2017-11-19,28,18,home,30,BUF,283,220,13,73,54,24,Win,146,173,1,1,6,LAC,78,429,393,0,Win
0.46666666700000003,0.571428571,24.81666667,2017-11-19,12,20,away,3,DEN,141,229,14,53,20,17,Win,49,112,2,3,2,CIN,37,190,341,0,Win
0.571428571,0.46666666700000003,35.18333333,2017-11-19,20,12,home,-3,CIN,229,141,50,79,17,20,Loss,112,49,3,2,0,DEN,37,341,190,2,Loss
0.5,0.46666666700000003,27.61666667,2017-11-19,25,21,away,25,OAK,332,235,10,58,33,8,Win,89,109,1,1,2,NEP,41,421,344,0,Win
0.46666666700000003,0.5,32.38333333,2017-11-19,21,25,home,-25,NEP,235,332,66,71,8,33,Loss,109,89,1,1,0,OAK,41,344,421,2,Loss
0.35714285700000004,0.214285714,29.48333333,2017-11-19,17,14,away,28,DAL,168,113,30,60,37,9,Win,215,112,0,4,4,PHI,46,383,225,0,Win
0.214285714,0.35714285700000004,30.51666667,2017-11-19,14,17,home,-28,PHI,113,168,10,63,9,37,Loss,112,215,4,0,0,DAL,46,225,383,4,Loss
0.642857143,0.41666666700000005,30.35,2017-11-20,22,26,away,3,SEA,190,224,69,58,34,31,Win,89,136,1,3,2,ATL,65,279,360,1,Win
0.41666666700000005,0.642857143,29.65,2017-11-20,26,22,home,-3,ATL,224,190,106,69,31,34,Loss,136,89,3,1,1,SEA,65,360,279,2,Loss
0.46153846200000004,0.272727273,34.95,2017-11-23,28,17,away,7,DET,272,236,74,73,30,23,Win,136,53,2,3,2,MIN,53,408,289,0,Win
0.272727273,0.46153846200000004,25.05,2017-11-23,17,28,home,-7,MIN,236,272,54,53,23,30,Loss,53,136,3,2,0,DET,53,289,408,2,Loss
0.642857143,0.545454545,36.08333333,2017-11-23,25,14,away,22,DAL,434,168,56,66,28,6,Win,81,79,0,2,2,LAC,34,515,247,0,Win
0.545454545,0.642857143,23.91666667,2017-11-23,14,25,home,-22,LAC,168,434,60,49,6,28,Loss,79,81,2,0,0,DAL,34,247,515,2,Loss
0.14285714300000002,0.26666666699999997,25.38333333,2017-11-23,7,17,away,-10,WAS,86,201,79,55,10,20,Loss,84,122,4,6,1,NYG,30,170,323,1,Loss
0.26666666699999997,0.14285714300000002,34.61666667,2017-11-23,17,7,home,10,NYG,201,86,55,68,20,10,Win,122,84,6,4,1,WAS,30,323,170,1,Win
0.363636364,0.7857142859999999,29.9,2017-11-26,27,23,away,-14,ATL,279,368,15,68,20,34,Loss,94,148,1,0,1,TBB,54,373,516,0,Loss
0.7857142859999999,0.363636364,30.1,2017-11-26,23,27,home,14,TBB,368,279,42,64,34,20,Win,148,94,0,1,0,ATL,54,516,373,1,Win
0.352941176,0.153846154,33.3,2017-11-26,17,14,away,6,KCC,164,181,50,68,16,10,Win,104,55,2,2,1,BUF,26,268,236,0,Win
0.153846154,0.352941176,26.7,2017-11-26,14,17,home,-6,BUF,181,164,50,57,10,16,Loss,55,104,2,2,0,KCC,26,236,268,1,Loss
0.214285714,0.35714285700000004,31.83333333,2017-11-26,17,21,away,8,NYJ,154,282,84,64,35,27,Win,145,109,3,3,1,CAR,62,299,391,0,Win
0.35714285700000004,0.214285714,28.16666667,2017-11-26,21,17,home,-8,CAR,282,154,68,65,27,35,Loss,109,145,3,3,0,NYJ,62,391,299,1,Loss
0.23076923100000002,0.4375,22.86666667,2017-11-26,8,24,away,-28,PHI,134,244,56,49,3,31,Loss,6,176,2,1,3,CHI,34,140,420,2,Loss
0.4375,0.23076923100000002,37.13333333,2017-11-26,24,8,home,28,CHI,244,134,70,73,31,3,Win,176,6,1,2,2,PHI,34,420,140,3,Win
0.4,0.4,29.46666667,2017-11-26,21,23,away,-14,CIN,236,209,69,67,16,30,Loss,169,152,4,1,0,CLE,46,405,361,0,Loss
0.4,0.4,30.53333333,2017-11-26,23,21,home,14,CLE,209,236,35,59,30,16,Win,152,169,1,4,0,CIN,46,361,405,0,Win
0.375,0.428571429,28.63333333,2017-11-26,19,15,away,4,IND,184,165,15,53,20,16,Win,92,89,0,8,1,TEN,36,276,254,2,Win
0.428571429,0.375,31.36666667,2017-11-26,15,19,home,-4,TEN,165,184,67,61,16,20,Loss,89,92,8,0,2,IND,36,254,276,1,Loss
0.181818182,0.41666666700000005,27.31666667,2017-11-26,15,25,away,-18,NEP,154,221,52,60,17,35,Loss,67,196,7,1,2,MIA,52,221,417,3,Loss
0.41666666700000005,0.181818182,32.68333333,2017-11-26,25,15,home,18,MIA,221,154,70,67,35,17,Win,196,67,1,7,3,NEP,52,417,221,2,Win
0.384615385,0.3125,29.51666667,2017-11-26,20,16,away,11,SFO,228,196,35,64,24,13,Win,90,84,0,3,1,SEA,37,318,280,1,Win
0.3125,0.384615385,30.48333333,2017-11-26,16,20,home,-11,SEA,196,228,74,67,13,24,Loss,84,90,3,0,1,SFO,37,280,318,1,Loss
0.083333333,0.41176470600000004,25.35,2017-11-26,19,20,away,-3,ARI,128,236,45,58,24,27,Loss,91,108,3,1,2,JAX,51,219,344,3,Loss
0.41176470600000004,0.083333333,34.65,2017-11-26,20,19,home,3,JAX,236,128,98,70,27,24,Win,108,91,1,3,3,ARI,51,344,219,2,Win
0.35714285700000004,0.384615385,24.1,2017-11-26,12,21,away,-7,OAK,160,244,75,57,14,21,Loss,56,104,5,2,1,DEN,35,216,348,1,Loss
0.384615385,0.35714285700000004,35.9,2017-11-26,21,12,home,7,DEN,244,160,68,63,21,14,Win,104,56,2,5,1,OAK,35,348,216,1,Win
0.23076923100000002,0.214285714,24.56666667,2017-11-26,14,24,away,-6,LAR,223,327,112,52,20,26,Loss,123,88,3,4,1,NOS,46,346,415,0,Loss
0.214285714,0.23076923100000002,35.43333333,2017-11-26,24,14,home,6,NOS,327,223,90,73,26,20,Win,88,123,4,3,0,LAR,46,415,346,1,Win
0.46153846200000004,0.615384615,26.4,2017-11-26,15,28,away,-3,PIT,227,341,27,54,28,31,Loss,80,121,4,1,3,GBP,59,307,462,0,Loss
0.615384615,0.46153846200000004,33.6,2017-11-26,28,15,home,3,GBP,341,227,45,70,31,28,Win,121,80,1,4,0,PIT,59,462,307,3,Win
0.428571429,0.214285714,30.26666667,2017-11-27,20,17,away,-7,BAL,237,155,36,64,16,23,Loss,66,139,2,1,0,HOU,39,303,294,3,Loss
0.214285714,0.428571429,29.73333333,2017-11-27,17,20,home,7,HOU,155,237,89,65,23,16,Win,139,66,1,2,3,BAL,39,294,303,0,Win
0.428571429,0.5,27.53333333,2017-11-30,15,21,away,-24,DAL,224,93,43,60,14,38,Loss,56,182,4,1,0,WAS,52,280,275,4,Loss
0.5,0.428571429,32.46666667,2017-11-30,21,15,home,24,WAS,93,224,25,65,38,14,Win,182,56,1,4,4,DAL,52,275,280,0,Win
0.5,0.1,34.03333333,2017-12-03,22,15,away,5,ATL,207,173,51,63,14,9,Win,105,102,2,0,0,MIN,23,312,275,0,Win
0.1,0.5,25.96666667,2017-12-03,15,22,home,-5,MIN,173,207,55,51,9,14,Loss,102,105,0,2,0,ATL,23,275,312,0,Loss
0.307692308,0.41666666700000005,30.15,2017-12-03,18,24,away,-24,BAL,294,269,45,61,20,44,Loss,78,101,3,0,0,DET,64,372,370,3,Loss
0.41666666700000005,0.307692308,29.85,2017-12-03,24,18,home,24,DET,269,294,25,63,44,20,Win,101,78,0,3,3,BAL,64,370,372,0,Win
0.41666666700000005,0.384615385,34.01666667,2017-12-03,23,16,away,20,BUF,244,85,66,68,23,3,Win,191,183,3,4,1,NEP,26,435,268,1,Win
0.384615385,0.41666666700000005,25.98333333,2017-12-03,16,23,home,-20,NEP,85,244,34,64,3,23,Loss,183,191,4,3,1,BUF,26,268,435,1,Loss
0.5555555560000001,0.5,38.78333333,2017-12-03,23,8,away,1,CHI,278,85,53,73,15,14,Win,110,62,2,2,0,SFO,29,388,147,1,Loss
0.5,0.5555555560000001,21.21666667,2017-12-03,8,23,home,-1,SFO,85,278,29,36,14,15,Loss,62,110,2,2,1,CHI,29,147,388,0,Loss
0.076923077,0.26666666699999997,25.63333333,2017-12-03,14,15,away,-26,MIA,167,222,57,67,9,35,Loss,103,145,3,2,3,DEN,44,270,367,3,Loss
0.26666666699999997,0.076923077,34.36666667,2017-12-03,15,14,home,26,DEN,222,167,85,64,35,9,Win,145,103,2,3,3,MIA,44,367,270,3,Win
0.5625,0.41666666700000005,37.28333333,2017-12-03,25,16,away,-6,GBP,230,77,74,74,0,6,Loss,165,199,7,2,1,TBB,6,395,276,1,Loss
0.41666666700000005,0.5625,26.73333333,2017-12-03,16,25,home,6,TBB,77,230,47,53,6,0,Win,199,165,2,7,1,GBP,6,276,395,1,Win
0.5,0.454545455,33.81666667,2017-12-03,24,19,away,-11,TEN,331,146,85,75,13,24,Loss,53,198,4,2,1,HOU,37,384,344,1,Loss
0.454545455,0.5,26.18333333,2017-12-03,19,24,home,11,HOU,146,331,63,50,24,13,Win,198,53,2,4,1,TEN,37,344,384,1,Win
0.333333333,0.6,26.21666667,2017-12-03,17,22,away,-20,JAX,149,330,31,66,10,30,Loss,141,96,4,1,0,IND,40,290,426,2,Loss
0.6,0.333333333,33.78333333,2017-12-03,22,17,home,20,IND,330,149,55,64,30,10,Win,96,141,1,4,2,JAX,40,426,290,0,Win
0.375,0.65,17.18333333,2017-12-03,17,30,away,-7,NYJ,362,331,30,46,31,38,Loss,112,157,2,0,0,KCC,69,474,488,0,Loss
0.65,0.375,42.81666667,2017-12-03,30,17,home,7,KCC,331,362,40,85,38,31,Win,157,112,0,2,0,NYJ,69,488,474,0,Win
0.454545455,0.533333333,25.05,2017-12-03,17,23,away,-9,LAC,202,335,24,57,10,19,Loss,89,94,3,1,0,CLE,29,291,429,2,Loss
0.533333333,0.454545455,34.95,2017-12-03,23,17,home,9,CLE,335,202,62,69,19,10,Win,94,89,1,3,2,LAC,29,429,291,0,Win
0.272727273,0.46666666700000003,28.96666667,2017-12-03,18,19,away,16,ARI,213,187,36,56,32,16,Win,90,118,1,7,2,LAR,48,303,305,1,Win
0.46666666700000003,0.272727273,31.03333333,2017-12-03,19,18,home,-16,LAR,187,213,25,62,16,32,Loss,118,90,7,1,1,ARI,48,305,303,2,Loss
0.3,0.4,26.65,2017-12-03,16,19,away,-10,NOS,167,252,54,53,21,31,Loss,112,148,2,2,1,CAR,52,279,400,1,Loss
0.4,0.3,33.35,2017-12-03,19,16,home,10,CAR,252,167,68,64,31,21,Win,148,112,2,2,1,NOS,52,400,279,1,Win
0.35714285700000004,0.4,28.68333333,2017-12-03,15,18,away,-7,OAK,200,282,5,61,17,24,Loss,65,119,3,1,1,NYG,41,265,401,2,Loss
0.4,0.35714285700000004,31.31666667,2017-12-03,18,15,home,7,NYG,282,200,42,66,24,17,Win,119,65,1,3,2,OAK,41,401,265,1,Win
0.5,0.5,31.9,2017-12-03,25,20,away,-14,SEA,327,209,64,74,10,24,Loss,98,101,3,2,0,PHI,34,425,310,2,Loss
0.5,0.5,28.1,2017-12-03,20,25,home,14,PHI,209,327,46,58,24,10,Win,101,98,2,3,2,SEA,34,310,425,0,Win
0.333333333,0.5,29.81666667,2017-12-04,24,19,away,3,CIN,282,223,66,63,23,20,Win,92,130,1,2,0,PIT,43,374,353,1,Loss
0.5,0.333333333,30.18333333,2017-12-04,19,24,home,-3,PIT,223,282,173,60,20,23,Loss,130,92,2,1,1,CIN,43,353,374,0,Loss
0.3,0.583333333,25.31666667,2017-12-07,18,26,away,-3,ATL,256,211,82,52,17,20,Loss,50,132,2,1,3,NOS,37,306,343,1,Loss
0.583333333,0.3,34.68333333,2017-12-07,26,18,home,3,NOS,211,256,35,65,20,17,Win,132,50,1,2,1,ATL,37,343,306,3,Win
0.25,0.5555555560000001,36.03333333,2017-12-10,16,14,away,-6,BUF,64,92,20,69,0,6,Loss,163,227,1,0,2,IND,6,227,319,0,Loss
0.5555555560000001,0.25,32.41666667,2017-12-10,14,16,home,6,IND,92,64,10,67,6,0,Win,227,163,0,1,0,BUF,6,319,227,2,Win
0.46666666700000003,0.333333333,28.7,2017-12-10,21,15,away,-7,CAR,256,129,30,71,24,31,Loss,100,216,6,2,1,MIN,55,356,345,3,Loss
0.333333333,0.46666666700000003,31.3,2017-12-10,15,21,home,7,MIN,129,256,48,63,31,24,Win,216,100,2,6,3,CAR,55,345,356,1,Win
0.363636364,0.25,38.15,2017-12-10,29,14,away,26,CIN,250,164,74,72,33,7,Win,232,70,2,3,2,CHI,40,482,234,0,Win
0.25,0.363636364,21.85,2017-12-10,14,29,home,-26,CHI,164,250,56,53,7,33,Loss,70,232,3,2,0,CIN,40,234,482,2,Loss
0.5,0.538461538,36.28333333,2017-12-10,24,17,away,6,CLE,256,209,20,74,6,0,Win,85,136,1,2,2,GBP,6,341,345,0,Win
0.538461538,0.5,28.63333333,2017-12-10,17,24,home,-6,GBP,209,256,45,57,0,6,Loss,136,85,2,1,0,CLE,6,345,341,2,Loss
0.5,0.375,27.11666667,2017-12-10,19,21,away,20,NYG,332,228,51,61,30,10,Win,122,102,0,0,2,DAL,40,454,330,0,Win
0.375,0.5,32.88333333,2017-12-10,21,19,home,-20,DAL,228,332,69,75,10,30,Loss,102,122,0,0,0,NYG,40,330,454,2,Loss
0.454545455,0.5,29.78333333,2017-12-10,21,28,away,3,TBB,381,267,105,62,24,21,Win,53,133,0,3,5,DET,45,434,400,3,Win
0.5,0.454545455,30.21666667,2017-12-10,28,21,home,-3,DET,267,381,65,69,21,24,Loss,133,53,3,0,3,TBB,45,400,434,5,Loss
0.181818182,0.23076923100000002,34.81666667,2017-12-10,20,18,away,10,HOU,314,221,87,66,26,16,Win,102,90,2,3,1,SFO,42,416,311,1,Win
0.23076923100000002,0.181818182,25.18333333,2017-12-10,18,20,home,-10,SFO,221,314,81,64,16,26,Loss,90,102,3,2,1,HOU,42,311,416,1,Loss
0.384615385,0.384615385,23.33333333,2017-12-10,15,23,away,-11,KCC,198,243,39,55,15,26,Loss,70,165,3,4,1,OAK,41,268,408,3,Loss
0.384615385,0.384615385,36.66666667,2017-12-10,23,15,home,11,OAK,243,198,69,71,26,15,Win,165,70,4,3,3,KCC,41,408,268,1,Win
0.333333333,0.214285714,26.18333333,2017-12-10,14,16,away,-5,ARI,139,125,48,56,7,12,Loss,65,136,3,8,0,TEN,19,204,261,2,Loss
0.214285714,0.333333333,33.81666667,2017-12-10,16,14,home,5,TEN,125,139,30,63,12,7,Win,136,65,8,3,2,ARI,19,261,204,0,Win
0.23076923100000002,0.41176470600000004,22.41666667,2017-12-10,6,17,away,-23,DEN,41,189,20,48,0,23,Loss,59,84,4,2,0,NYJ,23,100,273,2,Loss
0.41176470600000004,0.23076923100000002,37.58333333,2017-12-10,17,6,home,23,NYJ,189,41,21,68,23,0,Win,84,59,2,4,2,DEN,23,273,100,0,Win
0.166666667,0.4,24.66666667,2017-12-10,9,24,away,-17,LAC,136,314,47,50,13,30,Loss,65,174,2,2,1,WAS,43,201,488,1,Loss
0.4,0.166666667,35.33333333,2017-12-10,24,9,home,17,WAS,314,136,40,71,30,13,Win,174,65,2,2,1,LAC,43,488,201,1,Win
0.222222222,0.333333333,26.98333333,2017-12-10,17,20,away,-6,JAX,260,268,73,57,24,30,Loss,141,156,2,0,1,SEA,54,401,424,3,Loss
0.333333333,0.222222222,33.01666667,2017-12-10,20,17,home,6,SEA,268,260,48,66,30,24,Win,156,141,0,2,3,JAX,54,424,401,1,Win
0.4,0.28571428600000004,39.2,2017-12-10,29,17,away,8,LAR,316,198,67,85,43,35,Win,139,109,2,2,2,PHI,78,455,307,1,Win
0.28571428600000004,0.4,20.8,2017-12-10,17,29,home,-8,PHI,198,316,102,45,35,43,Loss,109,139,2,2,1,LAR,78,307,455,2,Loss
0.4,0.666666667,26.16666667,2017-12-10,26,31,away,-1,PIT,261,486,35,62,38,39,Loss,152,59,1,3,0,BAL,77,413,545,1,Loss
0.666666667,0.4,33.83333333,2017-12-10,31,26,home,1,BAL,486,261,101,85,39,38,Win,59,152,3,1,1,PIT,77,545,413,0,Loss
0.0,0.28571428600000004,23.85,2017-12-11,14,21,away,-7,MIA,223,242,78,55,20,27,Loss,25,120,2,2,0,NEP,47,248,362,2,Loss
0.28571428600000004,0.0,36.15,2017-12-11,21,14,home,7,NEP,242,223,102,70,27,20,Win,120,25,2,2,2,MIA,47,362,248,0,Win
0.46666666700000003,0.46153846200000004,36.85,2017-12-14,23,15,away,12,IND,251,158,80,74,25,13,Win,211,70,2,1,0,DEN,38,462,228,1,Win
0.46153846200000004,0.46666666700000003,23.15,2017-12-14,15,23,home,-12,DEN,158,251,39,53,13,25,Loss,70,211,1,2,1,IND,38,228,462,0,Loss
0.41666666700000005,0.46153846200000004,30.91666667,2017-12-16,22,18,away,-10,DET,306,202,97,63,10,20,Loss,43,91,2,4,1,CHI,30,349,293,3,Loss
0.46153846200000004,0.41666666700000005,29.08333333,2017-12-16,18,22,home,10,CHI,202,306,58,57,20,10,Win,91,43,4,2,3,DET,30,293,349,1,Win
0.363636364,0.428571429,26.65,2017-12-16,20,20,away,-17,KCC,209,223,61,60,13,30,Loss,98,174,2,1,0,LAC,43,307,397,4,Loss
0.428571429,0.363636364,33.35,2017-12-16,20,20,home,17,LAC,223,209,71,63,30,13,Win,174,98,1,2,4,KCC,43,397,307,0,Win
0.21052631600000002,0.111111111,36.26666667,2017-12-17,19,14,away,-5,WAS,145,187,71,80,15,20,Loss,141,31,5,1,1,ARI,35,286,218,2,Loss
0.111111111,0.21052631600000002,23.73333333,2017-12-17,14,19,home,5,ARI,187,145,82,47,20,15,Win,31,141,1,5,2,WAS,35,218,286,1,Win
0.4375,0.35714285700000004,36.8,2017-12-17,23,15,away,17,CLE,279,136,57,74,27,10,Win,97,130,1,2,4,BAL,37,376,266,0,Win
0.35714285700000004,0.4375,23.2,2017-12-17,15,23,home,-17,BAL,136,279,35,58,10,27,Loss,130,97,2,1,0,CLE,37,266,376,4,Loss
0.3125,0.46666666700000003,32.41666667,2017-12-17,21,21,away,-8,BUF,249,212,60,73,16,24,Loss,100,116,3,2,0,MIA,40,349,328,3,Loss
0.46666666700000003,0.3125,27.58333333,2017-12-17,21,21,home,8,MIA,212,249,28,61,24,16,Win,116,100,2,3,3,BUF,40,328,349,0,Win
0.363636364,0.5,26.05,2017-12-17,24,29,away,-7,CAR,264,236,28,67,24,31,Loss,120,151,3,1,0,GBP,55,384,387,4,Loss
0.5,0.363636364,33.95,2017-12-17,29,24,home,7,GBP,236,264,40,70,31,24,Win,151,120,1,3,4,CAR,55,387,384,0,Win
0.076923077,0.333333333,24.13333333,2017-12-17,8,18,away,-27,MIN,115,222,44,51,7,34,Loss,46,124,3,2,1,CIN,41,161,346,2,Loss
0.333333333,0.076923077,35.86666667,2017-12-17,18,8,home,27,CIN,222,115,93,61,34,7,Win,124,46,2,3,2,MIN,41,346,161,1,Win
0.25,0.3,26.7,2017-12-17,9,25,away,-38,JAX,99,326,127,56,7,45,Loss,87,138,4,1,0,HOU,52,186,464,1,Loss
0.3,0.25,33.3,2017-12-17,25,9,home,38,HOU,326,99,54,68,45,7,Win,138,87,1,4,1,JAX,52,464,186,0,Win
0.333333333,0.3,30.83333333,2017-12-17,19,23,away,-12,NOS,170,281,50,68,19,31,Loss,124,131,1,0,3,NYJ,50,294,412,2,Loss
0.3,0.333333333,29.16666667,2017-12-17,23,19,home,12,NYJ,281,170,92,64,31,19,Win,131,124,0,1,2,NOS,50,412,294,3,Win
0.46153846200000004,0.5555555560000001,30.88333333,2017-12-17,22,27,away,5,NYG,233,429,44,66,34,29,Win,108,75,1,1,1,PHI,63,341,504,0,Win
0.5555555560000001,0.46153846200000004,29.11666667,2017-12-17,27,22,home,-5,PHI,429,233,67,81,29,34,Loss,75,108,1,1,0,NYG,63,504,341,1,Loss
0.375,0.28571428600000004,36.76666667,2017-12-17,19,11,away,35,SEA,108,71,25,68,42,7,Win,244,78,2,7,2,LAR,49,352,149,1,Win
0.28571428600000004,0.375,23.23333333,2017-12-17,11,19,home,-35,LAR,71,108,60,54,7,42,Loss,78,244,7,2,1,SEA,49,149,352,2,Loss
0.333333333,0.625,24.88333333,2017-12-17,21,21,away,3,PIT,283,270,4,56,27,24,Win,77,143,2,2,1,NEP,51,360,413,1,Win
0.625,0.333333333,35.11666667,2017-12-17,21,21,home,-3,NEP,270,283,63,63,24,27,Loss,143,77,2,2,1,PIT,51,413,360,1,Loss
0.5,0.5,27.41666667,2017-12-17,23,23,away,-2,SFO,238,363,22,62,23,25,Loss,90,51,1,3,0,TEN,48,328,414,1,Loss
0.5,0.5,32.58333333,2017-12-17,23,23,home,2,TEN,363,238,70,68,25,23,Win,51,90,3,1,1,SFO,48,414,328,0,Win
0.2,0.533333333,32.33333333,2017-12-17,21,19,away,3,OAK,204,171,100,60,20,17,Win,126,122,2,0,1,DAL,37,330,293,2,Win
0.533333333,0.2,27.66666667,2017-12-17,19,21,home,-3,DAL,171,204,105,61,17,20,Loss,122,126,0,2,2,OAK,37,293,330,1,Loss
0.6,0.5,33.25,2017-12-18,24,22,away,3,TBB,209,289,60,67,24,21,Win,201,84,1,2,1,ATL,45,410,373,0,Win
0.5,0.6,26.75,2017-12-18,22,24,home,-3,ATL,289,209,53,55,21,24,Loss,84,201,2,1,0,TBB,45,373,410,1,Loss
0.384615385,0.428571429,24.2,2017-12-23,17,23,away,-7,BAL,203,220,19,59,16,23,Loss,93,103,2,1,0,IND,39,296,323,0,Loss
0.428571429,0.384615385,35.8,2017-12-23,23,17,home,7,IND,220,203,25,71,23,16,Win,103,93,1,2,0,BAL,39,323,296,0,Win
0.26666666699999997,0.26666666699999997,31.61666667,2017-12-23,15,12,away,16,GBP,124,126,10,61,16,0,Win,112,113,3,1,2,MIN,16,236,239,0,Win
0.26666666699999997,0.26666666699999997,28.38333333,2017-12-23,12,15,home,-16,MIN,126,124,79,65,0,16,Loss,113,112,1,3,0,GBP,16,239,236,2,Loss
0.153846154,0.23076923100000002,26.2,2017-12-24,15,15,away,-10,NOS,264,229,91,61,13,23,Loss,67,86,5,1,1,ATL,36,331,315,2,Loss
0.23076923100000002,0.153846154,33.8,2017-12-24,15,15,home,10,ATL,229,264,30,60,23,13,Win,86,67,1,5,2,NOS,36,315,331,1,Win
0.470588235,0.454545455,28.26666667,2017-12-24,17,28,away,-21,NEP,242,218,83,68,16,37,Loss,84,193,6,2,1,BUF,53,326,411,0,Loss
0.454545455,0.470588235,31.73333333,2017-12-24,28,17,home,21,BUF,218,242,10,68,37,16,Win,193,84,2,6,0,NEP,53,411,326,1,Win
0.545454545,0.307692308,29.5,2017-12-24,20,20,away,-3,CAR,326,140,72,57,19,22,Loss,66,115,6,2,1,TBB,41,392,255,3,Loss
0.307692308,0.545454545,30.5,2017-12-24,20,20,home,3,TBB,140,326,50,59,22,19,Win,115,66,2,6,3,CAR,41,255,392,1,Win
0.307692308,0.4375,26.76666667,2017-12-24,12,16,away,-17,CHI,178,161,60,57,3,20,Loss,76,97,1,5,0,CLE,23,254,258,3,Loss
0.4375,0.307692308,33.23333333,2017-12-24,16,12,home,17,CLE,161,178,25,59,20,3,Win,97,76,5,1,3,CHI,23,258,254,0,Win
0.4,0.5,27.51666667,2017-12-24,15,28,away,-9,CIN,189,222,74,59,17,26,Loss,87,142,2,3,1,DET,43,276,364,1,Loss
0.5,0.4,32.48333333,2017-12-24,28,15,home,9,DET,222,189,60,78,26,17,Win,142,87,3,2,1,CIN,43,364,276,1,Win
0.294117647,0.384615385,30.45,2017-12-24,18,19,away,-16,WAS,171,299,30,71,11,27,Loss,159,87,4,0,2,DEN,38,330,386,3,Loss
0.384615385,0.294117647,29.55,2017-12-24,19,18,home,16,DEN,299,171,35,66,27,11,Win,87,159,0,4,3,WAS,38,386,330,2,Win
0.0,0.5,22.11666667,2017-12-24,15,23,away,-16,KCC,286,301,75,54,13,29,Loss,59,103,0,1,0,MIA,42,345,404,2,Loss
0.5,0.0,37.88333333,2017-12-24,23,15,home,16,MIA,301,286,40,74,29,13,Win,103,59,1,0,2,KCC,42,404,345,0,Win
0.333333333,0.214285714,32.96666667,2017-12-24,21,13,away,7,NYJ,290,98,80,70,14,7,Win,89,197,0,3,3,LAC,21,379,295,0,Win
0.214285714,0.333333333,27.03333333,2017-12-24,13,21,home,-7,LAC,98,290,34,61,7,14,Loss,197,89,3,0,0,NYJ,21,295,379,3,Loss
0.428571429,0.25,30.06666667,2017-12-24,20,19,away,4,TEN,286,269,44,66,27,23,Win,116,97,1,1,1,LAR,50,402,366,1,Win
0.25,0.428571429,29.93333333,2017-12-24,19,20,home,-4,LAR,269,286,54,66,23,27,Loss,97,116,1,1,1,TEN,50,366,402,1,Loss
0.384615385,0.666666667,30.81666667,2017-12-24,32,26,away,-11,SFO,380,238,99,79,33,44,Loss,92,131,1,1,1,JAX,77,472,369,3,Loss
0.666666667,0.384615385,29.18333333,2017-12-24,26,32,home,11,JAX,238,380,68,66,44,33,Win,131,92,1,1,3,SFO,77,369,472,1,Win
0.071428571,0.35714285700000004,26.78333333,2017-12-24,12,19,away,-23,ARI,250,215,101,67,0,23,Loss,43,74,2,2,2,NYG,23,293,289,3,Loss
0.35714285700000004,0.071428571,33.21666667,2017-12-24,19,12,home,23,NYG,215,250,45,64,23,0,Win,74,43,2,2,3,ARI,23,289,293,2,Win
0.363636364,0.46153846200000004,27.16666667,2017-12-24,15,21,away,9,DAL,60,154,142,54,21,12,Win,76,128,3,4,3,SEA,33,136,282,0,Win
0.46153846200000004,0.363636364,32.83333333,2017-12-24,21,15,home,-9,SEA,154,60,75,68,12,21,Loss,128,76,4,3,0,DAL,33,282,136,3,Loss
0.583333333,0.25,30.93333333,2017-12-25,20,13,away,28,HOU,226,51,24,58,34,6,Win,104,176,0,7,2,PIT,40,330,227,0,Win
0.25,0.583333333,29.06666667,2017-12-25,13,20,home,-28,PIT,51,226,80,52,6,34,Loss,176,104,7,0,0,HOU,40,227,330,2,Loss
0.23076923100000002,0.071428571,34.35,2017-12-25,13,12,away,-9,PHI,137,138,50,63,10,19,Loss,137,78,1,2,2,OAK,29,274,216,5,Loss
0.071428571,0.23076923100000002,25.65,2017-12-25,12,13,home,9,OAK,138,137,60,61,19,10,Win,78,137,2,1,5,PHI,29,216,274,2,Win
0.083333333,0.384615385,24.08333333,2017-12-31,12,21,away,-13,MIN,171,180,116,53,10,23,Loss,30,147,1,2,0,CHI,33,201,327,0,Loss
0.384615385,0.083333333,35.91666667,2017-12-31,21,12,home,13,CHI,180,171,103,67,23,10,Win,147,30,2,1,0,MIN,33,327,201,0,Win
0.46666666700000003,0.3,30.91666667,2017-12-31,17,20,away,-4,PIT,272,224,77,63,24,28,Loss,102,124,6,3,2,CLE,52,374,348,2,Loss
0.3,0.46666666700000003,29.08333333,2017-12-31,20,17,home,4,CLE,224,272,15,58,28,24,Win,124,102,3,6,2,PIT,52,348,374,2,Win
0.333333333,0.181818182,30.08333333,2017-12-31,16,12,away,6,PHI,172,149,64,63,6,0,Win,129,70,1,3,2,DAL,6,301,219,1,Win
0.181818182,0.333333333,29.91666667,2017-12-31,12,16,home,-6,DAL,149,172,49,55,0,6,Loss,70,129,3,1,1,PHI,6,219,301,2,Loss
0.28571428600000004,0.333333333,31.78333333,2017-12-31,17,18,away,-24,DET,153,305,68,63,11,35,Loss,103,51,4,2,0,GBP,46,256,356,4,Loss
0.333333333,0.28571428600000004,28.21666667,2017-12-31,18,17,home,24,GBP,305,153,62,54,35,11,Win,51,103,2,4,4,DET,46,356,256,0,Win
0.454545455,0.46153846200000004,28.78333333,2017-12-31,15,20,away,-9,IND,124,104,34,53,13,22,Loss,85,146,2,1,0,HOU,35,209,250,1,Loss
0.46153846200000004,0.454545455,31.21666667,2017-12-31,20,15,home,9,HOU,104,124,20,62,22,13,Win,146,85,1,2,1,IND,35,250,209,0,Win
0.0,0.26666666699999997,25.18333333,2017-12-31,14,28,away,-20,NEP,207,183,84,59,6,26,Loss,40,147,4,2,0,NYJ,32,247,330,0,Loss
0.26666666699999997,0.0,34.81666667,2017-12-31,28,14,home,20,NYJ,183,207,49,80,26,6,Win,147,40,2,4,0,NEP,32,330,247,0,Win
0.076923077,0.25,28.11666667,2017-12-31,10,17,away,-8,NYG,136,121,35,56,10,18,Loss,61,260,3,2,1,WAS,28,197,381,3,Loss
0.25,0.076923077,31.88333333,2017-12-31,17,10,home,8,WAS,121,136,25,74,18,10,Win,260,61,2,3,3,NYG,28,381,197,1,Win
0.28571428600000004,0.083333333,32.26666667,2017-12-31,19,13,away,2,SEA,143,195,25,68,26,24,Win,116,101,1,3,0,ARI,50,259,296,1,Win
0.083333333,0.28571428600000004,27.73333333,2017-12-31,13,19,home,-2,ARI,195,143,100,54,24,26,Loss,101,116,3,1,1,SEA,50,296,259,0,Loss
0.333333333,0.375,25.3,2017-12-31,15,20,away,-12,ATL,161,311,35,60,10,22,Loss,87,60,2,1,0,CAR,32,248,371,3,Loss
0.375,0.333333333,34.7,2017-12-31,20,15,home,12,CAR,311,161,60,72,22,10,Win,60,87,1,2,3,ATL,32,371,248,0,Win
0.333333333,0.294117647,28.65,2017-12-31,22,19,away,4,BAL,213,194,60,75,31,27,Win,146,118,1,1,1,CIN,58,359,312,1,Win
0.294117647,0.333333333,31.35,2017-12-31,19,22,home,-4,CIN,194,213,47,74,27,31,Loss,118,146,1,1,1,BAL,58,312,359,1,Loss
0.41666666700000005,0.384615385,31.06666667,2017-12-31,23,21,away,6,MIA,186,263,45,63,22,16,Win,126,93,4,1,1,BUF,38,312,356,0,Win
0.384615385,0.41666666700000005,28.93333333,2017-12-31,21,23,home,-6,BUF,263,186,145,67,16,22,Loss,93,126,1,4,0,MIA,38,356,312,1,Loss
0.363636364,0.41666666700000005,29.05,2017-12-31,23,22,away,3,DEN,269,226,40,65,27,24,Win,110,110,2,5,3,KCC,51,379,336,2,Win
0.41666666700000005,0.363636364,30.95,2017-12-31,22,23,home,-3,KCC,226,269,30,65,24,27,Loss,110,110,5,2,2,DEN,51,336,379,3,Loss
0.375,0.1875,26.55,2017-12-31,13,11,away,-5,TEN,146,116,41,60,10,15,Loss,83,116,2,3,1,JAX,25,229,232,4,Loss
0.1875,0.375,33.45,2017-12-31,11,13,home,5,JAX,116,146,15,63,15,10,Win,116,83,3,2,4,TEN,25,232,229,1,Win
0.363636364,0.538461538,26.66666667,2017-12-31,14,26,away,-20,LAC,231,380,85,53,10,30,Loss,105,115,2,1,0,OAK,40,336,495,2,Loss
0.538461538,0.363636364,33.33333333,2017-12-31,26,14,home,20,OAK,380,231,65,68,30,10,Win,115,105,1,2,2,LAC,40,495,336,0,Win
0.5,0.333333333,29.15,2017-12-31,25,15,away,21,LAR,292,149,23,63,34,13,Win,169,102,0,3,2,SFO,47,461,251,3,Win
0.333333333,0.5,30.85,2017-12-31,15,25,home,-21,SFO,149,292,46,63,13,34,Loss,102,169,3,0,3,LAR,47,251,461,2,Loss
0.5,0.7222222220000001,28.45,2017-12-31,18,28,away,-7,TBB,231,345,38,58,24,31,Loss,92,110,2,2,3,NOS,55,323,455,1,Loss
0.7222222220000001,0.5,31.55,2017-12-31,28,18,home,7,NOS,345,231,15,81,31,24,Win,110,92,2,2,1,TBB,55,455,323,3,Win
0.615384615,0.363636364,32.46666667,2018-01-06,23,19,away,1,KCC,195,256,50,64,22,21,Win,202,69,2,4,0,TEN,43,397,325,2,Loss
0.363636364,0.615384615,27.53333333,2018-01-06,19,23,home,-1,TEN,256,195,68,53,21,22,Loss,69,202,4,2,2,KCC,43,325,397,0,Win
0.333333333,0.35714285700000004,37.58333333,2018-01-06,20,19,away,13,LAR,198,246,51,72,26,13,Win,124,115,3,3,2,ATL,39,322,361,0,Win
0.35714285700000004,0.333333333,22.41666667,2018-01-06,19,20,home,-13,ATL,246,198,45,64,13,26,Loss,115,124,3,3,0,LAR,39,361,322,2,Loss
0.38888888899999996,0.166666667,32.61666667,2018-01-07,20,15,away,-7,JAX,133,75,52,74,3,10,Loss,130,155,2,2,0,BUF,13,263,230,2,Loss
0.166666667,0.38888888899999996,27.38333333,2018-01-07,15,20,home,7,BUF,75,133,34,59,10,3,Win,155,130,2,2,2,JAX,13,230,263,0,Win
0.470588235,0.25,33.81666667,2018-01-07,24,21,away,-5,NOS,306,369,18,71,26,31,Loss,107,41,4,1,1,CAR,57,413,410,0,Loss
0.25,0.470588235,26.18333333,2018-01-07,21,24,home,5,CAR,369,306,96,56,31,26,Win,41,107,1,4,0,NOS,57,410,413,1,Win
0.307692308,0.46153846200000004,27.9,2018-01-13,19,22,away,-5,PHI,195,238,73,59,10,15,Loss,86,96,3,1,2,ATL,25,281,334,0,Loss
0.46153846200000004,0.307692308,32.1,2018-01-13,22,19,home,5,ATL,238,195,24,63,15,10,Win,96,86,1,3,0,PHI,25,334,281,2,Win
0.333333333,0.647058824,27.06666667,2018-01-13,15,31,away,-21,NEP,202,337,62,61,14,35,Loss,65,101,8,0,0,TEN,49,267,438,0,Loss
0.647058824,0.333333333,32.93333333,2018-01-13,31,15,home,21,TEN,337,202,37,80,35,14,Win,101,65,0,8,0,NEP,49,438,267,0,Win
0.571428571,0.4375,28.83333333,2018-01-14,22,28,away,3,PIT,214,462,40,61,45,42,Win,164,83,0,2,2,JAX,87,378,545,0,Win
0.4375,0.571428571,31.16666667,2018-01-14,28,22,home,-3,JAX,462,214,25,78,42,45,Loss,83,164,2,0,0,PIT,87,545,378,2,Loss
0.222222222,0.588235294,26.71666667,2018-01-14,23,24,away,-5,MIN,278,308,97,67,24,29,Loss,80,95,2,2,1,NOS,53,358,403,2,Loss
0.588235294,0.222222222,33.28333333,2018-01-14,24,23,home,5,NOS,308,278,30,71,29,24,Win,95,80,2,2,2,MIN,53,403,358,1,Win
0.4,0.25,35.13333333,2018-01-21,22,22,away,-4,NEP,273,298,98,71,20,24,Loss,101,46,3,3,1,JAX,44,374,344,0,Loss
0.25,0.4,24.86666667,2018-01-21,22,22,home,4,JAX,298,273,10,61,24,20,Win,46,101,3,3,0,NEP,44,344,374,1,Win
0.46153846200000004,0.7142857140000001,25.93333333,2018-01-21,22,27,away,-31,PHI,263,346,19,67,7,38,Loss,70,110,1,1,0,MIN,45,333,456,3,Loss
0.7142857140000001,0.46153846200000004,34.06666667,2018-01-21,27,22,home,31,MIN,346,263,55,64,38,7,Win,110,70,1,1,3,PHI,45,456,333,0,Win
0.625,0.5,34.06666667,2018-02-04,25,29,away,8,NEP,374,500,35,71,41,33,Win,164,113,0,1,1,PHI,74,538,613,1,Win
0.5,0.625,25.93333333,2018-02-04,29,25,home,-8,PHI,500,374,5,72,33,41,Loss,113,164,1,0,1,NEP,74,613,538,1,Loss
