,3d%,3d%_allowed,TOP,date,first_downs,first_downs_allowed,margin,opp,pass_yards,pass_yards_allowed,penalty_yards,plays,points,points_allowed,result,rush_yards,rush_yards_allowed,sacked,sacks,takeaways,team,total_points,total_yards,total_yards_allowed,turnovers
0,0.36363636363636365,0.3333333333333333,30.233333333333334,09/07/2017,26,25,15,New EnglandNE,352,247,139,65,42,27,Win,185,124,3,3,0,Kansas CityKC,69,537,371,1
1,0.3333333333333333,0.36363636363636365,29.766666666666666,09/07/2017,25,26,-15,Kansas CityKC,247,352,55,74,27,42,Loss,124,185,3,3,1,New EnglandNE,69,371,537,0
2,0.4,0.5,26.666666666666668,09/10/2017,24,19,-12,DetroitDet,263,285,55,67,23,35,Loss,45,82,1,1,1,ArizonaAri,58,308,367,4
3,0.5,0.4,33.333333333333336,09/10/2017,19,24,12,ArizonaAri,285,263,100,69,35,23,Win,82,45,1,1,4,DetroitDet,58,367,308,1
4,0.45454545454545453,0.38461538461538464,30.566666666666666,09/10/2017,18,20,6,ChicagoChi,308,176,73,55,23,17,Win,64,125,2,4,0,AtlantaAtl,40,372,301,0
5,0.38461538461538464,0.45454545454545453,29.433333333333334,09/10/2017,20,18,-6,AtlantaAtl,176,308,40,63,17,23,Loss,125,64,4,2,0,ChicagoChi,40,301,372,0
6,0.42857142857142855,0.3076923076923077,34.0,09/10/2017,17,14,20,CincinnatiCin,111,144,85,60,20,0,Win,157,77,1,5,5,BaltimoreBal,20,268,221,1
7,0.3076923076923077,0.42857142857142855,26.0,09/10/2017,14,17,-20,BaltimoreBal,144,111,66,58,0,20,Loss,77,157,5,1,1,CincinnatiCin,20,221,268,5
8,0.2857142857142857,0.47058823529411764,26.933333333333334,09/10/2017,11,23,-9,BuffaloBuf,176,218,62,55,12,21,Loss,38,190,1,2,1,NY JetsNYJ,33,214,408,2
9,0.47058823529411764,0.2857142857142857,33.06666666666667,09/10/2017,23,11,9,NY JetsNYJ,218,176,50,72,21,12,Win,190,38,2,1,2,BuffaloBuf,33,408,214,1
10,0.38461538461538464,0.25,28.833333333333332,09/10/2017,16,20,3,ClevelandCle,255,180,143,54,21,18,Win,35,57,1,7,1,PittsburghPit,39,290,237,1
11,0.25,0.38461538461538464,31.166666666666668,09/10/2017,20,16,-3,PittsburghPit,180,255,61,62,18,21,Loss,57,35,7,1,1,ClevelandCle,39,237,290,1
12,0.25,0.4166666666666667,30.083333333333332,09/10/2017,19,23,22,HoustonHou,125,110,89,60,29,7,Win,155,93,0,10,4,JacksonvilleJax,36,280,203,0
13,0.4166666666666667,0.25,29.916666666666668,09/10/2017,23,19,-22,JacksonvilleJax,110,125,94,69,7,29,Loss,93,155,10,0,0,HoustonHou,36,203,280,4
14,0.4166666666666667,0.5,31.65,09/10/2017,22,21,10,TennesseeTen,250,255,49,63,26,16,Win,109,95,2,1,0,OaklandOak,42,359,350,0
15,0.5,0.4166666666666667,28.35,09/10/2017,21,22,-10,OaklandOak,255,250,49,63,16,26,Loss,95,109,1,2,0,TennesseeTen,42,350,359,0
16,0.5714285714285714,0.2727272727272727,34.266666666666666,09/10/2017,19,16,13,WashingtonWas,298,200,76,65,30,17,Win,58,64,2,4,4,PhiladelphiaPhi,47,356,264,2
17,0.2727272727272727,0.5714285714285714,25.733333333333334,09/10/2017,16,19,-13,PhiladelphiaPhi,200,298,15,61,17,30,Loss,64,58,4,2,2,WashingtonWas,47,264,356,4
18,0.0,0.35714285714285715,25.583333333333332,09/10/2017,10,19,-37,LA RamsLA,150,310,20,49,9,46,Loss,75,63,4,1,1,IndianapolisInd,55,225,373,3
19,0.35714285714285715,0.0,34.416666666666664,09/10/2017,19,10,37,IndianapolisInd,310,150,50,64,46,9,Win,63,75,1,4,3,LA RamsLA,55,373,225,1
20,0.5384615384615384,0.18181818181818182,34.35,09/10/2017,20,13,20,San FranciscoSF,171,166,40,63,23,3,Win,116,51,0,4,2,CarolinaCar,26,287,217,2
21,0.18181818181818182,0.5384615384615384,25.65,09/10/2017,13,20,-20,CarolinaCar,166,171,74,54,3,23,Loss,51,116,4,0,2,San FranciscoSF,26,217,287,2
22,0.25,0.5625,20.783333333333335,09/10/2017,12,26,-8,Green BayGB,135,286,50,48,9,17,Loss,90,84,3,4,1,SeattleSea,26,225,370,1
23,0.5625,0.25,39.21666666666667,09/10/2017,26,12,8,SeattleSea,286,135,70,74,17,9,Win,84,90,4,3,1,Green BayGB,26,370,225,1
24,0.3333333333333333,0.5333333333333333,25.766666666666666,09/10/2017,13,22,-16,DallasDal,198,263,55,53,3,19,Loss,35,129,3,1,0,NY GiantsNYG,22,233,392,1
25,0.5333333333333333,0.3333333333333333,34.233333333333334,09/10/2017,22,13,16,NY GiantsNYG,263,198,50,71,19,3,Win,129,35,1,3,1,DallasDal,22,392,233,0
26,0.36363636363636365,0.6428571428571429,28.733333333333334,09/11/2017,19,23,-10,MinnesotaMin,284,341,52,59,19,29,Loss,60,129,1,1,0,New OrleansNO,48,344,470,0
27,0.6428571428571429,0.36363636363636365,31.266666666666666,09/11/2017,23,19,10,New OrleansNO,341,284,50,63,29,19,Win,129,60,1,1,0,MinnesotaMin,48,470,344,0
28,0.25,0.5333333333333333,25.783333333333335,09/11/2017,17,22,-3,DenverDen,185,181,40,56,21,24,Loss,64,140,1,4,2,LA ChargersLAC,45,249,321,1
29,0.5333333333333333,0.25,34.21666666666667,09/11/2017,22,17,3,LA ChargersLAC,181,185,62,68,24,21,Win,140,64,4,1,1,DenverDen,45,321,249,2
30,0.26666666666666666,0.26666666666666666,32.25,09/14/2017,14,12,4,CincinnatiCin,98,213,61,62,13,9,Win,168,82,3,3,1,HoustonHou,22,266,295,0
31,0.26666666666666666,0.26666666666666666,27.75,09/14/2017,12,14,-4,HoustonHou,213,98,45,62,9,13,Loss,82,168,3,3,0,CincinnatiCin,22,295,266,1
32,0.4,0.4444444444444444,28.816666666666666,09/17/2017,17,18,3,IndianapolisInd,306,190,41,65,3,0,Win,83,76,4,4,1,ArizonaAri,3,389,266,1
33,0.4444444444444444,0.4,33.15,09/17/2017,18,17,-3,ArizonaAri,190,306,70,70,0,3,Loss,76,83,4,4,1,IndianapolisInd,3,266,389,1
34,0.16666666666666666,0.36363636363636365,26.6,09/17/2017,20,24,-14,BaltimoreBal,293,201,65,66,10,24,Loss,93,136,3,2,2,ClevelandCle,34,386,337,5
35,0.36363636363636365,0.16666666666666666,33.4,09/17/2017,24,20,14,ClevelandCle,201,293,45,68,24,10,Win,136,93,2,3,5,BaltimoreBal,34,337,386,2
36,0.3076923076923077,0.4375,21.116666666666667,09/17/2017,10,19,-6,CarolinaCar,107,178,44,51,3,9,Loss,69,77,3,6,0,BuffaloBuf,12,176,255,0
37,0.4375,0.3076923076923077,38.88333333333333,09/17/2017,19,10,6,BuffaloBuf,178,107,40,66,9,3,Win,77,69,6,3,0,CarolinaCar,12,255,176,0
38,0.5,0.5333333333333333,26.816666666666666,09/17/2017,19,22,-22,Tampa BayTB,290,194,59,62,7,29,Loss,20,117,1,2,1,ChicagoChi,36,310,311,4
39,0.5333333333333333,0.5,33.18333333333333,09/17/2017,22,19,22,ChicagoChi,194,290,34,67,29,7,Win,117,20,2,1,4,Tampa BayTB,36,311,310,1
40,0.46153846153846156,0.46153846153846156,30.766666666666666,09/17/2017,21,20,21,JacksonvilleJax,211,211,70,64,37,16,Win,179,99,1,2,3,TennesseeTen,53,390,310,1
41,0.46153846153846156,0.46153846153846156,29.233333333333334,09/17/2017,20,21,-21,TennesseeTen,211,211,99,61,16,37,Loss,99,179,2,1,1,JacksonvilleJax,53,310,390,3
42,0.5333333333333333,0.4166666666666667,30.816666666666666,09/17/2017,27,16,-7,Kansas CityKC,299,232,30,69,20,27,Loss,107,112,6,4,0,PhiladelphiaPhi,47,406,344,2
43,0.4166666666666667,0.5333333333333333,29.183333333333334,09/17/2017,16,27,7,PhiladelphiaPhi,232,299,40,51,27,20,Win,112,107,4,6,2,Kansas CityKC,47,344,406,0
44,0.3333333333333333,0.23076923076923078,25.633333333333333,09/17/2017,14,22,-17,PittsburghPit,146,233,131,60,9,26,Loss,91,102,2,2,0,MinnesotaMin,35,237,335,1
45,0.23076923076923078,0.3333333333333333,34.36666666666667,09/17/2017,22,14,17,MinnesotaMin,233,146,72,69,26,9,Win,102,91,2,2,1,PittsburghPit,35,335,237,0
46,0.5,0.3333333333333333,35.1,09/17/2017,29,20,16,New OrleansNO,436,348,66,72,36,20,Win,119,81,2,1,0,New EnglandNE,56,555,429,0
47,0.3333333333333333,0.5,24.9,09/17/2017,20,29,-16,New EnglandNE,348,436,35,63,20,36,Loss,81,119,1,2,0,New OrleansNO,56,429,555,0
48,0.38461538461538464,0.25,33.36666666666667,09/17/2017,21,24,2,LA ChargersLAC,225,323,23,68,19,17,Win,111,44,2,1,0,MiamiMia,36,336,367,0
49,0.25,0.38461538461538464,26.633333333333333,09/17/2017,24,21,-2,MiamiMia,323,225,56,54,17,19,Loss,44,111,1,2,0,LA ChargersLAC,36,367,336,0
50,0.5833333333333334,0.6666666666666666,28.966666666666665,09/17/2017,17,21,-25,OaklandOak,145,230,47,53,20,45,Loss,126,180,4,0,0,NY JetsNYJ,65,271,410,2
51,0.6666666666666666,0.5833333333333334,31.033333333333335,09/17/2017,21,17,25,NY JetsNYJ,230,145,79,55,45,20,Win,180,126,0,4,2,OaklandOak,65,410,271,0
52,0.21428571428571427,0.6,26.166666666666668,09/17/2017,16,26,-25,DenverDen,228,202,69,66,17,42,Loss,40,178,2,2,2,DallasDal,59,268,380,2
53,0.6,0.21428571428571427,33.833333333333336,09/17/2017,26,16,25,DallasDal,202,228,61,73,42,17,Win,178,40,2,2,2,DenverDen,59,380,268,2
54,0.38461538461538464,0.4166666666666667,36.31666666666667,09/17/2017,21,14,7,LA RamsLA,156,235,25,68,27,20,Win,229,97,2,2,2,WashingtonWas,47,385,332,0
55,0.4166666666666667,0.38461538461538464,23.683333333333334,09/17/2017,14,21,-7,WashingtonWas,235,156,75,49,20,27,Loss,97,229,2,2,0,LA RamsLA,47,332,385,2
56,0.16666666666666666,0.42105263157894735,23.033333333333335,09/17/2017,11,21,-3,SeattleSea,89,181,66,48,9,12,Loss,159,131,2,3,0,San FranciscoSF,21,248,312,1
57,0.42105263157894735,0.16666666666666666,36.96666666666667,09/17/2017,21,11,3,San FranciscoSF,181,89,71,79,12,9,Win,131,159,3,2,1,SeattleSea,21,312,248,0
58,0.4166666666666667,0.45454545454545453,31.383333333333333,09/17/2017,24,19,-11,AtlantaAtl,308,223,70,68,23,34,Loss,59,141,3,3,0,Green BayGB,57,367,364,2
59,0.45454545454545453,0.4166666666666667,28.616666666666667,09/17/2017,19,24,11,Green BayGB,223,308,34,58,34,23,Win,141,59,3,3,2,AtlantaAtl,57,364,367,0
60,0.4666666666666667,0.3333333333333333,32.78333333333333,09/18/2017,12,14,14,NY GiantsNYG,119,208,50,56,24,10,Win,138,62,3,5,1,DetroitDet,34,257,270,1
61,0.3333333333333333,0.4666666666666667,27.216666666666665,09/18/2017,14,12,-14,DetroitDet,208,119,50,55,10,24,Loss,62,138,5,3,1,NY GiantsNYG,34,270,257,1
62,0.6666666666666666,0.5,29.716666666666665,09/21/2017,26,25,2,San FranciscoSF,292,308,52,60,41,39,Win,126,113,0,4,2,LA RamsLA,80,418,421,2
63,0.5,0.6666666666666666,30.283333333333335,09/21/2017,25,26,-2,LA RamsLA,308,292,55,74,39,41,Loss,113,126,4,0,2,San FranciscoSF,80,421,418,2
64,0.2727272727272727,0.25,25.95,09/24/2017,12,24,-37,JacksonvilleJax,52,244,88,54,7,44,Loss,134,166,2,0,0,BaltimoreBal,51,186,410,3
65,0.25,0.2727272727272727,34.05,09/24/2017,24,12,37,BaltimoreBal,244,52,70,68,44,7,Win,166,134,0,2,3,JacksonvilleJax,51,410,186,0
66,0.4444444444444444,0.23076923076923078,32.583333333333336,09/24/2017,26,21,4,DetroitDet,277,253,68,65,30,26,Win,151,71,2,2,0,AtlantaAtl,56,428,324,3
67,0.23076923076923078,0.4444444444444444,27.416666666666668,09/24/2017,21,26,-4,AtlantaAtl,253,277,98,66,26,30,Loss,71,151,2,2,3,DetroitDet,56,324,428,0
68,0.42857142857142855,0.375,29.566666666666666,09/24/2017,21,16,-10,BuffaloBuf,255,197,79,66,16,26,Loss,111,75,3,4,0,DenverDen,42,366,272,2
69,0.375,0.42857142857142855,30.433333333333334,09/24/2017,16,21,10,DenverDen,197,255,69,63,26,16,Win,75,111,4,3,2,BuffaloBuf,42,272,366,0
70,0.5,0.5,31.15,09/24/2017,21,18,21,CarolinaCar,213,156,10,57,34,13,Win,149,132,1,4,3,New OrleansNO,47,362,288,0
71,0.5,0.5,28.85,09/24/2017,18,21,-21,New OrleansNO,156,213,5,59,13,34,Loss,132,149,4,1,0,CarolinaCar,47,288,362,3
72,0.36363636363636365,0.3333333333333333,27.566666666666666,09/24/2017,19,18,-6,ChicagoChi,212,84,40,59,0,6,Loss,70,222,3,2,2,PittsburghPit,6,282,306,2
73,0.3333333333333333,0.36363636363636365,33.983333333333334,09/24/2017,18,19,6,PittsburghPit,84,212,73,62,6,0,Win,222,70,2,3,2,ChicagoChi,6,306,282,2
74,0.38461538461538464,0.47058823529411764,26.55,09/24/2017,25,16,-3,IndianapolisInd,235,243,113,69,28,31,Loss,111,92,1,3,1,ClevelandCle,59,346,335,3
75,0.47058823529411764,0.38461538461538464,33.45,09/24/2017,16,25,3,ClevelandCle,243,235,99,63,31,28,Win,92,111,3,1,3,IndianapolisInd,59,335,346,1
76,0.42857142857142855,0.46153846153846156,33.63333333333333,09/24/2017,23,21,-3,New EnglandNE,292,337,60,67,33,36,Loss,125,59,2,5,1,HoustonHou,69,417,396,2
77,0.46153846153846156,0.42857142857142855,26.366666666666667,09/24/2017,21,23,3,HoustonHou,337,292,69,60,36,33,Win,59,125,5,2,2,New EnglandNE,69,396,417,1
78,0.08333333333333333,0.3076923076923077,23.866666666666667,09/24/2017,16,16,-14,NY JetsNYJ,195,233,51,63,6,20,Loss,30,103,3,2,1,MiamiMia,26,225,336,2
79,0.3076923076923077,0.08333333333333333,36.13333333333333,09/24/2017,16,16,14,MiamiMia,233,195,94,59,20,6,Win,103,30,2,3,2,NY JetsNYJ,26,336,225,1
80,0.16666666666666666,0.5384615384615384,22.233333333333334,09/24/2017,20,25,-17,MinnesotaMin,316,369,37,51,17,34,Loss,26,125,2,0,0,Tampa BayTB,51,342,494,3
81,0.5384615384615384,0.16666666666666666,37.766666666666666,09/24/2017,25,20,17,Tampa BayTB,369,316,53,70,34,17,Win,125,26,0,2,3,MinnesotaMin,51,494,342,0
82,0.3,0.35714285714285715,22.466666666666665,09/24/2017,21,24,-3,PhiladelphiaPhi,366,161,137,64,24,27,Loss,49,193,0,3,1,NY GiantsNYG,51,415,354,2
83,0.35714285714285715,0.3,37.53333333333333,09/24/2017,24,21,3,NY GiantsNYG,161,366,103,73,27,24,Win,193,49,3,0,2,PhiladelphiaPhi,51,354,415,1
84,0.2857142857142857,0.2857142857142857,27.316666666666666,09/24/2017,24,21,-6,TennesseeTen,364,225,98,72,27,33,Loss,69,195,1,0,0,SeattleSea,60,433,420,0
85,0.2857142857142857,0.2857142857142857,32.68333333333333,09/24/2017,21,24,6,SeattleSea,225,364,45,67,33,27,Win,195,69,0,1,0,TennesseeTen,60,420,433,0
86,0.3333333333333333,0.4666666666666667,34.28333333333333,09/24/2017,21,22,-3,Green BayGB,191,280,68,60,0,3,Loss,110,64,3,6,1,CincinnatiCin,3,301,344,1
87,0.4666666666666667,0.3333333333333333,29.35,09/24/2017,22,21,3,CincinnatiCin,280,191,33,65,3,0,Win,64,110,6,3,1,Green BayGB,3,344,301,1
88,0.3333333333333333,0.38461538461538464,30.433333333333334,09/24/2017,16,24,14,LA ChargersLAC,122,226,122,51,24,10,Win,189,104,5,2,3,Kansas CityKC,34,311,330,0
89,0.38461538461538464,0.3333333333333333,29.566666666666666,09/24/2017,24,16,-14,Kansas CityKC,226,122,61,68,10,24,Loss,104,189,2,5,0,LA ChargersLAC,34,330,311,3
90,0.0,0.4666666666666667,21.9,09/24/2017,7,18,-17,WashingtonWas,96,356,35,48,10,27,Loss,32,116,4,1,2,OaklandOak,37,128,472,3
91,0.4666666666666667,0.0,38.1,09/24/2017,18,7,17,OaklandOak,356,96,77,65,27,10,Win,116,32,1,4,3,WashingtonWas,37,472,128,2
92,0.2222222222222222,0.4444444444444444,23.75,09/25/2017,15,22,11,ArizonaAri,174,283,76,45,28,17,Win,99,49,1,6,0,DallasDal,45,273,332,0
93,0.4444444444444444,0.2222222222222222,36.25,09/25/2017,22,15,-11,DallasDal,283,174,50,75,17,28,Loss,49,99,6,1,0,ArizonaAri,45,332,273,0
94,0.4166666666666667,0.5,31.85,09/28/2017,20,17,-21,Green BayGB,205,169,62,64,14,35,Loss,103,91,1,2,0,ChicagoChi,49,308,260,4
95,0.5,0.4166666666666667,28.15,09/28/2017,17,20,21,ChicagoChi,169,205,55,53,35,14,Win,91,103,2,1,4,Green BayGB,49,260,308,0
96,0.46153846153846156,0.125,34.46666666666667,10/01/2017,22,11,20,MiamiMia,261,128,71,70,20,0,Win,86,58,1,4,1,New OrleansNO,20,347,186,0
97,0.125,0.46153846153846156,25.533333333333335,10/01/2017,11,22,-20,New OrleansNO,128,261,90,47,0,20,Loss,58,86,4,1,0,MiamiMia,20,186,347,1
98,0.46153846153846156,0.38461538461538464,28.75,10/01/2017,15,25,6,AtlantaAtl,164,242,55,59,23,17,Win,117,147,3,1,3,BuffaloBuf,40,281,389,0
99,0.38461538461538464,0.46153846153846156,31.25,10/01/2017,25,15,-6,BuffaloBuf,242,164,45,72,17,23,Loss,147,117,1,3,0,AtlantaAtl,40,389,281,3
100,0.4666666666666667,0.38461538461538464,35.483333333333334,10/01/2017,22,18,17,BaltimoreBal,208,206,60,73,26,9,Win,173,82,1,4,3,PittsburghPit,35,381,288,1
101,0.38461538461538464,0.4666666666666667,24.516666666666666,10/01/2017,18,22,-17,PittsburghPit,206,208,55,68,9,26,Loss,82,173,4,1,1,BaltimoreBal,35,288,381,3
102,0.6666666666666666,0.5,28.883333333333333,10/01/2017,28,24,3,New EnglandNE,304,293,33,60,33,30,Win,140,80,2,3,0,CarolinaCar,63,444,373,2
103,0.5,0.6666666666666666,31.116666666666667,10/01/2017,24,28,-3,CarolinaCar,293,304,55,67,30,33,Loss,80,140,3,2,2,New EnglandNE,63,373,444,0
104,0.5454545454545454,0.3125,35.03333333333333,10/01/2017,25,16,24,ClevelandCle,264,170,66,63,31,7,Win,86,45,3,2,1,CincinnatiCin,38,350,215,1
105,0.3125,0.5454545454545454,24.966666666666665,10/01/2017,16,25,-24,CincinnatiCin,170,264,28,61,7,31,Loss,45,86,2,3,1,ClevelandCle,38,215,350,1
106,0.38461538461538464,0.5,30.533333333333335,10/01/2017,24,22,5,DallasDal,244,251,41,68,35,30,Win,168,189,1,2,2,LA RamsLA,65,412,440,0
107,0.5,0.38461538461538464,29.466666666666665,10/01/2017,22,24,-5,LA RamsLA,251,244,45,65,30,35,Loss,189,168,2,1,0,DallasDal,65,440,412,2
108,0.23076923076923078,0.3,36.45,10/01/2017,19,15,7,MinnesotaMin,154,197,60,68,14,7,Win,97,87,6,2,3,DetroitDet,21,251,284,0
109,0.3,0.23076923076923078,23.55,10/01/2017,15,19,-7,DetroitDet,197,154,10,54,7,14,Loss,87,97,2,6,0,MinnesotaMin,21,284,251,3
110,0.25,0.5,20.316666666666666,10/01/2017,9,33,-43,HoustonHou,109,272,88,41,14,57,Loss,86,173,2,2,1,TennesseeTen,71,195,445,5
111,0.5,0.25,39.68333333333333,10/01/2017,33,9,43,TennesseeTen,272,109,20,78,57,14,Win,173,86,2,2,5,HoustonHou,71,445,195,1
112,0.26666666666666666,0.35294117647058826,35.13333333333333,10/01/2017,20,18,-3,NY JetsNYJ,136,215,47,75,0,3,Loss,175,256,1,5,2,JacksonvilleJax,3,311,471,1
113,0.35294117647058826,0.26666666666666666,34.4,10/01/2017,18,20,3,JacksonvilleJax,215,136,70,69,3,0,Win,256,175,5,1,1,NY JetsNYJ,3,471,311,2
114,0.2631578947368421,0.3125,33.21666666666667,10/01/2017,20,25,-3,ArizonaAri,210,317,113,79,3,6,Loss,95,51,3,6,1,San FranciscoSF,9,305,368,1
115,0.3125,0.2631578947368421,36.25,10/01/2017,25,20,3,San FranciscoSF,317,210,80,79,6,3,Win,51,95,6,3,1,ArizonaAri,9,368,305,1
116,0.5625,0.5,39.3,10/01/2017,26,18,2,LA ChargersLAC,240,342,58,74,26,24,Win,214,58,1,2,1,PhiladelphiaPhi,50,454,400,0
117,0.5,0.5625,20.7,10/01/2017,18,26,-2,PhiladelphiaPhi,342,240,39,53,24,26,Loss,58,214,2,1,0,LA ChargersLAC,50,400,454,1
118,0.47058823529411764,0.2727272727272727,34.21666666666667,10/01/2017,24,20,-2,Tampa BayTB,288,323,0,77,23,25,Loss,91,111,0,1,0,NY GiantsNYG,48,379,434,0
119,0.2727272727272727,0.47058823529411764,25.783333333333335,10/01/2017,20,24,2,NY GiantsNYG,323,288,19,62,25,23,Win,111,91,1,0,0,Tampa BayTB,48,434,379,0
120,0.16666666666666666,0.3125,27.05,10/01/2017,11,16,-6,DenverDen,230,155,75,53,10,16,Loss,24,143,3,4,0,OaklandOak,26,254,298,1
121,0.3125,0.16666666666666666,32.95,10/01/2017,16,11,6,OaklandOak,155,230,40,62,16,10,Win,143,24,4,3,1,DenverDen,26,298,254,0
122,0.42857142857142855,0.6666666666666666,27.8,10/01/2017,16,22,-28,SeattleSea,139,283,31,57,18,46,Loss,98,194,3,3,2,IndianapolisInd,64,237,477,2
123,0.6666666666666666,0.42857142857142855,32.2,10/01/2017,22,16,28,IndianapolisInd,283,139,45,62,46,18,Win,194,98,3,3,2,SeattleSea,64,477,237,2
124,0.36363636363636365,0.6153846153846154,22.85,10/02/2017,15,29,-9,Kansas CityKC,220,261,44,50,20,29,Loss,111,168,0,4,0,WashingtonWas,49,331,429,1
125,0.6153846153846154,0.36363636363636365,37.15,10/02/2017,29,15,9,WashingtonWas,261,220,15,72,29,20,Win,168,111,4,0,1,Kansas CityKC,49,429,331,0
126,0.3333333333333333,0.3076923076923077,30.833333333333332,10/05/2017,23,26,5,Tampa BayTB,289,319,108,66,19,14,Win,113,90,3,2,0,New EnglandNE,33,402,409,2
127,0.3076923076923077,0.3333333333333333,29.166666666666668,10/05/2017,26,23,-5,New EnglandNE,319,289,70,68,14,19,Loss,90,113,2,3,2,Tampa BayTB,33,409,402,0
128,0.2857142857142857,0.6428571428571429,24.216666666666665,10/08/2017,16,19,-27,PhiladelphiaPhi,276,297,61,60,7,34,Loss,31,122,2,1,1,ArizonaAri,41,307,419,1
129,0.6428571428571429,0.2857142857142857,35.78333333333333,10/08/2017,19,16,27,ArizonaAri,297,276,60,64,34,7,Win,122,31,1,2,1,PhiladelphiaPhi,41,419,307,1
130,0.3333333333333333,0.4,29.983333333333334,10/08/2017,17,18,-4,CincinnatiCin,139,323,71,67,16,20,Loss,82,65,6,1,3,BuffaloBuf,36,221,388,1
131,0.4,0.3333333333333333,30.016666666666666,10/08/2017,18,17,4,BuffaloBuf,323,139,71,64,20,16,Win,65,82,1,6,1,CincinnatiCin,36,388,221,3
132,0.4375,0.38461538461538464,35.38333333333333,10/08/2017,16,19,3,DetroitDet,334,192,100,64,27,24,Win,28,50,3,6,1,CarolinaCar,51,362,242,0
133,0.38461538461538464,0.4375,24.616666666666667,10/08/2017,19,16,-3,CarolinaCar,192,334,10,56,24,27,Loss,50,28,6,3,0,DetroitDet,51,242,362,1
134,0.3333333333333333,0.42857142857142855,25.566666666666666,10/08/2017,14,22,3,ClevelandCle,178,279,80,51,17,14,Win,34,140,3,1,3,NY JetsNYJ,31,212,419,1
135,0.42857142857142855,0.3333333333333333,34.43333333333333,10/08/2017,22,14,-3,NY JetsNYJ,279,178,60,70,14,17,Loss,140,34,1,3,1,ClevelandCle,31,419,212,3
136,0.2857142857142857,0.5,31.083333333333332,10/08/2017,23,25,-3,IndianapolisInd,336,288,77,70,0,3,Loss,66,159,2,4,1,San FranciscoSF,3,402,447,0
137,0.5,0.2857142857142857,37.28333333333333,10/08/2017,25,23,3,San FranciscoSF,288,336,62,73,3,0,Win,159,66,4,2,0,IndianapolisInd,3,447,402,1
138,0.5,0.4666666666666667,28.866666666666667,10/08/2017,15,21,21,PittsburghPit,82,301,19,53,30,9,Win,231,70,2,2,5,JacksonvilleJax,39,313,371,1
139,0.4666666666666667,0.5,31.133333333333333,10/08/2017,21,15,-21,JacksonvilleJax,301,82,37,77,9,30,Loss,70,231,2,2,1,PittsburghPit,39,371,313,5
140,0.4444444444444444,0.3333333333333333,31.75,10/08/2017,21,18,5,NY GiantsNYG,258,183,87,73,27,22,Win,124,152,0,5,2,LA ChargersLAC,49,382,335,1
141,0.3333333333333333,0.4444444444444444,28.25,10/08/2017,18,21,-5,LA ChargersLAC,183,258,67,66,22,27,Loss,152,124,5,0,1,NY GiantsNYG,49,335,382,2
142,0.15384615384615385,0.3333333333333333,30.25,10/08/2017,14,12,-6,MiamiMia,119,78,77,58,10,16,Loss,69,100,6,1,2,TennesseeTen,26,188,178,2
143,0.3333333333333333,0.15384615384615385,29.75,10/08/2017,12,14,6,TennesseeTen,78,119,23,59,16,10,Win,100,69,1,6,2,MiamiMia,26,178,188,2
144,0.5,0.5,33.71666666666667,10/08/2017,19,15,13,OaklandOak,222,137,5,65,30,17,Win,143,108,0,3,1,BaltimoreBal,47,365,245,0
145,0.5,0.5,26.283333333333335,10/08/2017,15,19,-13,BaltimoreBal,137,222,24,54,17,30,Loss,108,143,3,0,0,OaklandOak,47,245,365,1
146,0.47058823529411764,0.5333333333333333,31.266666666666666,10/08/2017,15,21,6,LA RamsLA,179,275,40,66,16,10,Win,62,100,3,2,5,SeattleSea,26,241,375,2
147,0.5333333333333333,0.47058823529411764,28.733333333333334,10/08/2017,21,15,-6,SeattleSea,275,179,45,71,10,16,Loss,100,62,2,3,2,LA RamsLA,26,375,241,5
148,0.42857142857142855,0.5833333333333334,24.9,10/08/2017,25,26,4,DallasDal,182,245,38,58,35,31,Win,160,163,4,1,3,Green BayGB,66,342,408,1
149,0.5833333333333334,0.42857142857142855,35.1,10/08/2017,26,25,-4,Green BayGB,245,182,70,72,31,35,Loss,163,160,1,4,1,DallasDal,66,408,342,3
150,0.5625,0.3,38.28333333333333,10/08/2017,29,20,8,HoustonHou,323,248,64,73,42,34,Win,127,144,1,3,1,Kansas CityKC,76,450,392,0
151,0.3,0.5625,21.716666666666665,10/08/2017,20,29,-8,Kansas CityKC,248,323,59,57,34,42,Loss,144,127,3,1,0,HoustonHou,76,392,450,1
152,0.4,0.25,31.4,10/09/2017,17,16,3,ChicagoChi,141,159,69,67,20,17,Win,159,115,4,1,2,MinnesotaMin,37,300,274,0
153,0.25,0.4,28.6,10/09/2017,16,17,-3,MinnesotaMin,159,141,55,56,17,20,Loss,115,159,1,4,0,ChicagoChi,37,274,300,2
154,0.35714285714285715,0.25,28.566666666666666,10/12/2017,15,23,5,CarolinaCar,209,225,126,60,28,23,Win,101,80,3,2,3,PhiladelphiaPhi,51,310,305,1
155,0.25,0.35714285714285715,31.433333333333334,10/12/2017,23,15,-5,PhiladelphiaPhi,225,209,1,79,23,28,Loss,80,101,2,3,1,CarolinaCar,51,305,310,3
156,0.4166666666666667,0.5454545454545454,34.4,10/15/2017,20,19,3,AtlantaAtl,151,239,42,64,20,17,Win,138,100,0,2,1,MiamiMia,37,289,339,1
157,0.5454545454545454,0.4166666666666667,25.6,10/15/2017,19,20,-3,MiamiMia,239,151,73,56,17,20,Loss,100,138,2,0,1,AtlantaAtl,37,339,289,1
158,0.29411764705882354,0.16666666666666666,36.75,10/15/2017,18,16,3,BaltimoreBal,111,166,44,75,3,0,Win,231,125,4,3,3,ChicagoChi,3,342,291,2
159,0.16666666666666666,0.29411764705882354,31.15,10/15/2017,16,18,-3,ChicagoChi,166,111,69,70,0,3,Loss,125,231,3,4,2,BaltimoreBal,3,291,342,3
160,0.21428571428571427,0.38461538461538464,30.9,10/15/2017,16,18,-16,HoustonHou,113,217,72,63,17,33,Loss,134,123,4,1,1,ClevelandCle,50,247,340,3
161,0.38461538461538464,0.21428571428571427,29.1,10/15/2017,18,16,16,ClevelandCle,217,113,44,63,33,17,Win,123,134,1,4,3,HoustonHou,50,340,247,1
162,0.5,0.16666666666666666,27.816666666666666,10/15/2017,18,19,-14,New OrleansNO,281,186,46,76,38,52,Loss,66,193,5,0,3,DetroitDet,90,347,379,5
163,0.16666666666666666,0.5,32.18333333333333,10/15/2017,19,18,14,DetroitDet,186,281,118,67,52,38,Win,193,66,0,5,5,New OrleansNO,90,379,347,3
164,0.23529411764705882,0.3333333333333333,27.85,10/15/2017,14,24,-13,MinnesotaMin,155,239,92,65,10,23,Loss,72,112,4,0,2,Green BayGB,33,227,351,3
165,0.3333333333333333,0.23529411764705882,32.15,10/15/2017,24,14,13,Green BayGB,239,155,65,70,23,10,Win,112,72,0,4,3,MinnesotaMin,33,351,227,2
166,0.5384615384615384,0.5294117647058824,26.333333333333332,10/15/2017,23,23,7,NY JetsNYJ,257,334,45,63,24,17,Win,118,74,0,4,3,New EnglandNE,41,375,408,2
167,0.5294117647058824,0.5384615384615384,33.666666666666664,10/15/2017,23,23,-7,New EnglandNE,334,257,69,75,17,24,Loss,74,118,4,0,2,NY JetsNYJ,41,408,375,3
168,0.35294117647058826,0.5,23.133333333333333,10/15/2017,21,25,-2,WashingtonWas,250,325,40,70,24,26,Loss,85,94,3,1,2,San FranciscoSF,50,335,419,1
169,0.5,0.35294117647058826,36.86666666666667,10/15/2017,25,21,2,San FranciscoSF,325,250,43,71,26,24,Win,94,85,1,3,1,WashingtonWas,50,419,335,2
170,0.5,0.4444444444444444,27.616666666666667,10/15/2017,21,23,-5,ArizonaAri,344,272,49,64,33,38,Loss,70,160,2,2,2,Tampa BayTB,71,414,432,2
171,0.4444444444444444,0.5,32.38333333333333,10/15/2017,23,21,5,Tampa BayTB,272,344,61,59,38,33,Win,160,70,2,2,2,ArizonaAri,71,432,414,2
172,0.3076923076923077,0.26666666666666666,28.016666666666666,10/15/2017,12,19,10,JacksonvilleJax,107,220,70,56,27,17,Win,142,169,3,5,1,LA RamsLA,44,249,389,1
173,0.26666666666666666,0.3076923076923077,31.983333333333334,10/15/2017,19,12,-10,LA RamsLA,220,107,40,66,17,27,Loss,169,142,5,3,1,JacksonvilleJax,44,389,249,1
174,0.36363636363636365,0.2727272727272727,36.65,10/15/2017,23,12,6,Kansas CityKC,245,223,57,63,19,13,Win,194,28,1,3,0,PittsburghPit,32,439,251,1
175,0.2727272727272727,0.36363636363636365,23.35,10/15/2017,12,23,-6,PittsburghPit,223,245,48,52,13,19,Loss,28,194,3,1,1,Kansas CityKC,32,251,439,0
176,0.42857142857142855,0.5,32.05,10/15/2017,20,15,1,OaklandOak,263,165,32,65,17,16,Win,80,109,1,1,2,LA ChargersLAC,33,343,274,1
177,0.5,0.42857142857142855,27.95,10/15/2017,15,20,-1,LA ChargersLAC,165,263,40,53,16,17,Loss,109,80,1,1,1,OaklandOak,33,274,343,2
178,0.2857142857142857,0.29411764705882354,30.6,10/15/2017,12,20,13,DenverDen,118,366,77,54,23,10,Win,148,46,3,4,3,NY GiantsNYG,33,266,412,0
179,0.29411764705882354,0.2857142857142857,29.4,10/15/2017,20,12,-13,NY GiantsNYG,366,118,46,75,10,23,Loss,46,148,4,3,0,DenverDen,33,412,266,3
180,0.2222222222222222,0.46153846153846156,24.116666666666667,10/16/2017,18,25,-14,TennesseeTen,212,305,51,57,22,36,Loss,85,168,1,1,1,IndianapolisInd,58,297,473,1
181,0.46153846153846156,0.2222222222222222,35.88333333333333,10/16/2017,25,18,14,IndianapolisInd,305,212,45,67,36,22,Win,168,85,1,1,1,TennesseeTen,58,473,297,1
182,0.5333333333333333,0.46153846153846156,30.6,10/19/2017,19,32,-1,OaklandOak,331,417,108,60,30,31,Loss,94,88,1,0,0,Kansas CityKC,61,425,505,0
183,0.46153846153846156,0.5333333333333333,29.4,10/19/2017,32,19,1,Kansas CityKC,417,331,97,73,31,30,Win,88,94,0,1,0,OaklandOak,61,505,425,0
184,0.25,0.6842105263157895,20.983333333333334,10/22/2017,10,28,-33,LA RamsLA,171,228,65,47,0,33,Loss,25,197,3,1,1,ArizonaAri,33,196,425,2
185,0.6842105263157895,0.25,39.016666666666666,10/22/2017,28,10,33,ArizonaAri,228,171,45,78,33,0,Win,197,25,1,3,2,LA RamsLA,33,425,196,1
186,0.375,0.4666666666666667,27.983333333333334,10/22/2017,16,17,-8,MinnesotaMin,144,188,15,64,16,24,Loss,64,169,5,0,1,BaltimoreBal,40,208,357,0
187,0.4666666666666667,0.375,32.016666666666666,10/22/2017,17,16,8,BaltimoreBal,188,144,47,64,24,16,Win,169,64,0,5,0,MinnesotaMin,40,357,208,1
188,0.5454545454545454,0.625,33.166666666666664,10/22/2017,27,23,-3,BuffaloBuf,378,261,55,70,27,30,Loss,69,173,1,1,1,Tampa BayTB,57,447,434,3
189,0.625,0.5454545454545454,26.833333333333332,10/22/2017,23,27,3,Tampa BayTB,261,378,35,67,30,27,Win,173,69,1,1,3,BuffaloBuf,57,434,447,1
190,0.4,0.18181818181818182,38.583333333333336,10/22/2017,20,5,-14,ChicagoChi,185,85,35,69,3,17,Loss,108,68,5,4,0,CarolinaCar,20,293,153,3
191,0.18181818181818182,0.4,21.416666666666668,10/22/2017,5,20,14,CarolinaCar,85,185,40,37,17,3,Win,68,108,4,5,3,ChicagoChi,20,153,293,0
192,0.29411764705882354,0.23076923076923078,35.38333333333333,10/22/2017,16,19,3,ClevelandCle,189,218,35,68,3,0,Win,80,66,2,2,3,TennesseeTen,3,269,284,1
193,0.23076923076923078,0.29411764705882354,32.7,10/22/2017,19,16,-3,TennesseeTen,218,189,81,67,0,3,Loss,66,80,2,2,1,ClevelandCle,3,284,269,3
194,0.5333333333333333,0.36363636363636365,36.93333333333333,10/22/2017,25,16,9,Green BayGB,324,79,80,75,26,17,Win,161,181,1,1,1,New OrleansNO,43,485,260,2
195,0.36363636363636365,0.5333333333333333,23.066666666666666,10/22/2017,16,25,-9,New OrleansNO,79,324,54,50,17,26,Loss,181,161,1,1,2,Green BayGB,43,260,485,1
196,0.5714285714285714,0.3333333333333333,32.78333333333333,10/22/2017,23,15,27,IndianapolisInd,330,136,34,65,27,0,Win,188,96,1,10,0,JacksonvilleJax,27,518,232,2
197,0.3333333333333333,0.5714285714285714,27.216666666666665,10/22/2017,15,23,-27,JacksonvilleJax,136,330,55,67,0,27,Loss,96,188,10,1,2,IndianapolisInd,27,232,518,0
198,0.36363636363636365,0.38461538461538464,28.033333333333335,10/22/2017,16,25,-3,MiamiMia,180,304,124,52,28,31,Loss,92,53,3,3,2,NY JetsNYJ,59,272,357,2
199,0.38461538461538464,0.36363636363636365,31.966666666666665,10/22/2017,25,16,3,NY JetsNYJ,304,180,76,65,31,28,Win,53,92,3,3,2,MiamiMia,59,357,272,2
200,0.6363636363636364,0.46153846153846156,32.833333333333336,10/22/2017,27,23,30,San FranciscoSF,236,187,36,70,40,10,Win,265,103,0,5,3,DallasDal,50,501,290,0
201,0.46153846153846156,0.6363636363636364,27.166666666666668,10/22/2017,23,27,-30,DallasDal,187,236,22,65,10,40,Loss,103,265,5,0,0,San FranciscoSF,50,290,501,3
202,0.2727272727272727,0.18181818181818182,24.75,10/22/2017,11,21,-15,PittsburghPit,108,268,54,51,14,29,Loss,71,152,4,0,0,CincinnatiCin,43,179,420,2
203,0.18181818181818182,0.2727272727272727,35.25,10/22/2017,21,11,15,CincinnatiCin,268,108,5,68,29,14,Win,152,71,0,4,2,PittsburghPit,43,420,179,0
204,0.21428571428571427,0.25,31.066666666666666,10/22/2017,12,14,-21,LA ChargersLAC,182,162,68,59,0,21,Loss,69,80,5,3,0,DenverDen,21,251,242,3
205,0.25,0.21428571428571427,28.933333333333334,10/22/2017,14,12,21,DenverDen,162,182,81,55,21,0,Win,80,69,3,5,3,LA ChargersLAC,21,242,251,0
206,0.46153846153846156,0.16666666666666666,35.43333333333333,10/22/2017,26,14,17,NY GiantsNYG,321,131,110,71,24,7,Win,104,46,1,1,1,SeattleSea,31,425,177,1
207,0.16666666666666666,0.46153846153846156,24.566666666666666,10/22/2017,14,26,-17,SeattleSea,131,321,28,57,7,24,Loss,46,104,1,1,1,NY GiantsNYG,31,177,425,1
208,0.2222222222222222,0.5384615384615384,25.916666666666668,10/22/2017,21,25,-16,New EnglandNE,223,241,40,56,7,23,Loss,120,162,1,2,0,AtlantaAtl,30,343,403,0
209,0.5384615384615384,0.2222222222222222,34.083333333333336,10/22/2017,25,21,16,AtlantaAtl,241,223,65,67,23,7,Win,162,120,2,1,0,New EnglandNE,30,403,343,0
210,0.3333333333333333,0.5,30.25,10/23/2017,19,23,-10,PhiladelphiaPhi,269,244,55,62,24,34,Loss,75,127,4,3,1,WashingtonWas,58,344,371,1
211,0.5,0.3333333333333333,29.75,10/23/2017,23,19,10,WashingtonWas,244,269,55,61,34,24,Win,127,75,3,4,1,PhiladelphiaPhi,58,371,344,1
212,0.26666666666666666,0.23076923076923078,28.766666666666666,10/26/2017,13,19,-40,BaltimoreBal,151,121,43,66,0,40,Loss,45,174,3,0,0,MiamiMia,40,196,295,2
213,0.23076923076923078,0.26666666666666666,31.233333333333334,10/26/2017,19,13,40,MiamiMia,121,151,40,62,40,0,Win,174,45,0,3,2,BaltimoreBal,40,295,196,0
214,0.375,0.3076923076923077,37.86666666666667,10/29/2017,26,16,17,ClevelandCle,287,161,58,78,33,16,Win,88,115,1,3,2,MinnesotaMin,49,375,276,1
215,0.3076923076923077,0.375,22.133333333333333,10/29/2017,16,26,-17,MinnesotaMin,161,287,74,59,16,33,Loss,115,88,3,1,1,ClevelandCle,49,276,375,2
216,0.35714285714285715,0.3333333333333333,28.316666666666666,10/29/2017,18,15,5,NY JetsNYJ,246,236,68,62,25,20,Win,140,43,1,3,1,AtlantaAtl,45,386,279,2
217,0.3333333333333333,0.35714285714285715,31.683333333333334,10/29/2017,15,18,-5,AtlantaAtl,236,246,50,58,20,25,Loss,43,140,3,1,2,NY JetsNYJ,45,279,386,1
218,0.3,0.4,24.383333333333333,10/29/2017,23,17,-20,BuffaloBuf,313,165,50,63,14,34,Loss,54,166,0,0,0,OaklandOak,48,367,331,4
219,0.4,0.3,35.61666666666667,10/29/2017,17,23,20,OaklandOak,165,313,95,64,34,14,Win,166,54,0,0,4,BuffaloBuf,48,331,367,0
220,0.47058823529411764,0.16666666666666666,32.18333333333333,10/29/2017,14,16,14,Tampa BayTB,154,194,51,63,17,3,Win,100,85,0,3,3,CarolinaCar,20,254,279,1
221,0.16666666666666666,0.47058823529411764,27.816666666666666,10/29/2017,16,14,-14,CarolinaCar,194,154,55,63,3,17,Loss,85,100,3,0,1,Tampa BayTB,20,279,254,3
222,0.47058823529411764,0.2222222222222222,28.616666666666667,10/29/2017,17,19,-8,New OrleansNO,150,286,31,65,12,20,Loss,157,101,2,2,2,ChicagoChi,32,307,387,1
223,0.2222222222222222,0.47058823529411764,31.383333333333333,10/29/2017,19,17,8,ChicagoChi,286,150,51,60,20,12,Win,101,157,2,2,1,New OrleansNO,32,387,307,2
224,0.5,0.36363636363636365,33.21666666666667,10/29/2017,19,17,-1,CincinnatiCin,216,218,45,71,23,24,Loss,115,58,4,3,2,IndianapolisInd,47,331,276,1
225,0.36363636363636365,0.5,26.783333333333335,10/29/2017,17,19,1,IndianapolisInd,218,216,54,53,24,23,Win,58,115,3,4,1,CincinnatiCin,47,276,331,2
226,0.3,0.47368421052631576,23.016666666666666,10/29/2017,16,27,-8,New EnglandNE,192,317,77,52,13,21,Loss,157,97,1,3,0,LA ChargersLAC,34,349,414,1
227,0.47368421052631576,0.3,36.983333333333334,10/29/2017,27,16,8,LA ChargersLAC,317,192,80,82,21,13,Win,97,157,3,1,1,New EnglandNE,34,414,349,0
228,0.2,0.2857142857142857,27.05,10/29/2017,14,19,-23,PhiladelphiaPhi,144,192,69,64,10,33,Loss,94,112,4,3,1,San FranciscoSF,43,238,304,2
229,0.2857142857142857,0.2,32.95,10/29/2017,19,14,23,San FranciscoSF,192,144,35,66,33,10,Win,112,94,3,4,2,PhiladelphiaPhi,43,304,238,1
230,0.2,0.4166666666666667,30.366666666666667,10/29/2017,25,21,-3,SeattleSea,367,446,93,69,38,41,Loss,142,33,5,2,1,HoustonHou,79,509,479,3
231,0.4166666666666667,0.2,29.633333333333333,10/29/2017,21,25,3,HoustonHou,446,367,120,64,41,38,Win,33,142,2,5,3,SeattleSea,79,479,509,1
232,0.35714285714285715,0.3076923076923077,33.31666666666667,10/29/2017,18,16,14,WashingtonWas,138,236,89,63,33,19,Win,169,49,2,4,3,DallasDal,52,307,285,1
233,0.3076923076923077,0.35714285714285715,26.683333333333334,10/29/2017,16,18,-14,DallasDal,236,138,32,58,19,33,Loss,49,169,4,2,1,WashingtonWas,52,285,307,3
234,0.5,0.16666666666666666,28.383333333333333,10/29/2017,17,21,5,DetroitDet,317,411,37,60,20,15,Win,75,71,0,2,1,PittsburghPit,35,392,482,2
235,0.16666666666666666,0.5,31.616666666666667,10/29/2017,21,17,-5,PittsburghPit,411,317,57,69,15,20,Loss,71,75,2,0,2,DetroitDet,35,482,392,1
236,0.38461538461538464,0.16666666666666666,31.383333333333333,10/30/2017,23,16,-10,Kansas CityKC,187,197,53,70,19,29,Loss,177,79,3,1,2,DenverDen,48,364,276,5
237,0.16666666666666666,0.38461538461538464,28.616666666666667,10/30/2017,16,23,10,DenverDen,197,187,69,59,29,19,Win,79,177,1,3,5,Kansas CityKC,48,276,364,2
238,0.375,0.42857142857142855,26.5,11/02/2017,21,21,-13,NY JetsNYJ,244,137,99,69,21,34,Loss,63,194,7,1,0,BuffaloBuf,55,307,331,3
239,0.42857142857142855,0.375,33.5,11/02/2017,21,21,13,BuffaloBuf,137,244,66,62,34,21,Win,194,63,1,7,3,NY JetsNYJ,55,331,307,0
240,0.3333333333333333,0.3076923076923077,27.133333333333333,11/05/2017,17,20,-3,CarolinaCar,302,129,70,58,17,20,Loss,53,201,2,1,2,AtlantaAtl,37,355,330,1
241,0.3076923076923077,0.3333333333333333,32.86666666666667,11/05/2017,20,17,3,AtlantaAtl,129,302,29,63,20,17,Win,201,53,1,2,1,CarolinaCar,37,330,355,2
242,0.375,0.2727272727272727,32.36666666666667,11/05/2017,24,14,-3,TennesseeTen,268,186,39,77,20,23,Loss,73,71,2,3,1,BaltimoreBal,43,341,257,2
243,0.2727272727272727,0.375,27.633333333333333,11/05/2017,14,24,3,BaltimoreBal,186,268,39,52,23,20,Win,71,73,3,2,2,TennesseeTen,43,257,341,1
244,0.125,0.6666666666666666,19.766666666666666,11/05/2017,8,26,-16,JacksonvilleJax,119,259,77,37,7,23,Loss,29,149,2,0,1,CincinnatiCin,30,148,408,0
245,0.6666666666666666,0.125,40.233333333333334,11/05/2017,26,8,16,CincinnatiCin,259,119,50,78,23,7,Win,149,29,0,2,0,JacksonvilleJax,30,408,148,1
246,0.23076923076923078,0.38461538461538464,30.1,11/05/2017,14,25,-28,PhiladelphiaPhi,191,222,105,60,23,51,Loss,35,197,3,2,1,DenverDen,74,226,419,2
247,0.38461538461538464,0.23076923076923078,29.9,11/05/2017,25,14,28,DenverDen,222,191,35,67,51,23,Win,197,35,2,3,2,PhiladelphiaPhi,74,419,226,1
248,0.2857142857142857,0.2857142857142857,30.983333333333334,11/05/2017,17,19,6,HoustonHou,279,194,68,61,20,14,Win,92,94,3,2,1,IndianapolisInd,34,371,288,1
249,0.2857142857142857,0.2857142857142857,29.016666666666666,11/05/2017,19,17,-6,IndianapolisInd,194,279,74,67,14,20,Loss,94,92,2,3,1,HoustonHou,34,288,371,1
250,0.5,0.5,30.5,11/05/2017,20,17,34,NY GiantsNYG,311,208,55,61,51,17,Win,162,111,0,2,3,LA RamsLA,68,473,319,0
251,0.5,0.5,29.5,11/05/2017,17,20,-34,LA RamsLA,208,311,52,66,17,51,Loss,111,162,2,0,0,NY GiantsNYG,68,319,473,3
252,0.3076923076923077,0.5384615384615384,27.7,11/05/2017,14,21,-20,New OrleansNO,113,256,50,57,10,30,Loss,87,151,4,1,2,Tampa BayTB,40,200,407,1
253,0.5384615384615384,0.3076923076923077,32.3,11/05/2017,21,14,20,Tampa BayTB,256,113,28,60,30,10,Win,151,87,1,4,1,New OrleansNO,40,407,200,2
254,0.4375,0.35294117647058826,36.36666666666667,11/05/2017,20,17,10,San FranciscoSF,201,266,25,73,20,10,Win,167,63,0,5,2,ArizonaAri,30,368,329,2
255,0.35294117647058826,0.4375,23.633333333333333,11/05/2017,17,20,-10,ArizonaAri,266,201,53,73,10,20,Loss,63,167,5,0,2,San FranciscoSF,30,329,368,2
256,0.3076923076923077,0.35714285714285715,27.683333333333334,11/05/2017,16,22,3,SeattleSea,193,289,62,60,17,14,Win,51,148,6,2,2,WashingtonWas,31,244,437,1
257,0.35714285714285715,0.3076923076923077,32.31666666666667,11/05/2017,22,16,-3,WashingtonWas,289,193,138,75,14,17,Loss,148,51,2,6,1,SeattleSea,31,437,244,2
258,0.36363636363636365,0.5833333333333334,28.716666666666665,11/05/2017,17,24,-11,DallasDal,255,244,52,55,17,28,Loss,68,131,2,1,0,Kansas CityKC,45,323,375,1
259,0.5833333333333334,0.36363636363636365,31.283333333333335,11/05/2017,24,17,11,Kansas CityKC,244,255,65,65,28,17,Win,131,68,1,2,1,DallasDal,45,375,323,0
260,0.5333333333333333,0.4166666666666667,30.933333333333334,11/05/2017,20,23,3,MiamiMia,295,309,105,58,27,24,Win,84,86,1,1,1,OaklandOak,51,379,395,2
261,0.4166666666666667,0.5333333333333333,29.066666666666666,11/05/2017,23,20,-3,OaklandOak,309,295,107,61,24,27,Loss,86,84,1,1,2,MiamiMia,51,395,379,1
262,0.6153846153846154,0.2222222222222222,36.916666666666664,11/06/2017,24,21,13,Green BayGB,353,233,19,67,30,17,Win,64,78,1,3,0,DetroitDet,47,417,311,1
263,0.2222222222222222,0.6153846153846154,23.083333333333332,11/06/2017,21,24,-13,DetroitDet,233,353,20,58,17,30,Loss,78,64,3,1,1,Green BayGB,47,311,417,0
264,0.23076923076923078,0.4,30.883333333333333,11/09/2017,14,24,6,ArizonaAri,212,256,108,60,22,16,Win,75,34,5,2,1,SeattleSea,38,287,290,0
265,0.4,0.23076923076923078,29.116666666666667,11/09/2017,24,14,-6,SeattleSea,256,212,58,73,16,22,Loss,34,75,2,5,0,ArizonaAri,38,290,287,1
266,0.5,0.18181818181818182,41.38333333333333,11/12/2017,32,10,37,BuffaloBuf,184,129,41,73,47,10,Win,298,69,0,2,1,New OrleansNO,57,482,198,1
267,0.18181818181818182,0.5,18.616666666666667,11/12/2017,10,32,-37,New OrleansNO,129,184,56,45,10,47,Loss,69,298,2,0,1,BuffaloBuf,57,198,482,1
268,0.4375,0.2857142857142857,33.88333333333333,11/12/2017,18,14,7,ChicagoChi,182,268,35,65,23,16,Win,160,55,3,5,1,Green BayGB,39,342,323,0
269,0.2857142857142857,0.4375,26.116666666666667,11/12/2017,14,18,-7,Green BayGB,268,182,78,57,16,23,Loss,55,160,5,3,0,ChicagoChi,39,323,342,1
270,0.1,0.4666666666666667,19.85,11/12/2017,15,27,-4,TennesseeTen,255,236,84,50,20,24,Loss,53,180,1,4,2,CincinnatiCin,44,308,416,2
271,0.4666666666666667,0.1,40.15,11/12/2017,27,15,4,CincinnatiCin,236,255,55,84,24,20,Win,180,53,4,1,2,TennesseeTen,44,416,308,2
272,0.3333333333333333,0.45454545454545453,34.56666666666667,11/12/2017,26,16,-14,DetroitDet,212,241,60,77,24,38,Loss,201,104,4,4,1,ClevelandCle,62,413,345,2
273,0.45454545454545453,0.3333333333333333,25.433333333333334,11/12/2017,16,26,14,ClevelandCle,241,212,81,49,38,24,Win,104,201,4,4,2,DetroitDet,62,345,413,1
274,0.38461538461538464,0.4,29.966666666666665,11/12/2017,18,13,3,IndianapolisInd,228,196,70,62,20,17,Win,88,71,1,3,1,PittsburghPit,37,316,267,1
275,0.4,0.38461538461538464,30.033333333333335,11/12/2017,13,18,-3,PittsburghPit,196,228,82,56,17,20,Loss,71,88,3,1,1,IndianapolisInd,37,267,316,1
276,0.2,0.2777777777777778,31.783333333333335,11/12/2017,16,20,-3,JacksonvilleJax,235,263,77,67,0,3,Loss,87,135,0,3,2,LA ChargersLAC,3,322,398,2
277,0.2777777777777778,0.2,35.016666666666666,11/12/2017,20,16,3,LA ChargersLAC,263,235,106,81,3,0,Win,135,87,3,0,2,JacksonvilleJax,3,398,322,2
278,0.6666666666666666,0.35714285714285715,28.9,11/12/2017,21,24,8,WashingtonWas,304,313,40,60,38,30,Win,102,81,0,1,1,MinnesotaMin,68,406,394,2
279,0.35714285714285715,0.6666666666666666,31.1,11/12/2017,24,21,-8,MinnesotaMin,313,304,15,73,30,38,Loss,81,102,1,0,2,WashingtonWas,68,394,406,1
280,0.2,0.4375,28.1,11/12/2017,15,17,-5,Tampa BayTB,219,181,77,64,10,15,Loss,56,90,6,1,1,NY JetsNYJ,25,275,271,2
281,0.4375,0.2,31.9,11/12/2017,17,15,5,NY JetsNYJ,181,219,50,66,15,10,Win,90,56,1,6,2,Tampa BayTB,25,271,275,1
282,0.3333333333333333,0.375,28.483333333333334,11/12/2017,17,19,-26,LA RamsLA,194,339,60,64,7,33,Loss,89,104,3,3,0,HoustonHou,40,283,443,4
283,0.375,0.3333333333333333,31.516666666666666,11/12/2017,19,17,26,HoustonHou,339,194,86,66,33,7,Win,104,89,3,3,4,LA RamsLA,40,443,283,0
284,0.45454545454545453,0.5384615384615384,27.9,11/12/2017,18,22,-20,AtlantaAtl,126,204,54,59,7,27,Loss,107,132,8,1,1,DallasDal,34,233,336,2
285,0.5384615384615384,0.45454545454545453,32.1,11/12/2017,22,18,20,DallasDal,204,126,35,64,27,7,Win,132,107,1,8,2,AtlantaAtl,34,336,233,1
286,0.35714285714285715,0.6666666666666666,31.0,11/12/2017,19,21,-10,San FranciscoSF,260,288,35,63,21,31,Loss,114,186,3,0,2,NY GiantsNYG,52,374,474,1
287,0.6666666666666666,0.35714285714285715,29.0,11/12/2017,21,19,10,NY GiantsNYG,288,260,44,58,31,21,Win,186,114,0,3,1,San FranciscoSF,52,474,374,2
288,0.36363636363636365,0.5333333333333333,29.716666666666665,11/12/2017,28,17,25,DenverDen,297,221,5,67,41,16,Win,99,118,1,0,2,New EnglandNE,57,396,339,0
289,0.5333333333333333,0.36363636363636365,30.283333333333335,11/12/2017,17,28,-25,New EnglandNE,221,297,28,61,16,41,Loss,118,99,0,1,0,DenverDen,57,339,396,2
290,0.5833333333333334,0.7857142857142857,24.35,11/13/2017,17,30,-24,CarolinaCar,213,254,57,54,21,45,Loss,100,294,0,0,0,MiamiMia,66,313,548,1
291,0.7857142857142857,0.5833333333333334,35.65,11/13/2017,30,17,24,MiamiMia,254,213,37,71,45,21,Win,294,100,0,0,1,CarolinaCar,66,548,313,0
292,0.38461538461538464,0.3333333333333333,28.333333333333332,11/16/2017,17,25,-23,PittsburghPit,264,284,65,60,17,40,Loss,52,65,5,3,0,TennesseeTen,57,316,349,4
293,0.3333333333333333,0.38461538461538464,31.666666666666668,11/16/2017,25,17,23,TennesseeTen,284,264,61,69,40,17,Win,65,52,3,5,4,PittsburghPit,57,349,316,0
294,0.23076923076923078,0.46153846153846156,31.816666666666666,11/19/2017,19,18,10,MiamiMia,268,365,82,62,30,20,Win,53,83,1,1,5,Tampa BayTB,50,321,448,0
295,0.46153846153846156,0.23076923076923078,28.183333333333334,11/19/2017,18,19,-10,Tampa BayTB,365,268,123,60,20,30,Loss,83,53,1,1,0,MiamiMia,50,448,321,5
296,0.3,0.5333333333333333,26.233333333333334,11/19/2017,17,22,-10,HoustonHou,244,223,90,54,21,31,Loss,48,134,2,1,2,ArizonaAri,52,292,357,2
297,0.5333333333333333,0.3,33.766666666666666,11/19/2017,22,17,10,ArizonaAri,223,244,42,67,31,21,Win,134,48,1,2,2,HoustonHou,52,357,292,2
298,0.21428571428571427,0.3076923076923077,30.05,11/19/2017,14,16,23,Green BayGB,161,190,30,57,23,0,Win,58,75,3,6,5,BaltimoreBal,23,219,265,1
299,0.3076923076923077,0.21428571428571427,29.95,11/19/2017,16,14,-23,BaltimoreBal,190,161,53,67,0,23,Loss,75,58,6,3,1,Green BayGB,23,265,219,5
300,0.3,0.3333333333333333,30.6,11/19/2017,20,25,3,ChicagoChi,287,176,49,58,27,24,Win,65,222,3,1,1,DetroitDet,51,352,398,1
301,0.3333333333333333,0.3,29.4,11/19/2017,25,20,-3,DetroitDet,176,287,64,61,24,27,Loss,222,65,1,3,1,ChicagoChi,51,398,352,1
302,0.3,0.23076923076923078,36.916666666666664,11/19/2017,15,11,12,ClevelandCle,145,134,40,76,19,7,Win,139,50,2,5,5,JacksonvilleJax,26,284,184,1
303,0.23076923076923078,0.3,23.083333333333332,11/19/2017,11,15,-12,JacksonvilleJax,134,145,0,55,7,19,Loss,50,139,5,2,1,ClevelandCle,26,184,284,5
304,0.2727272727272727,0.23076923076923078,37.266666666666666,11/19/2017,22,20,-3,NY GiantsNYG,229,205,87,71,0,3,Loss,134,112,1,0,1,Kansas CityKC,3,363,317,3
305,0.23076923076923078,0.2727272727272727,30.833333333333332,11/19/2017,20,22,3,Kansas CityKC,205,229,48,68,3,0,Win,112,134,0,1,3,NY GiantsNYG,3,317,363,1
306,0.2727272727272727,0.5,22.633333333333333,11/19/2017,15,27,-17,MinnesotaMin,209,280,60,56,7,24,Loss,45,171,2,0,0,LA RamsLA,31,254,451,1
307,0.5,0.2727272727272727,37.36666666666667,11/19/2017,27,15,17,LA RamsLA,280,209,65,73,24,7,Win,171,45,0,2,1,MinnesotaMin,31,451,254,0
308,0.3333333333333333,0.3333333333333333,32.18333333333333,11/19/2017,24,27,-3,New OrleansNO,300,375,67,67,0,3,Loss,156,160,2,2,1,WashingtonWas,3,456,535,0
309,0.3333333333333333,0.3333333333333333,30.4,11/19/2017,27,24,3,WashingtonWas,375,300,54,66,3,0,Win,160,156,2,2,0,New OrleansNO,3,535,456,1
310,0.42857142857142855,0.5,23.916666666666668,11/19/2017,18,28,-30,LA ChargersLAC,220,283,48,62,24,54,Loss,173,146,1,1,0,BuffaloBuf,78,393,429,6
311,0.5,0.42857142857142855,36.083333333333336,11/19/2017,28,18,30,BuffaloBuf,283,220,13,73,54,24,Win,146,173,1,1,6,LA ChargersLAC,78,429,393,0
312,0.4666666666666667,0.5714285714285714,24.816666666666666,11/19/2017,12,20,3,DenverDen,141,229,14,53,20,17,Win,49,112,2,3,2,CincinnatiCin,37,190,341,0
313,0.5714285714285714,0.4666666666666667,35.18333333333333,11/19/2017,20,12,-3,CincinnatiCin,229,141,50,79,17,20,Loss,112,49,3,2,0,DenverDen,37,341,190,2
314,0.5,0.4666666666666667,27.616666666666667,11/19/2017,25,21,25,OaklandOak,332,235,10,58,33,8,Win,89,109,1,1,2,New EnglandNE,41,421,344,0
315,0.4666666666666667,0.5,32.38333333333333,11/19/2017,21,25,-25,New EnglandNE,235,332,66,71,8,33,Loss,109,89,1,1,0,OaklandOak,41,344,421,2
316,0.35714285714285715,0.21428571428571427,29.483333333333334,11/19/2017,17,14,28,DallasDal,168,113,30,60,37,9,Win,215,112,0,4,4,PhiladelphiaPhi,46,383,225,0
317,0.21428571428571427,0.35714285714285715,30.516666666666666,11/19/2017,14,17,-28,PhiladelphiaPhi,113,168,10,63,9,37,Loss,112,215,4,0,0,DallasDal,46,225,383,4
318,0.6428571428571429,0.4166666666666667,30.35,11/20/2017,22,26,3,SeattleSea,190,224,69,58,34,31,Win,89,136,1,3,2,AtlantaAtl,65,279,360,1
319,0.4166666666666667,0.6428571428571429,29.65,11/20/2017,26,22,-3,AtlantaAtl,224,190,106,69,31,34,Loss,136,89,3,1,1,SeattleSea,65,360,279,2
320,0.46153846153846156,0.2727272727272727,34.95,11/23/2017,28,17,7,DetroitDet,272,236,74,73,30,23,Win,136,53,2,3,2,MinnesotaMin,53,408,289,0
321,0.2727272727272727,0.46153846153846156,25.05,11/23/2017,17,28,-7,MinnesotaMin,236,272,54,53,23,30,Loss,53,136,3,2,0,DetroitDet,53,289,408,2
322,0.6428571428571429,0.5454545454545454,36.083333333333336,11/23/2017,25,14,22,DallasDal,434,168,56,66,28,6,Win,81,79,0,2,2,LA ChargersLAC,34,515,247,0
323,0.5454545454545454,0.6428571428571429,23.916666666666668,11/23/2017,14,25,-22,LA ChargersLAC,168,434,60,49,6,28,Loss,79,81,2,0,0,DallasDal,34,247,515,2
324,0.14285714285714285,0.26666666666666666,25.383333333333333,11/23/2017,7,17,-10,WashingtonWas,86,201,79,55,10,20,Loss,84,122,4,6,1,NY GiantsNYG,30,170,323,1
325,0.26666666666666666,0.14285714285714285,34.61666666666667,11/23/2017,17,7,10,NY GiantsNYG,201,86,55,68,20,10,Win,122,84,6,4,1,WashingtonWas,30,323,170,1
326,0.36363636363636365,0.7857142857142857,29.9,11/26/2017,27,23,-14,AtlantaAtl,279,368,15,68,20,34,Loss,94,148,1,0,1,Tampa BayTB,54,373,516,0
327,0.7857142857142857,0.36363636363636365,30.1,11/26/2017,23,27,14,Tampa BayTB,368,279,42,64,34,20,Win,148,94,0,1,0,AtlantaAtl,54,516,373,1
328,0.35294117647058826,0.15384615384615385,33.3,11/26/2017,17,14,6,Kansas CityKC,164,181,50,68,16,10,Win,104,55,2,2,1,BuffaloBuf,26,268,236,0
329,0.15384615384615385,0.35294117647058826,26.7,11/26/2017,14,17,-6,BuffaloBuf,181,164,50,57,10,16,Loss,55,104,2,2,0,Kansas CityKC,26,236,268,1
330,0.21428571428571427,0.35714285714285715,31.833333333333332,11/26/2017,17,21,8,NY JetsNYJ,154,282,84,64,35,27,Win,145,109,3,3,1,CarolinaCar,62,299,391,0
331,0.35714285714285715,0.21428571428571427,28.166666666666668,11/26/2017,21,17,-8,CarolinaCar,282,154,68,65,27,35,Loss,109,145,3,3,0,NY JetsNYJ,62,391,299,1
332,0.23076923076923078,0.4375,22.866666666666667,11/26/2017,8,24,-28,PhiladelphiaPhi,134,244,56,49,3,31,Loss,6,176,2,1,3,ChicagoChi,34,140,420,2
333,0.4375,0.23076923076923078,37.13333333333333,11/26/2017,24,8,28,ChicagoChi,244,134,70,73,31,3,Win,176,6,1,2,2,PhiladelphiaPhi,34,420,140,3
334,0.4,0.4,29.466666666666665,11/26/2017,21,23,-14,CincinnatiCin,236,209,69,67,16,30,Loss,169,152,4,1,0,ClevelandCle,46,405,361,0
335,0.4,0.4,30.533333333333335,11/26/2017,23,21,14,ClevelandCle,209,236,35,59,30,16,Win,152,169,1,4,0,CincinnatiCin,46,361,405,0
336,0.375,0.42857142857142855,28.633333333333333,11/26/2017,19,15,4,IndianapolisInd,184,165,15,53,20,16,Win,92,89,0,8,1,TennesseeTen,36,276,254,2
337,0.42857142857142855,0.375,31.366666666666667,11/26/2017,15,19,-4,TennesseeTen,165,184,67,61,16,20,Loss,89,92,8,0,2,IndianapolisInd,36,254,276,1
338,0.18181818181818182,0.4166666666666667,27.316666666666666,11/26/2017,15,25,-18,New EnglandNE,154,221,52,60,17,35,Loss,67,196,7,1,2,MiamiMia,52,221,417,3
339,0.4166666666666667,0.18181818181818182,32.68333333333333,11/26/2017,25,15,18,MiamiMia,221,154,70,67,35,17,Win,196,67,1,7,3,New EnglandNE,52,417,221,2
340,0.38461538461538464,0.3125,29.516666666666666,11/26/2017,20,16,11,San FranciscoSF,228,196,35,64,24,13,Win,90,84,0,3,1,SeattleSea,37,318,280,1
341,0.3125,0.38461538461538464,30.483333333333334,11/26/2017,16,20,-11,SeattleSea,196,228,74,67,13,24,Loss,84,90,3,0,1,San FranciscoSF,37,280,318,1
342,0.08333333333333333,0.4117647058823529,25.35,11/26/2017,19,20,-3,ArizonaAri,128,236,45,58,24,27,Loss,91,108,3,1,2,JacksonvilleJax,51,219,344,3
343,0.4117647058823529,0.08333333333333333,34.65,11/26/2017,20,19,3,JacksonvilleJax,236,128,98,70,27,24,Win,108,91,1,3,3,ArizonaAri,51,344,219,2
344,0.35714285714285715,0.38461538461538464,24.1,11/26/2017,12,21,-7,OaklandOak,160,244,75,57,14,21,Loss,56,104,5,2,1,DenverDen,35,216,348,1
345,0.38461538461538464,0.35714285714285715,35.9,11/26/2017,21,12,7,DenverDen,244,160,68,63,21,14,Win,104,56,2,5,1,OaklandOak,35,348,216,1
346,0.23076923076923078,0.21428571428571427,24.566666666666666,11/26/2017,14,24,-6,LA RamsLA,223,327,112,52,20,26,Loss,123,88,3,4,1,New OrleansNO,46,346,415,0
347,0.21428571428571427,0.23076923076923078,35.43333333333333,11/26/2017,24,14,6,New OrleansNO,327,223,90,73,26,20,Win,88,123,4,3,0,LA RamsLA,46,415,346,1
348,0.46153846153846156,0.6153846153846154,26.4,11/26/2017,15,28,-3,PittsburghPit,227,341,27,54,28,31,Loss,80,121,4,1,3,Green BayGB,59,307,462,0
349,0.6153846153846154,0.46153846153846156,33.6,11/26/2017,28,15,3,Green BayGB,341,227,45,70,31,28,Win,121,80,1,4,0,PittsburghPit,59,462,307,3
350,0.42857142857142855,0.21428571428571427,30.266666666666666,11/27/2017,20,17,-7,BaltimoreBal,237,155,36,64,16,23,Loss,66,139,2,1,0,HoustonHou,39,303,294,3
351,0.21428571428571427,0.42857142857142855,29.733333333333334,11/27/2017,17,20,7,HoustonHou,155,237,89,65,23,16,Win,139,66,1,2,3,BaltimoreBal,39,294,303,0
352,0.42857142857142855,0.5,27.533333333333335,11/30/2017,15,21,-24,DallasDal,224,93,43,60,14,38,Loss,56,182,4,1,0,WashingtonWas,52,280,275,4
353,0.5,0.42857142857142855,32.46666666666667,11/30/2017,21,15,24,WashingtonWas,93,224,25,65,38,14,Win,182,56,1,4,4,DallasDal,52,275,280,0
354,0.5,0.1,34.03333333333333,12/03/2017,22,15,5,AtlantaAtl,207,173,51,63,14,9,Win,105,102,2,0,0,MinnesotaMin,23,312,275,0
355,0.1,0.5,25.966666666666665,12/03/2017,15,22,-5,MinnesotaMin,173,207,55,51,9,14,Loss,102,105,0,2,0,AtlantaAtl,23,275,312,0
356,0.3076923076923077,0.4166666666666667,30.15,12/03/2017,18,24,-24,BaltimoreBal,294,269,45,61,20,44,Loss,78,101,3,0,0,DetroitDet,64,372,370,3
357,0.4166666666666667,0.3076923076923077,29.85,12/03/2017,24,18,24,DetroitDet,269,294,25,63,44,20,Win,101,78,0,3,3,BaltimoreBal,64,370,372,0
358,0.4166666666666667,0.38461538461538464,34.016666666666666,12/03/2017,23,16,20,BuffaloBuf,244,85,66,68,23,3,Win,191,183,3,4,1,New EnglandNE,26,435,268,1
359,0.38461538461538464,0.4166666666666667,25.983333333333334,12/03/2017,16,23,-20,New EnglandNE,85,244,34,64,3,23,Loss,183,191,4,3,1,BuffaloBuf,26,268,435,1
360,0.5555555555555556,0.5,38.78333333333333,12/03/2017,23,8,1,ChicagoChi,278,85,53,73,15,14,Win,110,62,2,2,0,San FranciscoSF,29,388,147,1
361,0.5,0.5555555555555556,21.216666666666665,12/03/2017,8,23,-1,San FranciscoSF,85,278,29,36,14,15,Loss,62,110,2,2,1,ChicagoChi,29,147,388,0
362,0.07692307692307693,0.26666666666666666,25.633333333333333,12/03/2017,14,15,-26,MiamiMia,167,222,57,67,9,35,Loss,103,145,3,2,3,DenverDen,44,270,367,3
363,0.26666666666666666,0.07692307692307693,34.36666666666667,12/03/2017,15,14,26,DenverDen,222,167,85,64,35,9,Win,145,103,2,3,3,MiamiMia,44,367,270,3
364,0.5625,0.4166666666666667,37.28333333333333,12/03/2017,25,16,-6,Green BayGB,230,77,74,74,0,6,Loss,165,199,7,2,1,Tampa BayTB,6,395,276,1
365,0.4166666666666667,0.5625,26.733333333333334,12/03/2017,16,25,6,Tampa BayTB,77,230,47,53,6,0,Win,199,165,2,7,1,Green BayGB,6,276,395,1
366,0.5,0.45454545454545453,33.81666666666667,12/03/2017,24,19,-11,TennesseeTen,331,146,85,75,13,24,Loss,53,198,4,2,1,HoustonHou,37,384,344,1
367,0.45454545454545453,0.5,26.183333333333334,12/03/2017,19,24,11,HoustonHou,146,331,63,50,24,13,Win,198,53,2,4,1,TennesseeTen,37,344,384,1
368,0.3333333333333333,0.6,26.216666666666665,12/03/2017,17,22,-20,JacksonvilleJax,149,330,31,66,10,30,Loss,141,96,4,1,0,IndianapolisInd,40,290,426,2
369,0.6,0.3333333333333333,33.78333333333333,12/03/2017,22,17,20,IndianapolisInd,330,149,55,64,30,10,Win,96,141,1,4,2,JacksonvilleJax,40,426,290,0
370,0.375,0.65,17.183333333333334,12/03/2017,17,30,-7,NY JetsNYJ,362,331,30,46,31,38,Loss,112,157,2,0,0,Kansas CityKC,69,474,488,0
371,0.65,0.375,42.81666666666667,12/03/2017,30,17,7,Kansas CityKC,331,362,40,85,38,31,Win,157,112,0,2,0,NY JetsNYJ,69,488,474,0
372,0.45454545454545453,0.5333333333333333,25.05,12/03/2017,17,23,-9,LA ChargersLAC,202,335,24,57,10,19,Loss,89,94,3,1,0,ClevelandCle,29,291,429,2
373,0.5333333333333333,0.45454545454545453,34.95,12/03/2017,23,17,9,ClevelandCle,335,202,62,69,19,10,Win,94,89,1,3,2,LA ChargersLAC,29,429,291,0
374,0.2727272727272727,0.4666666666666667,28.966666666666665,12/03/2017,18,19,16,ArizonaAri,213,187,36,56,32,16,Win,90,118,1,7,2,LA RamsLA,48,303,305,1
375,0.4666666666666667,0.2727272727272727,31.033333333333335,12/03/2017,19,18,-16,LA RamsLA,187,213,25,62,16,32,Loss,118,90,7,1,1,ArizonaAri,48,305,303,2
376,0.3,0.4,26.65,12/03/2017,16,19,-10,New OrleansNO,167,252,54,53,21,31,Loss,112,148,2,2,1,CarolinaCar,52,279,400,1
377,0.4,0.3,33.35,12/03/2017,19,16,10,CarolinaCar,252,167,68,64,31,21,Win,148,112,2,2,1,New OrleansNO,52,400,279,1
378,0.35714285714285715,0.4,28.683333333333334,12/03/2017,15,18,-7,OaklandOak,200,282,5,61,17,24,Loss,65,119,3,1,1,NY GiantsNYG,41,265,401,2
379,0.4,0.35714285714285715,31.316666666666666,12/03/2017,18,15,7,NY GiantsNYG,282,200,42,66,24,17,Win,119,65,1,3,2,OaklandOak,41,401,265,1
380,0.5,0.5,31.9,12/03/2017,25,20,-14,SeattleSea,327,209,64,74,10,24,Loss,98,101,3,2,0,PhiladelphiaPhi,34,425,310,2
381,0.5,0.5,28.1,12/03/2017,20,25,14,PhiladelphiaPhi,209,327,46,58,24,10,Win,101,98,2,3,2,SeattleSea,34,310,425,0
382,0.3333333333333333,0.5,29.816666666666666,12/04/2017,24,19,3,CincinnatiCin,282,223,66,63,23,20,Win,92,130,1,2,0,PittsburghPit,43,374,353,1
383,0.5,0.3333333333333333,30.183333333333334,12/04/2017,19,24,-3,PittsburghPit,223,282,173,60,20,23,Loss,130,92,2,1,1,CincinnatiCin,43,353,374,0
384,0.3,0.5833333333333334,25.316666666666666,12/07/2017,18,26,-3,AtlantaAtl,256,211,82,52,17,20,Loss,50,132,2,1,3,New OrleansNO,37,306,343,1
385,0.5833333333333334,0.3,34.68333333333333,12/07/2017,26,18,3,New OrleansNO,211,256,35,65,20,17,Win,132,50,1,2,1,AtlantaAtl,37,343,306,3
386,0.25,0.5555555555555556,36.03333333333333,12/10/2017,16,14,-6,BuffaloBuf,64,92,20,69,0,6,Loss,163,227,1,0,2,IndianapolisInd,6,227,319,0
387,0.5555555555555556,0.25,32.416666666666664,12/10/2017,14,16,6,IndianapolisInd,92,64,10,67,6,0,Win,227,163,0,1,0,BuffaloBuf,6,319,227,2
388,0.4666666666666667,0.3333333333333333,28.7,12/10/2017,21,15,-7,CarolinaCar,256,129,30,71,24,31,Loss,100,216,6,2,1,MinnesotaMin,55,356,345,3
389,0.3333333333333333,0.4666666666666667,31.3,12/10/2017,15,21,7,MinnesotaMin,129,256,48,63,31,24,Win,216,100,2,6,3,CarolinaCar,55,345,356,1
390,0.36363636363636365,0.25,38.15,12/10/2017,29,14,26,CincinnatiCin,250,164,74,72,33,7,Win,232,70,2,3,2,ChicagoChi,40,482,234,0
391,0.25,0.36363636363636365,21.85,12/10/2017,14,29,-26,ChicagoChi,164,250,56,53,7,33,Loss,70,232,3,2,0,CincinnatiCin,40,234,482,2
392,0.5,0.5384615384615384,36.28333333333333,12/10/2017,24,17,6,ClevelandCle,256,209,20,74,6,0,Win,85,136,1,2,2,Green BayGB,6,341,345,0
393,0.5384615384615384,0.5,28.633333333333333,12/10/2017,17,24,-6,Green BayGB,209,256,45,57,0,6,Loss,136,85,2,1,0,ClevelandCle,6,345,341,2
394,0.5,0.375,27.116666666666667,12/10/2017,19,21,20,NY GiantsNYG,332,228,51,61,30,10,Win,122,102,0,0,2,DallasDal,40,454,330,0
395,0.375,0.5,32.88333333333333,12/10/2017,21,19,-20,DallasDal,228,332,69,75,10,30,Loss,102,122,0,0,0,NY GiantsNYG,40,330,454,2
396,0.45454545454545453,0.5,29.783333333333335,12/10/2017,21,28,3,Tampa BayTB,381,267,105,62,24,21,Win,53,133,0,3,5,DetroitDet,45,434,400,3
397,0.5,0.45454545454545453,30.216666666666665,12/10/2017,28,21,-3,DetroitDet,267,381,65,69,21,24,Loss,133,53,3,0,3,Tampa BayTB,45,400,434,5
398,0.18181818181818182,0.23076923076923078,34.81666666666667,12/10/2017,20,18,10,HoustonHou,314,221,87,66,26,16,Win,102,90,2,3,1,San FranciscoSF,42,416,311,1
399,0.23076923076923078,0.18181818181818182,25.183333333333334,12/10/2017,18,20,-10,San FranciscoSF,221,314,81,64,16,26,Loss,90,102,3,2,1,HoustonHou,42,311,416,1
400,0.38461538461538464,0.38461538461538464,23.333333333333332,12/10/2017,15,23,-11,Kansas CityKC,198,243,39,55,15,26,Loss,70,165,3,4,1,OaklandOak,41,268,408,3
401,0.38461538461538464,0.38461538461538464,36.666666666666664,12/10/2017,23,15,11,OaklandOak,243,198,69,71,26,15,Win,165,70,4,3,3,Kansas CityKC,41,408,268,1
402,0.3333333333333333,0.21428571428571427,26.183333333333334,12/10/2017,14,16,-5,ArizonaAri,139,125,48,56,7,12,Loss,65,136,3,8,0,TennesseeTen,19,204,261,2
403,0.21428571428571427,0.3333333333333333,33.81666666666667,12/10/2017,16,14,5,TennesseeTen,125,139,30,63,12,7,Win,136,65,8,3,2,ArizonaAri,19,261,204,0
404,0.23076923076923078,0.4117647058823529,22.416666666666668,12/10/2017,6,17,-23,DenverDen,41,189,20,48,0,23,Loss,59,84,4,2,0,NY JetsNYJ,23,100,273,2
405,0.4117647058823529,0.23076923076923078,37.583333333333336,12/10/2017,17,6,23,NY JetsNYJ,189,41,21,68,23,0,Win,84,59,2,4,2,DenverDen,23,273,100,0
406,0.16666666666666666,0.4,24.666666666666668,12/10/2017,9,24,-17,LA ChargersLAC,136,314,47,50,13,30,Loss,65,174,2,2,1,WashingtonWas,43,201,488,1
407,0.4,0.16666666666666666,35.333333333333336,12/10/2017,24,9,17,WashingtonWas,314,136,40,71,30,13,Win,174,65,2,2,1,LA ChargersLAC,43,488,201,1
408,0.2222222222222222,0.3333333333333333,26.983333333333334,12/10/2017,17,20,-6,JacksonvilleJax,260,268,73,57,24,30,Loss,141,156,2,0,1,SeattleSea,54,401,424,3
409,0.3333333333333333,0.2222222222222222,33.016666666666666,12/10/2017,20,17,6,SeattleSea,268,260,48,66,30,24,Win,156,141,0,2,3,JacksonvilleJax,54,424,401,1
410,0.4,0.2857142857142857,39.2,12/10/2017,29,17,8,LA RamsLA,316,198,67,85,43,35,Win,139,109,2,2,2,PhiladelphiaPhi,78,455,307,1
411,0.2857142857142857,0.4,20.8,12/10/2017,17,29,-8,PhiladelphiaPhi,198,316,102,45,35,43,Loss,109,139,2,2,1,LA RamsLA,78,307,455,2
412,0.4,0.6666666666666666,26.166666666666668,12/10/2017,26,31,-1,PittsburghPit,261,486,35,62,38,39,Loss,152,59,1,3,0,BaltimoreBal,77,413,545,1
413,0.6666666666666666,0.4,33.833333333333336,12/10/2017,31,26,1,BaltimoreBal,486,261,101,85,39,38,Win,59,152,3,1,1,PittsburghPit,77,545,413,0
414,0.0,0.2857142857142857,23.85,12/11/2017,14,21,-7,MiamiMia,223,242,78,55,20,27,Loss,25,120,2,2,0,New EnglandNE,47,248,362,2
415,0.2857142857142857,0.0,36.15,12/11/2017,21,14,7,New EnglandNE,242,223,102,70,27,20,Win,120,25,2,2,2,MiamiMia,47,362,248,0
416,0.4666666666666667,0.46153846153846156,36.85,12/14/2017,23,15,12,IndianapolisInd,251,158,80,74,25,13,Win,211,70,2,1,0,DenverDen,38,462,228,1
417,0.46153846153846156,0.4666666666666667,23.15,12/14/2017,15,23,-12,DenverDen,158,251,39,53,13,25,Loss,70,211,1,2,1,IndianapolisInd,38,228,462,0
418,0.4166666666666667,0.46153846153846156,30.916666666666668,12/16/2017,22,18,-10,DetroitDet,306,202,97,63,10,20,Loss,43,91,2,4,1,ChicagoChi,30,349,293,3
419,0.46153846153846156,0.4166666666666667,29.083333333333332,12/16/2017,18,22,10,ChicagoChi,202,306,58,57,20,10,Win,91,43,4,2,3,DetroitDet,30,293,349,1
420,0.36363636363636365,0.42857142857142855,26.65,12/16/2017,20,20,-17,Kansas CityKC,209,223,61,60,13,30,Loss,98,174,2,1,0,LA ChargersLAC,43,307,397,4
421,0.42857142857142855,0.36363636363636365,33.35,12/16/2017,20,20,17,LA ChargersLAC,223,209,71,63,30,13,Win,174,98,1,2,4,Kansas CityKC,43,397,307,0
422,0.21052631578947367,0.1111111111111111,36.266666666666666,12/17/2017,19,14,-5,WashingtonWas,145,187,71,80,15,20,Loss,141,31,5,1,1,ArizonaAri,35,286,218,2
423,0.1111111111111111,0.21052631578947367,23.733333333333334,12/17/2017,14,19,5,ArizonaAri,187,145,82,47,20,15,Win,31,141,1,5,2,WashingtonWas,35,218,286,1
424,0.4375,0.35714285714285715,36.8,12/17/2017,23,15,17,ClevelandCle,279,136,57,74,27,10,Win,97,130,1,2,4,BaltimoreBal,37,376,266,0
425,0.35714285714285715,0.4375,23.2,12/17/2017,15,23,-17,BaltimoreBal,136,279,35,58,10,27,Loss,130,97,2,1,0,ClevelandCle,37,266,376,4
426,0.3125,0.4666666666666667,32.416666666666664,12/17/2017,21,21,-8,BuffaloBuf,249,212,60,73,16,24,Loss,100,116,3,2,0,MiamiMia,40,349,328,3
427,0.4666666666666667,0.3125,27.583333333333332,12/17/2017,21,21,8,MiamiMia,212,249,28,61,24,16,Win,116,100,2,3,3,BuffaloBuf,40,328,349,0
428,0.36363636363636365,0.5,26.05,12/17/2017,24,29,-7,CarolinaCar,264,236,28,67,24,31,Loss,120,151,3,1,0,Green BayGB,55,384,387,4
429,0.5,0.36363636363636365,33.95,12/17/2017,29,24,7,Green BayGB,236,264,40,70,31,24,Win,151,120,1,3,4,CarolinaCar,55,387,384,0
430,0.07692307692307693,0.3333333333333333,24.133333333333333,12/17/2017,8,18,-27,MinnesotaMin,115,222,44,51,7,34,Loss,46,124,3,2,1,CincinnatiCin,41,161,346,2
431,0.3333333333333333,0.07692307692307693,35.86666666666667,12/17/2017,18,8,27,CincinnatiCin,222,115,93,61,34,7,Win,124,46,2,3,2,MinnesotaMin,41,346,161,1
432,0.25,0.3,26.7,12/17/2017,9,25,-38,JacksonvilleJax,99,326,127,56,7,45,Loss,87,138,4,1,0,HoustonHou,52,186,464,1
433,0.3,0.25,33.3,12/17/2017,25,9,38,HoustonHou,326,99,54,68,45,7,Win,138,87,1,4,1,JacksonvilleJax,52,464,186,0
434,0.3333333333333333,0.3,30.833333333333332,12/17/2017,19,23,-12,New OrleansNO,170,281,50,68,19,31,Loss,124,131,1,0,3,NY JetsNYJ,50,294,412,2
435,0.3,0.3333333333333333,29.166666666666668,12/17/2017,23,19,12,NY JetsNYJ,281,170,92,64,31,19,Win,131,124,0,1,2,New OrleansNO,50,412,294,3
436,0.46153846153846156,0.5555555555555556,30.883333333333333,12/17/2017,22,27,5,NY GiantsNYG,233,429,44,66,34,29,Win,108,75,1,1,1,PhiladelphiaPhi,63,341,504,0
437,0.5555555555555556,0.46153846153846156,29.116666666666667,12/17/2017,27,22,-5,PhiladelphiaPhi,429,233,67,81,29,34,Loss,75,108,1,1,0,NY GiantsNYG,63,504,341,1
438,0.375,0.2857142857142857,36.766666666666666,12/17/2017,19,11,35,SeattleSea,108,71,25,68,42,7,Win,244,78,2,7,2,LA RamsLA,49,352,149,1
439,0.2857142857142857,0.375,23.233333333333334,12/17/2017,11,19,-35,LA RamsLA,71,108,60,54,7,42,Loss,78,244,7,2,1,SeattleSea,49,149,352,2
440,0.3333333333333333,0.625,24.883333333333333,12/17/2017,21,21,3,PittsburghPit,283,270,4,56,27,24,Win,77,143,2,2,1,New EnglandNE,51,360,413,1
441,0.625,0.3333333333333333,35.11666666666667,12/17/2017,21,21,-3,New EnglandNE,270,283,63,63,24,27,Loss,143,77,2,2,1,PittsburghPit,51,413,360,1
442,0.5,0.5,27.416666666666668,12/17/2017,23,23,-2,San FranciscoSF,238,363,22,62,23,25,Loss,90,51,1,3,0,TennesseeTen,48,328,414,1
443,0.5,0.5,32.583333333333336,12/17/2017,23,23,2,TennesseeTen,363,238,70,68,25,23,Win,51,90,3,1,1,San FranciscoSF,48,414,328,0
444,0.2,0.5333333333333333,32.333333333333336,12/17/2017,21,19,3,OaklandOak,204,171,100,60,20,17,Win,126,122,2,0,1,DallasDal,37,330,293,2
445,0.5333333333333333,0.2,27.666666666666668,12/17/2017,19,21,-3,DallasDal,171,204,105,61,17,20,Loss,122,126,0,2,2,OaklandOak,37,293,330,1
446,0.6,0.5,33.25,12/18/2017,24,22,3,Tampa BayTB,209,289,60,67,24,21,Win,201,84,1,2,1,AtlantaAtl,45,410,373,0
447,0.5,0.6,26.75,12/18/2017,22,24,-3,AtlantaAtl,289,209,53,55,21,24,Loss,84,201,2,1,0,Tampa BayTB,45,373,410,1
448,0.38461538461538464,0.42857142857142855,24.2,12/23/2017,17,23,-7,BaltimoreBal,203,220,19,59,16,23,Loss,93,103,2,1,0,IndianapolisInd,39,296,323,0
449,0.42857142857142855,0.38461538461538464,35.8,12/23/2017,23,17,7,IndianapolisInd,220,203,25,71,23,16,Win,103,93,1,2,0,BaltimoreBal,39,323,296,0
450,0.26666666666666666,0.26666666666666666,31.616666666666667,12/23/2017,15,12,16,Green BayGB,124,126,10,61,16,0,Win,112,113,3,1,2,MinnesotaMin,16,236,239,0
451,0.26666666666666666,0.26666666666666666,28.383333333333333,12/23/2017,12,15,-16,MinnesotaMin,126,124,79,65,0,16,Loss,113,112,1,3,0,Green BayGB,16,239,236,2
452,0.15384615384615385,0.23076923076923078,26.2,12/24/2017,15,15,-10,New OrleansNO,264,229,91,61,13,23,Loss,67,86,5,1,1,AtlantaAtl,36,331,315,2
453,0.23076923076923078,0.15384615384615385,33.8,12/24/2017,15,15,10,AtlantaAtl,229,264,30,60,23,13,Win,86,67,1,5,2,New OrleansNO,36,315,331,1
454,0.47058823529411764,0.45454545454545453,28.266666666666666,12/24/2017,17,28,-21,New EnglandNE,242,218,83,68,16,37,Loss,84,193,6,2,1,BuffaloBuf,53,326,411,0
455,0.45454545454545453,0.47058823529411764,31.733333333333334,12/24/2017,28,17,21,BuffaloBuf,218,242,10,68,37,16,Win,193,84,2,6,0,New EnglandNE,53,411,326,1
456,0.5454545454545454,0.3076923076923077,29.5,12/24/2017,20,20,-3,CarolinaCar,326,140,72,57,19,22,Loss,66,115,6,2,1,Tampa BayTB,41,392,255,3
457,0.3076923076923077,0.5454545454545454,30.5,12/24/2017,20,20,3,Tampa BayTB,140,326,50,59,22,19,Win,115,66,2,6,3,CarolinaCar,41,255,392,1
458,0.3076923076923077,0.4375,26.766666666666666,12/24/2017,12,16,-17,ChicagoChi,178,161,60,57,3,20,Loss,76,97,1,5,0,ClevelandCle,23,254,258,3
459,0.4375,0.3076923076923077,33.233333333333334,12/24/2017,16,12,17,ClevelandCle,161,178,25,59,20,3,Win,97,76,5,1,3,ChicagoChi,23,258,254,0
460,0.4,0.5,27.516666666666666,12/24/2017,15,28,-9,CincinnatiCin,189,222,74,59,17,26,Loss,87,142,2,3,1,DetroitDet,43,276,364,1
461,0.5,0.4,32.483333333333334,12/24/2017,28,15,9,DetroitDet,222,189,60,78,26,17,Win,142,87,3,2,1,CincinnatiCin,43,364,276,1
462,0.29411764705882354,0.38461538461538464,30.45,12/24/2017,18,19,-16,WashingtonWas,171,299,30,71,11,27,Loss,159,87,4,0,2,DenverDen,38,330,386,3
463,0.38461538461538464,0.29411764705882354,29.55,12/24/2017,19,18,16,DenverDen,299,171,35,66,27,11,Win,87,159,0,4,3,WashingtonWas,38,386,330,2
464,0.0,0.5,22.116666666666667,12/24/2017,15,23,-16,Kansas CityKC,286,301,75,54,13,29,Loss,59,103,0,1,0,MiamiMia,42,345,404,2
465,0.5,0.0,37.88333333333333,12/24/2017,23,15,16,MiamiMia,301,286,40,74,29,13,Win,103,59,1,0,2,Kansas CityKC,42,404,345,0
466,0.3333333333333333,0.21428571428571427,32.96666666666667,12/24/2017,21,13,7,NY JetsNYJ,290,98,80,70,14,7,Win,89,197,0,3,3,LA ChargersLAC,21,379,295,0
467,0.21428571428571427,0.3333333333333333,27.033333333333335,12/24/2017,13,21,-7,LA ChargersLAC,98,290,34,61,7,14,Loss,197,89,3,0,0,NY JetsNYJ,21,295,379,3
468,0.42857142857142855,0.25,30.066666666666666,12/24/2017,20,19,4,TennesseeTen,286,269,44,66,27,23,Win,116,97,1,1,1,LA RamsLA,50,402,366,1
469,0.25,0.42857142857142855,29.933333333333334,12/24/2017,19,20,-4,LA RamsLA,269,286,54,66,23,27,Loss,97,116,1,1,1,TennesseeTen,50,366,402,1
470,0.38461538461538464,0.6666666666666666,30.816666666666666,12/24/2017,32,26,-11,San FranciscoSF,380,238,99,79,33,44,Loss,92,131,1,1,1,JacksonvilleJax,77,472,369,3
471,0.6666666666666666,0.38461538461538464,29.183333333333334,12/24/2017,26,32,11,JacksonvilleJax,238,380,68,66,44,33,Win,131,92,1,1,3,San FranciscoSF,77,369,472,1
472,0.07142857142857142,0.35714285714285715,26.783333333333335,12/24/2017,12,19,-23,ArizonaAri,250,215,101,67,0,23,Loss,43,74,2,2,2,NY GiantsNYG,23,293,289,3
473,0.35714285714285715,0.07142857142857142,33.21666666666667,12/24/2017,19,12,23,NY GiantsNYG,215,250,45,64,23,0,Win,74,43,2,2,3,ArizonaAri,23,289,293,2
474,0.36363636363636365,0.46153846153846156,27.166666666666668,12/24/2017,15,21,9,DallasDal,60,154,142,54,21,12,Win,76,128,3,4,3,SeattleSea,33,136,282,0
475,0.46153846153846156,0.36363636363636365,32.833333333333336,12/24/2017,21,15,-9,SeattleSea,154,60,75,68,12,21,Loss,128,76,4,3,0,DallasDal,33,282,136,3
476,0.5833333333333334,0.25,30.933333333333334,12/25/2017,20,13,28,HoustonHou,226,51,24,58,34,6,Win,104,176,0,7,2,PittsburghPit,40,330,227,0
477,0.25,0.5833333333333334,29.066666666666666,12/25/2017,13,20,-28,PittsburghPit,51,226,80,52,6,34,Loss,176,104,7,0,0,HoustonHou,40,227,330,2
478,0.23076923076923078,0.07142857142857142,34.35,12/25/2017,13,12,-9,PhiladelphiaPhi,137,138,50,63,10,19,Loss,137,78,1,2,2,OaklandOak,29,274,216,5
479,0.07142857142857142,0.23076923076923078,25.65,12/25/2017,12,13,9,OaklandOak,138,137,60,61,19,10,Win,78,137,2,1,5,PhiladelphiaPhi,29,216,274,2
480,0.08333333333333333,0.38461538461538464,24.083333333333332,12/31/2017,12,21,-13,MinnesotaMin,171,180,116,53,10,23,Loss,30,147,1,2,0,ChicagoChi,33,201,327,0
481,0.38461538461538464,0.08333333333333333,35.916666666666664,12/31/2017,21,12,13,ChicagoChi,180,171,103,67,23,10,Win,147,30,2,1,0,MinnesotaMin,33,327,201,0
482,0.4666666666666667,0.3,30.916666666666668,12/31/2017,17,20,-4,PittsburghPit,272,224,77,63,24,28,Loss,102,124,6,3,2,ClevelandCle,52,374,348,2
483,0.3,0.4666666666666667,29.083333333333332,12/31/2017,20,17,4,ClevelandCle,224,272,15,58,28,24,Win,124,102,3,6,2,PittsburghPit,52,348,374,2
484,0.3333333333333333,0.18181818181818182,30.083333333333332,12/31/2017,16,12,6,PhiladelphiaPhi,172,149,64,63,6,0,Win,129,70,1,3,2,DallasDal,6,301,219,1
485,0.18181818181818182,0.3333333333333333,29.916666666666668,12/31/2017,12,16,-6,DallasDal,149,172,49,55,0,6,Loss,70,129,3,1,1,PhiladelphiaPhi,6,219,301,2
486,0.2857142857142857,0.3333333333333333,31.783333333333335,12/31/2017,17,18,-24,DetroitDet,153,305,68,63,11,35,Loss,103,51,4,2,0,Green BayGB,46,256,356,4
487,0.3333333333333333,0.2857142857142857,28.216666666666665,12/31/2017,18,17,24,Green BayGB,305,153,62,54,35,11,Win,51,103,2,4,4,DetroitDet,46,356,256,0
488,0.45454545454545453,0.46153846153846156,28.783333333333335,12/31/2017,15,20,-9,IndianapolisInd,124,104,34,53,13,22,Loss,85,146,2,1,0,HoustonHou,35,209,250,1
489,0.46153846153846156,0.45454545454545453,31.216666666666665,12/31/2017,20,15,9,HoustonHou,104,124,20,62,22,13,Win,146,85,1,2,1,IndianapolisInd,35,250,209,0
490,0.0,0.26666666666666666,25.183333333333334,12/31/2017,14,28,-20,New EnglandNE,207,183,84,59,6,26,Loss,40,147,4,2,0,NY JetsNYJ,32,247,330,0
491,0.26666666666666666,0.0,34.81666666666667,12/31/2017,28,14,20,NY JetsNYJ,183,207,49,80,26,6,Win,147,40,2,4,0,New EnglandNE,32,330,247,0
492,0.07692307692307693,0.25,28.116666666666667,12/31/2017,10,17,-8,NY GiantsNYG,136,121,35,56,10,18,Loss,61,260,3,2,1,WashingtonWas,28,197,381,3
493,0.25,0.07692307692307693,31.883333333333333,12/31/2017,17,10,8,WashingtonWas,121,136,25,74,18,10,Win,260,61,2,3,3,NY GiantsNYG,28,381,197,1
494,0.2857142857142857,0.08333333333333333,32.266666666666666,12/31/2017,19,13,2,SeattleSea,143,195,25,68,26,24,Win,116,101,1,3,0,ArizonaAri,50,259,296,1
495,0.08333333333333333,0.2857142857142857,27.733333333333334,12/31/2017,13,19,-2,ArizonaAri,195,143,100,54,24,26,Loss,101,116,3,1,1,SeattleSea,50,296,259,0
496,0.3333333333333333,0.375,25.3,12/31/2017,15,20,-12,AtlantaAtl,161,311,35,60,10,22,Loss,87,60,2,1,0,CarolinaCar,32,248,371,3
497,0.375,0.3333333333333333,34.7,12/31/2017,20,15,12,CarolinaCar,311,161,60,72,22,10,Win,60,87,1,2,3,AtlantaAtl,32,371,248,0
498,0.3333333333333333,0.29411764705882354,28.65,12/31/2017,22,19,4,BaltimoreBal,213,194,60,75,31,27,Win,146,118,1,1,1,CincinnatiCin,58,359,312,1
499,0.29411764705882354,0.3333333333333333,31.35,12/31/2017,19,22,-4,CincinnatiCin,194,213,47,74,27,31,Loss,118,146,1,1,1,BaltimoreBal,58,312,359,1
500,0.4166666666666667,0.38461538461538464,31.066666666666666,12/31/2017,23,21,6,MiamiMia,186,263,45,63,22,16,Win,126,93,4,1,1,BuffaloBuf,38,312,356,0
501,0.38461538461538464,0.4166666666666667,28.933333333333334,12/31/2017,21,23,-6,BuffaloBuf,263,186,145,67,16,22,Loss,93,126,1,4,0,MiamiMia,38,356,312,1
502,0.36363636363636365,0.4166666666666667,29.05,12/31/2017,23,22,3,DenverDen,269,226,40,65,27,24,Win,110,110,2,5,3,Kansas CityKC,51,379,336,2
503,0.4166666666666667,0.36363636363636365,30.95,12/31/2017,22,23,-3,Kansas CityKC,226,269,30,65,24,27,Loss,110,110,5,2,2,DenverDen,51,336,379,3
504,0.375,0.1875,26.55,12/31/2017,13,11,-5,TennesseeTen,146,116,41,60,10,15,Loss,83,116,2,3,1,JacksonvilleJax,25,229,232,4
505,0.1875,0.375,33.45,12/31/2017,11,13,5,JacksonvilleJax,116,146,15,63,15,10,Win,116,83,3,2,4,TennesseeTen,25,232,229,1
506,0.36363636363636365,0.5384615384615384,26.666666666666668,12/31/2017,14,26,-20,LA ChargersLAC,231,380,85,53,10,30,Loss,105,115,2,1,0,OaklandOak,40,336,495,2
507,0.5384615384615384,0.36363636363636365,33.333333333333336,12/31/2017,26,14,20,OaklandOak,380,231,65,68,30,10,Win,115,105,1,2,2,LA ChargersLAC,40,495,336,0
508,0.5,0.3333333333333333,29.15,12/31/2017,25,15,21,LA RamsLA,292,149,23,63,34,13,Win,169,102,0,3,2,San FranciscoSF,47,461,251,3
509,0.3333333333333333,0.5,30.85,12/31/2017,15,25,-21,San FranciscoSF,149,292,46,63,13,34,Loss,102,169,3,0,3,LA RamsLA,47,251,461,2
510,0.5,0.7222222222222222,28.45,12/31/2017,18,28,-7,Tampa BayTB,231,345,38,58,24,31,Loss,92,110,2,2,3,New OrleansNO,55,323,455,1
511,0.7222222222222222,0.5,31.55,12/31/2017,28,18,7,New OrleansNO,345,231,15,81,31,24,Win,110,92,2,2,1,Tampa BayTB,55,455,323,3
512,0.6153846153846154,0.36363636363636365,32.46666666666667,01/06/2018,23,19,1,Kansas CityKC,195,256,50,64,22,21,Win,202,69,2,4,0,TennesseeTen,43,397,325,2
513,0.36363636363636365,0.6153846153846154,27.533333333333335,01/06/2018,19,23,-1,TennesseeTen,256,195,68,53,21,22,Loss,69,202,4,2,2,Kansas CityKC,43,325,397,0
514,0.3333333333333333,0.35714285714285715,37.583333333333336,01/06/2018,20,19,13,LA RamsLA,198,246,51,72,26,13,Win,124,115,3,3,2,AtlantaAtl,39,322,361,0
515,0.35714285714285715,0.3333333333333333,22.416666666666668,01/06/2018,19,20,-13,AtlantaAtl,246,198,45,64,13,26,Loss,115,124,3,3,0,LA RamsLA,39,361,322,2
516,0.3888888888888889,0.16666666666666666,32.61666666666667,01/07/2018,20,15,-7,JacksonvilleJax,133,75,52,74,3,10,Loss,130,155,2,2,0,BuffaloBuf,13,263,230,2
517,0.16666666666666666,0.3888888888888889,27.383333333333333,01/07/2018,15,20,7,BuffaloBuf,75,133,34,59,10,3,Win,155,130,2,2,2,JacksonvilleJax,13,230,263,0
518,0.47058823529411764,0.25,33.81666666666667,01/07/2018,24,21,-5,New OrleansNO,306,369,18,71,26,31,Loss,107,41,4,1,1,CarolinaCar,57,413,410,0
519,0.25,0.47058823529411764,26.183333333333334,01/07/2018,21,24,5,CarolinaCar,369,306,96,56,31,26,Win,41,107,1,4,0,New OrleansNO,57,410,413,1
520,0.3076923076923077,0.46153846153846156,27.9,01/13/2018,19,22,-5,PhiladelphiaPhi,195,238,73,59,10,15,Loss,86,96,3,1,2,AtlantaAtl,25,281,334,0
521,0.46153846153846156,0.3076923076923077,32.1,01/13/2018,22,19,5,AtlantaAtl,238,195,24,63,15,10,Win,96,86,1,3,0,PhiladelphiaPhi,25,334,281,2
522,0.3333333333333333,0.6470588235294118,27.066666666666666,01/13/2018,15,31,-21,New EnglandNE,202,337,62,61,14,35,Loss,65,101,8,0,0,TennesseeTen,49,267,438,0
523,0.6470588235294118,0.3333333333333333,32.93333333333333,01/13/2018,31,15,21,TennesseeTen,337,202,37,80,35,14,Win,101,65,0,8,0,New EnglandNE,49,438,267,0
524,0.5714285714285714,0.4375,28.833333333333332,01/14/2018,22,28,3,PittsburghPit,214,462,40,61,45,42,Win,164,83,0,2,2,JacksonvilleJax,87,378,545,0
525,0.4375,0.5714285714285714,31.166666666666668,01/14/2018,28,22,-3,JacksonvilleJax,462,214,25,78,42,45,Loss,83,164,2,0,0,PittsburghPit,87,545,378,2
526,0.2222222222222222,0.5882352941176471,26.716666666666665,01/14/2018,23,24,-5,MinnesotaMin,278,308,97,67,24,29,Loss,80,95,2,2,1,New OrleansNO,53,358,403,2
527,0.5882352941176471,0.2222222222222222,33.28333333333333,01/14/2018,24,23,5,New OrleansNO,308,278,30,71,29,24,Win,95,80,2,2,2,MinnesotaMin,53,403,358,1
528,0.4,0.25,35.13333333333333,01/21/2018,22,22,-4,New EnglandNE,273,298,98,71,20,24,Loss,101,46,3,3,1,JacksonvilleJax,44,374,344,0
529,0.25,0.4,24.866666666666667,01/21/2018,22,22,4,JacksonvilleJax,298,273,10,61,24,20,Win,46,101,3,3,0,New EnglandNE,44,344,374,1
530,0.46153846153846156,0.7142857142857143,25.933333333333334,01/21/2018,22,27,-31,PhiladelphiaPhi,263,346,19,67,7,38,Loss,70,110,1,1,0,MinnesotaMin,45,333,456,3
531,0.7142857142857143,0.46153846153846156,34.06666666666667,01/21/2018,27,22,31,MinnesotaMin,346,263,55,64,38,7,Win,110,70,1,1,3,PhiladelphiaPhi,45,456,333,0
532,0.625,0.5,34.06666666666667,02/04/2018,25,29,8,New EnglandNE,374,500,35,71,41,33,Win,164,113,0,1,1,PhiladelphiaPhi,74,538,613,1
533,0.5,0.625,25.933333333333334,02/04/2018,29,25,-8,PhiladelphiaPhi,500,374,5,72,33,41,Loss,113,164,1,0,1,New EnglandNE,74,613,538,1
