3d%,3d%_allowed,TOP,date,season,week,first_downs,first_downs_allowed,ha,margin,opp,pass_yards,pass_yards_allowed,penalty_yards,plays,points,points_allowed,result,rush_yards,rush_yards_allowed,sacked,sacks,takeaways,team,total_points,total_yards,total_yards_allowed,turnovers
0.307692308,0.285714286,28.35,9/10/2009,,,18,19,away,-3,PIT,234,321,28,61,0,3,Loss,86,36,1,4,3,TEN,3,320,357,2
0.285714286,0.307692308,36.18333333,9/10/2009,,,19,18,home,3,TEN,321,234,60,70,3,0,Win,36,86,4,1,2,PIT,3,357,320,3
0.363636364,0.4,29.11666667,9/13/2009,,,16,19,away,-12,ATL,163,213,27,56,7,19,Loss,96,68,4,2,0,MIA,26,259,281,4
0.4,0.363636364,30.88333333,9/13/2009,,,19,16,home,12,MIA,213,163,35,65,19,7,Win,68,96,2,4,4,ATL,26,281,259,0
0.25,0.333333333,26.55,9/13/2009,,,10,16,away,5,CIN,227,221,39,51,12,7,Win,75,86,3,3,2,DEN,19,302,307,0
0.333333333,0.25,33.45,9/13/2009,,,16,10,home,-5,DEN,221,227,27,63,7,12,Loss,86,75,3,3,0,CIN,19,307,302,2
0.428571429,0.25,33.36666667,9/13/2009,,,19,17,away,14,CLE,85,179,38,63,34,20,Win,225,89,4,5,2,MIN,54,310,268,0
0.25,0.428571429,26.63333333,9/13/2009,,,17,19,home,-14,MIN,179,85,66,60,20,34,Loss,89,225,5,4,0,CLE,54,268,310,2
0.4,0.571428571,26.06666667,9/13/2009,,,12,21,away,-2,IND,114,294,24,55,12,14,Loss,114,71,1,1,2,JAX,26,228,365,0
0.571428571,0.4,33.93333333,9/13/2009,,,21,12,home,2,JAX,294,114,17,70,14,12,Win,71,114,1,1,0,IND,26,365,228,2
0.214285714,0.692307692,23.5,9/13/2009,,,14,28,away,-18,NOS,198,358,80,58,27,45,Loss,33,157,1,0,3,DET,72,231,515,3
0.692307692,0.214285714,36.5,9/13/2009,,,28,14,home,18,DET,358,198,36,69,45,27,Win,157,33,0,1,3,NOS,72,515,231,3
0.3,0.384615385,26.46666667,9/13/2009,,,18,26,away,13,TBB,344,276,41,52,34,21,Win,118,174,1,0,0,DAL,55,462,450,0
0.384615385,0.3,33.53333333,9/13/2009,,,26,18,home,-13,DAL,276,344,20,73,21,34,Loss,174,118,0,1,0,TBB,55,450,462,0
0.384615385,0.1875,31.61666667,9/13/2009,,,17,14,away,28,CAR,82,83,76,63,38,10,Win,185,86,2,5,7,PHI,48,267,169,2
0.1875,0.384615385,28.38333333,9/13/2009,,,14,17,home,-28,PHI,83,82,30,69,10,38,Loss,86,185,5,2,2,CAR,48,169,267,7
0.2,0.588235294,20.18333333,9/13/2009,,,11,32,away,-14,BAL,159,303,15,44,24,38,Loss,29,198,3,1,1,KCC,62,188,501,0
0.588235294,0.2,39.81666667,9/13/2009,,,32,11,home,14,KCC,303,159,65,85,38,24,Win,198,29,1,3,0,BAL,62,501,188,1
0.555555556,0.3,38.76666667,9/13/2009,,,22,11,away,17,HOU,272,145,80,73,24,7,Win,190,38,0,2,2,NYJ,31,462,183,1
0.3,0.555555556,21.23333333,9/13/2009,,,11,22,home,-17,NYJ,145,272,37,48,7,24,Loss,38,190,2,0,1,HOU,31,183,462,2
0.416666667,0.461538462,23.86666667,9/13/2009,,,15,18,away,-6,NYG,187,248,32,50,17,23,Loss,85,103,3,1,2,WAS,40,272,351,2
0.461538462,0.416666667,36.13333333,9/13/2009,,,18,15,home,6,WAS,248,187,30,61,23,17,Win,103,85,1,3,2,NYG,40,351,272,2
0.388888889,0.285714286,31.61666667,9/13/2009,,,13,17,away,4,ARI,182,259,31,60,20,16,Win,21,40,4,3,2,SFO,36,203,299,1
0.285714286,0.388888889,28.38333333,9/13/2009,,,17,13,home,-4,SFO,259,182,82,64,16,20,Loss,40,21,3,4,1,ARI,36,299,203,2
0.166666667,0.533333333,27.55,9/13/2009,,,13,25,away,-28,SEA,170,279,85,57,0,28,Loss,77,167,3,0,3,LAR,28,247,446,1
0.533333333,0.166666667,32.45,9/13/2009,,,25,13,home,28,LAR,279,170,25,70,28,0,Win,167,77,0,3,1,SEA,28,446,247,3
0.266666667,0.285714286,33.05,9/13/2009,,,18,12,away,-6,GBP,266,150,25,69,15,21,Loss,86,76,2,4,0,CHI,36,352,226,4
0.285714286,0.266666667,26.95,9/13/2009,,,12,18,home,6,CHI,150,266,45,54,21,15,Win,76,86,4,2,4,GBP,36,226,352,0
0.4,0.625,22.86666667,9/14/2009,,,17,28,away,-1,NEP,186,368,71,48,24,25,Loss,90,73,4,1,1,BUF,49,276,441,1
0.625,0.4,37.13333333,9/14/2009,,,28,17,home,1,BUF,368,186,55,77,25,24,Win,73,90,1,4,1,NEP,49,441,276,1
0.416666667,0.5,28.38333333,9/14/2009,,,19,19,away,4,OAK,240,218,60,62,24,20,Win,77,148,3,1,3,LAC,44,317,366,2
0.5,0.416666667,31.61666667,9/14/2009,,,19,19,home,-4,LAC,218,240,40,65,20,24,Loss,148,77,1,3,2,OAK,44,366,317,3
0.583333333,0.5,28.46666667,9/20/2009,,,24,23,away,-8,ATL,296,220,35,67,20,28,Loss,144,151,1,0,2,CAR,48,440,371,2
0.5,0.583333333,31.53333333,9/20/2009,,,23,24,home,8,CAR,220,296,40,64,28,20,Win,151,144,0,1,2,ATL,48,371,440,2
0.272727273,0.384615385,29.58333333,9/20/2009,,,18,17,away,14,DET,153,136,43,56,27,13,Win,112,129,3,2,3,MIN,40,265,265,1
0.384615385,0.272727273,30.41666667,9/20/2009,,,17,18,home,-14,MIN,136,153,45,66,13,27,Loss,129,112,2,3,1,DET,40,265,265,3
0.642857143,0.461538462,33.8,9/20/2009,,,19,22,away,7,GBP,168,222,100,59,31,24,Win,151,89,2,6,1,CIN,55,319,311,2
0.461538462,0.642857143,26.2,9/20/2009,,,22,19,home,-7,CIN,222,168,76,63,24,31,Loss,89,151,6,2,2,GBP,55,311,319,1
0.3125,0.454545455,34.05,9/20/2009,,,19,19,away,3,TEN,357,209,40,68,34,31,Win,63,240,0,2,2,HOU,65,420,449,0
0.454545455,0.3125,25.95,9/20/2009,,,19,19,home,-3,HOU,209,357,64,60,31,34,Loss,240,63,2,0,0,TEN,65,449,420,2
0.230769231,0.333333333,21.35,9/20/2009,,,11,25,away,3,KCC,99,236,45,51,13,10,Win,67,173,2,2,2,OAK,23,166,409,0
0.333333333,0.230769231,38.65,9/20/2009,,,25,11,home,-3,OAK,236,99,70,79,10,13,Loss,173,67,2,2,0,KCC,23,409,166,2
0.333333333,0.272727273,30.83333333,9/20/2009,,,18,14,away,-7,NYJ,216,137,89,67,9,16,Loss,83,117,0,2,1,NEP,25,299,254,1
0.272727273,0.333333333,29.16666667,9/20/2009,,,14,18,home,7,NEP,137,216,55,55,16,9,Win,117,83,2,0,1,NYJ,25,254,299,1
0.461538462,0.4375,30.43333333,9/20/2009,,,23,23,away,26,PHI,288,384,13,65,48,22,Win,133,79,2,1,4,NOS,70,421,463,1
0.4375,0.461538462,29.56666667,9/20/2009,,,23,23,home,-26,NOS,384,288,45,75,22,48,Loss,79,133,1,2,1,PHI,70,463,421,4
0.5,0.466666667,25.11666667,9/20/2009,,,14,21,away,-2,WAS,119,237,45,50,7,9,Loss,126,125,1,1,1,LAR,16,245,362,1
0.466666667,0.5,34.88333333,9/20/2009,,,21,14,home,2,LAR,237,119,35,70,9,7,Win,125,126,1,1,1,WAS,16,362,245,1
0.222222222,0.375,31.35,9/20/2009,,,22,18,away,14,JAX,265,275,58,60,31,17,Win,118,92,0,4,3,ARI,48,383,367,2
0.375,0.222222222,28.65,9/20/2009,,,18,22,home,-14,ARI,275,265,50,67,17,31,Loss,92,118,4,0,2,JAX,48,367,383,3
0.285714286,0.333333333,25.48333333,9/20/2009,,,19,16,away,-13,SFO,217,123,45,65,10,23,Loss,66,256,1,4,0,SEA,33,283,379,1
0.333333333,0.285714286,34.51666667,9/20/2009,,,16,19,home,13,SEA,123,217,54,60,23,10,Win,256,66,4,1,1,SFO,33,379,283,0
0.25,0.333333333,30.45,9/20/2009,,,19,25,away,-13,BUF,296,220,112,71,20,33,Loss,57,218,2,2,2,TBB,53,353,438,2
0.333333333,0.25,29.55,9/20/2009,,,25,19,home,13,TBB,220,296,55,68,33,20,Win,218,57,2,2,2,BUF,53,438,353,2
0.5,0.5,30.43333333,9/20/2009,,,21,17,away,-3,CHI,203,231,52,59,14,17,Loss,105,44,2,2,0,PIT,31,308,275,2
0.5,0.5,29.56666667,9/20/2009,,,17,21,home,3,PIT,231,203,80,57,17,14,Win,44,105,2,2,2,CHI,31,275,308,0
0.363636364,0.4375,28.68333333,9/20/2009,,,22,20,away,5,LAC,181,421,32,60,31,26,Win,130,53,1,2,2,BAL,57,311,474,1
0.4375,0.363636364,31.31666667,9/20/2009,,,20,22,home,-5,BAL,421,181,85,68,26,31,Loss,53,130,2,1,1,LAC,57,474,311,2
0.214285714,0.533333333,27.26666667,9/20/2009,,,11,25,away,-21,DEN,146,263,43,56,6,27,Loss,54,186,4,0,1,CLE,33,200,449,3
0.533333333,0.214285714,32.73333333,9/20/2009,,,25,11,home,21,CLE,263,146,50,74,27,6,Win,186,54,0,4,3,DEN,33,449,200,1
0.4,0.545454545,34.81666667,9/20/2009,,,19,23,away,2,DAL,330,127,40,64,33,31,Win,97,251,0,0,4,NYG,64,427,378,0
0.545454545,0.4,25.18333333,9/20/2009,,,23,19,home,-2,NYG,127,330,50,58,31,33,Loss,251,97,0,0,0,DAL,64,378,427,4
0.428571429,0.714285714,14.88333333,9/21/2009,,,14,27,away,4,MIA,295,164,20,35,27,23,Win,61,239,1,2,1,IND,50,356,403,0
0.714285714,0.428571429,45.11666667,9/21/2009,,,27,14,home,-4,IND,164,295,20,84,23,27,Loss,239,61,2,1,0,MIA,50,403,356,1
0.2,0.555555556,23.2,9/27/2009,,,22,23,away,-5,DET,325,227,97,57,14,19,Loss,65,154,2,2,0,WAS,33,390,381,1
0.555555556,0.2,36.8,9/27/2009,,,23,22,home,5,WAS,227,325,58,74,19,14,Win,154,65,2,2,1,DET,33,381,390,0
0,0.461538462,29.41666667,9/27/2009,,,11,21,away,-20,PHI,97,327,90,51,14,34,Loss,99,93,3,0,1,KCC,48,196,420,1
0.461538462,0,30.58333333,9/27/2009,,,21,11,home,20,KCC,327,97,20,63,34,14,Win,93,99,0,3,1,PHI,48,420,196,1
0.222222222,0.285714286,30.31666667,9/27/2009,,,24,22,away,19,LAR,250,187,51,62,36,17,Win,152,149,2,1,3,GBP,53,402,336,0
0.285714286,0.222222222,29.68333333,9/27/2009,,,22,24,home,-19,GBP,187,250,40,69,17,36,Loss,149,152,1,2,0,LAR,53,336,402,3
0,0.5,27.85,9/27/2009,,,13,19,away,-3,MIN,188,283,60,52,24,27,Loss,58,94,1,2,1,SFO,51,246,377,1
0.5,0,32.15,9/27/2009,,,19,13,home,3,SFO,283,188,52,75,27,24,Win,94,58,2,1,1,MIN,51,377,246,1
0.222222222,0.444444444,20.18333333,9/27/2009,,,13,28,away,-16,NEP,199,277,54,45,10,26,Loss,58,168,0,0,0,ATL,36,257,445,1
0.444444444,0.222222222,39.81666667,9/27/2009,,,28,13,home,16,ATL,277,199,10,81,26,10,Win,168,58,0,0,1,NEP,36,445,257,0
0.625,0,43.63333333,9/27/2009,,,27,5,away,24,TBB,171,58,60,76,24,0,Win,226,28,0,0,1,NYG,24,397,86,0
0,0.625,16.36666667,9/27/2009,,,5,27,home,-24,NYG,58,171,25,36,0,24,Loss,28,226,0,0,0,TBB,24,86,397,1
0.25,0.363636364,28.7,9/27/2009,,,11,28,away,-31,BAL,115,337,46,52,3,34,Loss,71,142,2,1,1,CLE,37,186,479,4
0.363636364,0.25,31.3,9/27/2009,,,28,11,home,31,CLE,337,115,84,66,34,3,Win,142,71,1,2,4,BAL,37,479,186,1
0.454545455,0.4,30.86666667,9/27/2009,,,24,23,away,7,HOU,214,286,40,62,31,24,Win,185,111,0,2,2,JAX,55,399,397,1
0.4,0.454545455,29.13333333,9/27/2009,,,23,24,home,-7,JAX,286,214,60,59,24,31,Loss,111,185,2,0,1,HOU,55,397,399,2
0.285714286,0.25,27.36666667,9/27/2009,,,17,13,away,-7,NYJ,159,146,15,69,17,24,Loss,127,83,2,3,2,TEN,41,286,229,4
0.25,0.285714286,32.63333333,9/27/2009,,,13,17,home,7,TEN,146,159,25,64,24,17,Win,83,127,3,2,4,NYJ,41,229,286,2
0.333333333,0.411764706,30.4,9/27/2009,,,14,19,away,6,SEA,233,243,60,57,25,19,Win,85,103,2,3,2,CHI,44,318,346,2
0.411764706,0.333333333,29.6,9/27/2009,,,19,14,home,-6,CHI,243,233,45,75,19,25,Loss,103,85,3,2,2,SEA,44,346,318,2
0.333333333,0.142857143,33.56666667,9/27/2009,,,21,13,away,20,BUF,156,154,97,69,27,7,Win,222,89,2,4,2,NOS,34,378,243,1
0.142857143,0.333333333,26.43333333,9/27/2009,,,13,21,home,-20,NOS,154,156,116,61,7,27,Loss,89,222,4,2,1,BUF,34,243,378,2
0.5,0.25,34.7,9/27/2009,,,17,19,away,-3,CIN,271,173,51,60,20,23,Loss,102,100,1,2,0,PIT,43,373,273,1
0.25,0.5,25.3,9/27/2009,,,19,17,home,3,PIT,173,271,30,58,23,20,Win,100,102,2,1,1,CIN,43,273,373,0
0.416666667,0.3,36.25,9/27/2009,,,21,9,away,20,OAK,157,42,30,68,23,3,Win,215,95,0,3,3,DEN,26,372,137,1
0.3,0.416666667,23.75,9/27/2009,,,9,21,home,-20,DEN,42,157,53,47,3,23,Loss,95,215,3,0,1,OAK,26,137,372,3
0.416666667,0.5,32.45,9/27/2009,,,19,19,away,-10,LAC,140,286,39,63,13,23,Loss,149,69,1,2,1,MIA,36,289,355,2
0.5,0.416666667,27.55,9/27/2009,,,19,19,home,10,MIA,286,140,20,63,23,13,Win,69,149,2,1,2,LAC,36,355,289,1
0.272727273,0.285714286,31.7,9/27/2009,,,22,21,away,21,ARI,379,299,69,66,31,10,Win,126,24,0,4,3,IND,41,505,323,1
0.285714286,0.272727273,28.3,9/27/2009,,,21,22,home,-21,IND,299,379,35,70,10,31,Loss,24,126,4,0,1,ARI,41,323,505,3
0.125,0.384615385,22.93333333,9/28/2009,,,15,24,away,-14,DAL,198,237,60,52,7,21,Loss,73,212,3,2,0,CAR,28,271,449,3
0.384615385,0.125,37.06666667,9/28/2009,,,24,15,home,14,CAR,237,198,80,67,21,7,Win,212,73,2,3,3,DAL,28,449,271,0
0.411764706,0.2,36.5,10/4/2009,,,25,14,away,-24,CHI,308,125,51,78,24,48,Loss,90,151,5,2,0,DET,72,398,276,2
0.2,0.411764706,23.5,10/4/2009,,,14,25,home,24,DET,125,308,36,50,48,24,Win,151,90,2,5,2,CHI,72,276,398,0
0.277777778,0.315789474,36.01666667,10/4/2009,,,21,22,away,3,CLE,221,249,46,76,3,0,Win,154,146,2,2,2,CIN,3,375,395,2
0.315789474,0.277777778,38.91666667,10/4/2009,,,22,21,home,-3,CIN,249,221,44,83,0,3,Loss,146,154,2,2,2,CLE,3,395,375,2
0.4,0.615384615,31.1,10/4/2009,,,20,24,away,-17,IND,230,353,45,69,17,34,Loss,49,78,5,0,1,SEA,51,279,431,2
0.615384615,0.4,28.9,10/4/2009,,,24,20,home,17,SEA,353,230,48,63,34,17,Win,78,49,0,5,2,IND,51,431,279,1
0.4,0.133333333,31.25,10/4/2009,,,21,15,away,11,KCC,273,88,54,71,27,16,Win,156,124,2,5,1,NYG,43,429,212,2
0.133333333,0.4,28.75,10/4/2009,,,15,21,home,-11,NYG,88,273,55,62,16,27,Loss,124,156,5,2,2,KCC,43,212,429,1
0.642857143,0.4,25.06666667,10/4/2009,,,24,25,away,-6,NEP,247,234,85,66,21,27,Loss,116,85,2,3,1,BAL,48,363,319,2
0.4,0.642857143,34.93333333,10/4/2009,,,25,24,home,6,BAL,234,247,41,65,27,21,Win,85,116,3,2,2,NEP,48,319,363,1
0.153846154,0.285714286,31.06666667,10/4/2009,,,12,14,away,-3,WAS,100,152,40,55,13,16,Loss,129,125,3,3,4,TBB,29,229,277,2
0.285714286,0.153846154,28.93333333,10/4/2009,,,14,12,home,3,TBB,152,100,40,60,16,13,Win,125,129,3,3,2,WAS,29,277,229,4
0.5,0.461538462,25.88333333,10/4/2009,,,19,27,away,-20,JAX,284,305,68,67,17,37,Loss,95,137,0,2,1,TEN,54,379,442,3
0.461538462,0.5,34.11666667,10/4/2009,,,27,19,home,20,TEN,305,284,30,69,37,17,Win,137,95,2,0,3,JAX,54,442,379,1
0.133333333,0.1875,25.78333333,10/4/2009,,,8,16,away,-23,HOU,120,209,60,57,6,29,Loss,45,120,3,4,2,OAK,35,165,329,3
0.1875,0.133333333,34.21666667,10/4/2009,,,16,8,home,23,OAK,209,120,5,67,29,6,Win,120,45,4,3,3,HOU,35,329,165,2
0.25,0.307692308,27.35,10/4/2009,,,14,18,away,-14,NOS,112,190,21,58,10,24,Loss,132,153,4,0,1,NYJ,34,244,343,4
0.307692308,0.25,32.65,10/4/2009,,,18,14,home,14,NYJ,190,112,70,64,24,10,Win,153,132,0,4,4,NOS,34,343,244,1
0.090909091,0.529411765,22.85,10/4/2009,,,10,25,away,-28,MIA,160,86,19,49,10,38,Loss,46,250,6,6,0,BUF,48,206,336,3
0.529411765,0.090909091,37.15,10/4/2009,,,25,10,home,28,BUF,86,160,45,73,38,10,Win,250,46,6,6,3,MIA,48,336,206,0
0.214285714,0.2,33.11666667,10/4/2009,,,20,18,away,-7,DEN,241,221,70,72,10,17,Loss,74,116,5,3,1,DAL,27,315,337,2
0.2,0.214285714,26.88333333,10/4/2009,,,18,20,home,7,DAL,221,241,81,57,17,10,Win,116,74,3,5,2,DEN,27,337,315,1
0.3125,0.307692308,29.8,10/4/2009,,,9,13,away,-35,SFO,82,132,73,57,0,35,Loss,95,96,5,4,0,LAR,35,177,228,3
0.307692308,0.3125,30.2,10/4/2009,,,13,9,home,35,LAR,132,82,33,57,35,0,Win,96,95,4,5,3,SFO,35,228,177,0
0.333333333,0.666666667,19.66666667,10/4/2009,,,17,32,away,-10,PIT,235,320,20,47,28,38,Loss,16,177,3,3,1,LAC,66,251,497,1
0.666666667,0.333333333,40.33333333,10/4/2009,,,32,17,home,10,LAC,320,235,59,73,38,28,Win,177,16,3,3,1,PIT,66,497,251,1
0.538461538,0.571428571,28.26666667,10/5/2009,,,19,22,away,-7,MIN,342,271,57,62,23,30,Loss,82,63,8,0,1,GBP,53,424,334,2
0.571428571,0.538461538,31.73333333,10/5/2009,,,22,19,home,7,GBP,271,342,10,62,30,23,Win,63,82,0,8,2,MIN,53,334,424,1
0.25,0.352941176,28.43333333,10/11/2009,,,9,13,away,3,BUF,22,143,29,59,6,3,Win,171,145,1,2,3,CLE,9,193,288,1
0.352941176,0.25,31.56666667,10/11/2009,,,13,9,home,-3,CLE,143,22,75,68,3,6,Loss,145,171,2,1,1,BUF,9,288,193,3
0.375,0.611111111,27.41666667,10/11/2009,,,18,21,away,8,DET,262,225,59,54,28,20,Win,82,110,3,7,1,PIT,48,344,335,1
0.611111111,0.375,32.58333333,10/11/2009,,,21,18,home,-8,PIT,225,262,66,69,20,28,Loss,110,82,7,3,1,DET,48,335,344,1
0.416666667,0.294117647,32,10/11/2009,,,20,20,away,6,KCC,348,232,90,61,6,0,Win,150,72,1,4,0,DAL,6,498,304,2
0.294117647,0.416666667,34.63333333,10/11/2009,,,20,20,home,-6,DAL,232,348,50,74,0,6,Loss,72,150,4,1,2,KCC,6,304,498,0
0.636363636,0.416666667,27.35,10/11/2009,,,21,27,away,28,LAR,288,278,44,53,38,10,Win,89,122,2,2,4,MIN,48,377,400,1
0.416666667,0.636363636,32.65,10/11/2009,,,27,21,home,-28,MIN,278,288,82,70,10,38,Loss,122,89,2,2,1,LAR,48,400,377,4
0.090909091,0.5,23.93333333,10/11/2009,,,7,27,away,-37,NYG,64,263,67,44,7,44,Loss,60,220,6,0,1,OAK,51,124,483,3
0.5,0.090909091,36.06666667,10/11/2009,,,27,7,home,37,OAK,263,64,37,65,44,7,Win,220,60,0,6,3,NYG,51,483,124,1
0.5,0.4,34.55,10/11/2009,,,22,16,away,-19,PHI,218,249,30,75,14,33,Loss,85,76,3,3,0,TBB,47,303,325,3
0.4,0.5,25.45,10/11/2009,,,16,22,home,19,TBB,249,218,111,48,33,14,Win,76,85,3,3,3,PHI,47,325,303,0
0.222222222,0.333333333,28.71666667,10/11/2009,,,15,16,away,-3,CAR,124,162,20,52,17,20,Loss,74,86,5,3,2,WAS,37,198,248,1
0.333333333,0.222222222,31.28333333,10/11/2009,,,16,15,home,3,WAS,162,124,27,60,20,17,Win,86,74,3,5,1,CAR,37,248,198,2
0.384615385,0.272727273,34.31666667,10/11/2009,,,22,12,away,3,BAL,261,175,39,66,17,14,Win,142,82,1,2,2,CIN,31,403,257,2
0.272727273,0.384615385,25.68333333,10/11/2009,,,12,22,home,-3,CIN,175,261,76,51,14,17,Loss,82,142,2,1,2,BAL,31,257,403,2
0.571428571,0.285714286,36.48333333,10/11/2009,,,28,13,away,35,SFO,329,179,90,72,45,10,Win,148,100,0,3,3,ATL,55,477,279,2
0.285714286,0.571428571,23.51666667,10/11/2009,,,13,28,home,-35,ATL,179,329,92,58,10,45,Loss,100,148,3,0,2,SFO,55,279,477,3
0.153846154,0.428571429,25.26666667,10/11/2009,,,10,24,away,-41,SEA,161,236,73,52,0,41,Loss,38,143,5,1,0,JAX,41,199,379,2
0.428571429,0.153846154,34.73333333,10/11/2009,,,24,10,home,41,JAX,236,161,10,71,41,0,Win,143,38,1,5,2,SEA,41,379,199,0
0.307692308,0.222222222,33.41666667,10/11/2009,,,23,19,away,-7,ARI,371,296,53,71,21,28,Loss,45,44,0,1,1,HOU,49,416,340,1
0.222222222,0.307692308,26.58333333,10/11/2009,,,19,23,home,7,HOU,296,371,40,55,28,21,Win,44,45,1,0,1,ARI,49,340,416,1
0.357142857,0.428571429,28.36666667,10/11/2009,,,18,27,away,-3,DEN,209,321,46,61,0,3,Loss,96,103,1,2,2,NEP,3,305,424,1
0.428571429,0.357142857,36.48333333,10/11/2009,,,27,18,home,3,NEP,321,209,20,75,3,0,Win,103,96,2,1,1,DEN,3,424,305,2
0.571428571,0.357142857,33.63333333,10/11/2009,,,23,12,away,22,TEN,309,155,48,67,31,9,Win,58,90,0,1,2,IND,40,367,245,2
0.357142857,0.571428571,26.36666667,10/11/2009,,,12,23,home,-22,IND,155,309,89,57,9,31,Loss,90,58,1,0,2,TEN,40,245,367,2
0.363636364,0.642857143,26.41666667,10/12/2009,,,20,23,away,-4,MIA,171,262,56,55,27,31,Loss,138,151,1,0,0,NYJ,58,309,413,0
0.642857143,0.363636364,33.58333333,10/12/2009,,,23,20,home,4,NYJ,262,171,112,64,31,27,Win,151,138,0,1,0,MIA,58,413,309,0
0.5,0.416666667,36.25,10/18/2009,,,26,14,away,11,CIN,385,250,60,73,28,17,Win,87,46,2,1,3,HOU,45,472,296,2
0.416666667,0.5,23.75,10/18/2009,,,14,26,home,-11,HOU,250,385,45,53,17,28,Loss,46,87,1,2,2,CIN,45,296,472,3
0,0.5,19.2,10/18/2009,,,10,23,away,-26,GBP,71,328,40,48,0,26,Loss,78,107,5,5,2,DET,26,149,435,3
0.5,0,40.8,10/18/2009,,,23,10,home,26,DET,328,71,130,72,26,0,Win,107,78,5,5,3,GBP,26,435,149,2
0.384615385,0.357142857,25.25,10/18/2009,,,20,19,away,-2,MIN,367,259,74,64,31,33,Loss,81,167,3,3,0,BAL,64,448,426,0
0.357142857,0.384615385,34.75,10/18/2009,,,19,20,home,2,BAL,259,367,15,63,33,31,Win,167,81,3,3,0,MIN,64,426,448,0
0.3,0.538461538,23.88333333,10/18/2009,,,17,28,away,-21,NOS,241,369,110,57,27,48,Loss,84,124,2,0,0,NYG,75,325,493,2
0.538461538,0.3,36.11666667,10/18/2009,,,28,17,home,21,NYG,369,241,55,70,48,27,Win,124,84,0,2,2,NOS,75,493,325,0
0.571428571,0.545454545,32.35,10/18/2009,,,22,12,away,7,TBB,55,121,30,66,28,21,Win,267,124,1,4,2,CAR,49,322,245,3
0.545454545,0.571428571,27.65,10/18/2009,,,12,22,home,-7,CAR,121,55,40,46,21,28,Loss,124,267,4,1,3,TBB,49,245,322,2
0.235294118,0.142857143,37.16666667,10/18/2009,,,16,7,away,8,WAS,158,147,30,72,14,6,Win,110,118,5,3,2,KCC,20,268,265,0
0.142857143,0.235294118,22.83333333,10/18/2009,,,7,16,home,-8,KCC,147,158,63,53,6,14,Loss,118,110,3,5,0,WAS,20,265,268,2
0.333333333,0.6875,24.8,10/18/2009,,,13,33,away,-3,JAX,207,326,52,53,0,3,Loss,55,166,1,3,3,LAR,3,262,492,1
0.6875,0.333333333,42.2,10/18/2009,,,33,13,home,3,LAR,326,207,15,84,3,0,Win,166,55,3,1,1,JAX,3,492,262,3
0.384615385,0.363636364,23.23333333,10/18/2009,,,12,28,away,-13,PIT,106,403,45,51,14,27,Loss,91,140,2,3,4,CLE,41,197,543,4
0.363636364,0.384615385,36.76666667,10/18/2009,,,28,12,home,13,CLE,403,106,30,74,27,14,Win,140,91,3,2,4,PIT,41,543,197,4
0.5,0,42.83333333,10/18/2009,,,21,7,away,24,SEA,282,114,76,71,27,3,Win,62,14,2,5,2,ARI,30,344,128,2
0,0.5,17.16666667,10/18/2009,,,7,21,home,-24,ARI,114,282,56,46,3,27,Loss,14,62,5,2,2,SEA,30,128,344,2
0.125,0.285714286,26.96666667,10/18/2009,,,14,18,away,-4,OAK,216,209,38,66,9,13,Loss,67,116,6,2,2,PHI,22,283,325,0
0.285714286,0.125,33.03333333,10/18/2009,,,18,14,home,4,PHI,209,216,23,65,13,9,Win,116,67,2,6,0,OAK,22,325,283,2
0.3125,0.2,39.05,10/18/2009,,,20,15,away,3,NYJ,154,96,64,73,3,0,Win,142,318,1,2,6,BUF,3,296,414,2
0.2,0.3125,33.21666667,10/18/2009,,,15,20,home,-3,BUF,96,154,96,72,0,3,Loss,318,142,2,1,2,NYJ,3,414,296,6
0.2,0.454545455,21,10/18/2009,,,9,32,away,-59,NEP,-7,426,55,50,0,59,Loss,193,193,0,2,0,TEN,59,186,619,5
0.454545455,0.2,39,10/18/2009,,,32,9,home,59,TEN,426,-7,40,77,59,0,Win,193,193,2,0,5,NEP,59,619,186,0
0.5625,0.416666667,33.9,10/18/2009,,,21,16,away,-7,ATL,290,185,65,68,14,21,Loss,83,68,2,0,2,CHI,35,373,253,3
0.416666667,0.5625,26.1,10/18/2009,,,16,21,home,7,CHI,185,290,70,56,21,14,Win,68,83,0,2,3,ATL,35,253,373,2
0.5625,0.181818182,30.71666667,10/19/2009,,,19,20,away,11,LAC,227,238,48,63,34,23,Win,101,73,1,5,1,DEN,57,328,311,0
0.181818182,0.5625,29.28333333,10/19/2009,,,20,19,home,-11,DEN,238,227,44,59,23,34,Loss,73,101,5,1,0,LAC,57,311,328,1
0.545454545,0.166666667,35.9,10/25/2009,,,25,12,away,28,CLE,258,81,70,63,31,3,Win,202,58,0,2,2,GBP,34,460,139,0
0.166666667,0.545454545,24.1,10/25/2009,,,12,25,home,-28,GBP,81,258,40,52,3,31,Loss,58,202,2,0,0,CLE,34,139,460,2
0.470588235,0.2,32.75,10/25/2009,,,17,10,away,30,KCC,268,82,59,66,37,7,Win,135,121,0,5,3,LAC,44,403,203,0
0.2,0.470588235,27.25,10/25/2009,,,10,17,home,-30,LAC,82,268,41,61,7,37,Loss,121,135,5,0,0,KCC,44,203,403,3
0.363636364,0.461538462,29.51666667,10/25/2009,,,17,18,away,-3,HOU,238,246,65,54,21,24,Loss,59,90,2,2,1,SFO,45,297,336,2
0.461538462,0.363636364,30.48333333,10/25/2009,,,18,17,home,3,SFO,246,238,77,59,24,21,Win,90,59,2,2,2,HOU,45,336,297,1
0.666666667,0.307692308,30.65,10/25/2009,,,24,14,away,36,LAR,235,117,51,60,42,6,Win,156,155,0,3,2,IND,48,391,272,0
0.307692308,0.666666667,29.35,10/25/2009,,,14,24,home,-36,IND,117,235,73,59,6,42,Loss,155,156,3,0,0,LAR,48,272,391,2
0.5,0.333333333,36.96666667,10/25/2009,,,21,14,away,-10,PIT,297,152,78,77,17,27,Loss,89,107,4,4,1,MIN,44,386,259,2
0.333333333,0.5,23.03333333,10/25/2009,,,14,21,home,10,MIN,152,297,15,49,27,17,Win,107,89,4,4,2,PIT,44,259,386,1
0.5,0.266666667,33.25,10/25/2009,,,18,10,away,28,TBB,307,151,66,61,35,7,Win,107,89,1,3,3,NEP,42,414,240,2
0.266666667,0.5,26.75,10/25/2009,,,10,18,home,-28,NEP,151,307,55,59,7,35,Loss,89,107,3,1,2,TBB,42,240,414,3
0.214285714,0.153846154,25.33333333,10/25/2009,,,9,20,away,11,CAR,114,309,22,54,20,9,Win,53,116,2,2,4,BUF,29,167,425,0
0.153846154,0.214285714,34.66666667,10/25/2009,,,20,9,home,-11,BUF,309,114,67,71,9,20,Loss,116,53,2,2,0,CAR,29,425,167,4
0.5625,0.416666667,35.95,10/25/2009,,,26,13,away,38,OAK,131,144,8,71,38,0,Win,316,119,1,3,4,NYJ,38,447,263,0
0.416666667,0.5625,24.05,10/25/2009,,,13,26,home,-38,NYJ,144,131,24,52,0,38,Loss,119,316,3,1,0,OAK,38,263,447,4
0.5,0.666666667,23.63333333,10/25/2009,,,15,30,away,-35,CIN,244,233,44,52,10,45,Loss,35,215,1,0,0,CHI,55,279,448,4
0.666666667,0.5,36.36666667,10/25/2009,,,30,15,home,35,CHI,233,244,20,69,45,10,Win,215,35,0,1,4,CIN,55,448,279,0
0.5,0.461538462,31.13333333,10/25/2009,,,21,18,away,-16,DAL,174,299,30,65,21,37,Loss,124,115,4,2,1,ATL,58,298,414,3
0.461538462,0.5,28.86666667,10/25/2009,,,18,21,home,16,ATL,299,174,50,59,37,21,Win,115,124,2,4,3,DAL,58,414,298,1
0.333333333,0.444444444,33.03333333,10/25/2009,,,22,17,away,12,MIA,276,197,25,70,46,34,Win,138,137,5,2,3,NOS,80,414,334,4
0.444444444,0.333333333,26.96666667,10/25/2009,,,17,22,home,-12,NOS,197,276,55,69,34,46,Loss,137,138,2,5,4,MIA,80,334,414,3
0.214285714,0.266666667,29.73333333,10/25/2009,,,15,15,away,7,NYG,216,220,60,60,24,17,Win,72,107,2,3,4,ARI,41,288,327,2
0.266666667,0.214285714,30.26666667,10/25/2009,,,15,15,home,-7,ARI,220,216,30,66,17,24,Loss,107,72,3,2,2,NYG,41,327,288,4
0.266666667,0.25,28.3,10/26/2009,,,11,21,away,10,WAS,140,246,66,56,27,17,Win,122,62,3,6,4,PHI,44,262,308,0
0.25,0.266666667,31.7,10/26/2009,,,21,11,home,-10,PHI,246,140,60,68,17,27,Loss,62,122,6,3,0,WAS,44,308,262,4
0.538461538,0.2,39.13333333,11/1/2009,,,24,9,away,21,BUF,257,107,45,76,31,10,Win,182,97,1,2,2,HOU,41,439,204,3
0.2,0.538461538,20.86666667,11/1/2009,,,9,24,home,-21,HOU,107,257,36,45,10,31,Loss,97,182,2,1,3,BUF,41,204,439,2
0.090909091,0.375,22.58333333,11/1/2009,,,9,20,away,-24,CHI,74,199,30,50,6,30,Loss,117,170,1,4,1,CLE,36,191,369,5
0.375,0.090909091,37.41666667,11/1/2009,,,20,9,home,24,CLE,199,74,35,71,30,6,Win,170,117,4,1,5,CHI,36,369,191,1
0.428571429,0.538461538,25.25,11/1/2009,,,18,26,away,-21,DAL,229,249,53,64,17,38,Loss,79,113,3,2,1,SEA,55,308,362,2
0.538461538,0.428571429,34.75,11/1/2009,,,26,18,home,21,SEA,249,229,43,67,38,17,Win,113,79,2,3,2,DAL,55,362,308,1
0.25,0.375,27.95,11/1/2009,,,21,17,away,7,DET,212,162,27,62,17,10,Win,150,127,0,2,1,LAR,27,362,289,1
0.375,0.25,32.05,11/1/2009,,,17,21,home,-7,LAR,162,212,67,68,10,17,Loss,127,150,2,0,1,DET,27,289,362,1
0.2,0.421052632,26.43333333,11/1/2009,,,16,20,away,-4,IND,182,349,50,54,14,18,Loss,113,61,4,3,0,SFO,32,295,410,2
0.421052632,0.2,33.56666667,11/1/2009,,,20,16,home,4,SFO,349,182,38,73,18,14,Win,61,113,3,4,2,IND,32,410,295,0
0.285714286,0.214285714,25.9,11/1/2009,,,10,23,away,5,NYJ,52,251,25,51,30,25,Win,52,127,6,2,1,MIA,55,104,378,1
0.214285714,0.285714286,34.1,11/1/2009,,,23,10,home,-5,MIA,251,52,40,77,25,30,Loss,127,52,2,6,1,NYJ,55,378,104,1
0.230769231,0.611111111,26.38333333,11/1/2009,,,17,16,away,-23,BAL,134,167,35,58,7,30,Loss,66,125,2,2,0,DEN,37,200,292,1
0.611111111,0.230769231,33.61666667,11/1/2009,,,16,17,home,23,DEN,167,134,94,62,30,7,Win,125,66,2,2,1,BAL,37,292,200,0
0.5,0.545454545,35.55,11/1/2009,,,21,17,away,-23,PHI,215,211,25,73,17,40,Loss,141,180,2,2,2,NYG,57,356,391,3
0.545454545,0.5,24.45,11/1/2009,,,17,21,home,23,NYG,211,215,45,49,40,17,Win,180,141,2,2,3,PHI,57,391,356,2
0.333333333,0.533333333,20.28333333,11/1/2009,,,12,20,away,-17,TEN,113,125,27,49,13,30,Loss,217,305,4,0,0,JAX,43,330,430,2
0.533333333,0.333333333,39.71666667,11/1/2009,,,20,12,home,17,JAX,125,113,20,67,30,13,Win,305,217,0,4,2,TEN,43,430,330,0
0.384615385,0.636363636,29.51666667,11/1/2009,,,13,20,away,-8,LAC,81,246,31,54,16,24,Loss,99,100,5,1,2,OAK,40,180,346,1
0.636363636,0.384615385,30.48333333,11/1/2009,,,20,13,home,8,OAK,246,81,40,56,24,16,Win,100,99,1,5,1,LAC,40,346,180,2
0.428571429,0.4375,27.46666667,11/1/2009,,,19,21,away,12,GBP,244,261,29,60,38,26,Win,111,90,0,6,0,MIN,64,355,351,2
0.4375,0.428571429,32.53333333,11/1/2009,,,21,19,home,-12,MIN,261,244,45,67,26,38,Loss,90,111,6,0,2,GBP,64,351,355,0
0.5,0.4,32.96666667,11/1/2009,,,13,23,away,13,ARI,85,226,72,60,34,21,Win,270,94,1,2,6,CAR,55,355,320,0
0.4,0.5,27.03333333,11/1/2009,,,23,13,home,-13,CAR,226,85,35,65,21,34,Loss,94,270,2,1,0,ARI,55,320,355,6
0.272727273,0.583333333,26.76666667,11/2/2009,,,21,23,away,-8,NOS,281,291,25,69,27,35,Loss,161,146,3,2,4,ATL,62,442,437,3
0.583333333,0.272727273,33.23333333,11/2/2009,,,23,21,home,8,ATL,291,281,65,70,35,27,Win,146,161,2,3,3,NOS,62,437,442,4
0.5625,0.363636364,33.53333333,11/8/2009,,,17,18,away,-14,ATL,176,125,88,64,17,31,Loss,136,181,5,3,1,WAS,48,312,306,1
0.363636364,0.5625,26.46666667,11/8/2009,,,18,17,home,14,WAS,125,176,54,54,31,17,Win,181,136,3,5,1,ATL,48,306,312,1
0.571428571,0.384615385,33.26666667,11/8/2009,,,27,20,away,20,CHI,256,347,15,65,41,21,Win,182,70,1,4,1,ARI,62,438,417,1
0.384615385,0.571428571,26.73333333,11/8/2009,,,20,27,home,-20,ARI,347,256,89,63,21,41,Loss,70,182,4,1,1,CHI,62,417,438,1
0.1,0.444444444,20,11/8/2009,,,16,20,away,-10,CIN,160,223,80,53,7,17,Loss,55,146,4,1,1,BAL,24,215,369,2
0.444444444,0.1,40,11/8/2009,,,20,16,home,10,BAL,223,160,40,73,17,7,Win,146,55,1,4,2,CIN,24,369,215,1
0.625,0.5,34.55,11/8/2009,,,22,27,away,-3,IND,301,306,103,71,17,20,Loss,81,72,2,2,2,HOU,37,382,378,3
0.5,0.625,25.45,11/8/2009,,,27,22,home,3,HOU,306,301,40,71,20,17,Win,72,81,2,2,3,IND,37,378,382,2
0.529411765,0.461538462,31.11666667,11/8/2009,,,21,22,away,-10,NEP,201,323,35,70,17,27,Loss,133,109,2,2,1,MIA,44,334,432,0
0.461538462,0.529411765,28.88333333,11/8/2009,,,22,21,home,10,MIA,323,201,49,63,27,17,Win,109,133,2,2,0,NEP,44,432,334,1
0.357142857,0.25,35.28333333,11/8/2009,,,20,17,away,-10,TBB,234,198,35,73,28,38,Loss,170,81,6,1,1,GBP,66,404,279,3
0.25,0.357142857,24.71666667,11/8/2009,,,17,20,home,10,GBP,198,234,15,57,38,28,Win,81,170,1,6,3,TBB,66,279,404,1
0.307692308,0.5625,23.78333333,11/8/2009,,,14,21,away,-3,JAX,241,253,10,56,21,24,Loss,60,173,3,1,1,KCC,45,301,426,0
0.5625,0.307692308,36.21666667,11/8/2009,,,21,14,home,3,KCC,253,241,31,69,24,21,Win,173,60,1,3,0,JAX,45,426,301,1
0.375,0.466666667,29.3,11/8/2009,,,17,25,away,-12,SEA,186,342,77,65,20,32,Loss,114,55,2,1,2,DET,52,300,397,5
0.466666667,0.375,30.7,11/8/2009,,,25,17,home,12,DET,342,186,45,71,32,20,Win,55,114,1,2,5,SEA,52,397,300,2
0.5,0.5,32.43333333,11/8/2009,,,21,18,away,-10,NOS,189,330,37,71,20,30,Loss,182,84,2,1,2,CAR,50,371,414,3
0.5,0.5,27.56666667,11/8/2009,,,18,21,home,10,CAR,330,189,55,59,30,20,Win,84,182,1,2,3,NOS,50,414,371,2
0.3,0.357142857,22.21666667,11/8/2009,,,18,19,away,1,NYG,192,188,20,53,21,20,Win,34,116,2,5,1,LAC,41,226,304,2
0.357142857,0.3,37.78333333,11/8/2009,,,19,18,home,-1,LAC,188,192,104,67,20,21,Loss,116,34,5,2,2,NYG,41,304,226,1
0.333333333,0.307692308,26.16666667,11/8/2009,,,14,25,away,7,SFO,163,250,58,55,34,27,Win,152,108,1,4,4,TEN,61,315,358,0
0.307692308,0.333333333,33.83333333,11/8/2009,,,25,14,home,-7,TEN,250,163,25,69,27,34,Loss,108,152,4,1,0,SFO,61,358,315,4
0.466666667,0.333333333,31.73333333,11/8/2009,,,18,17,away,4,PHI,282,209,70,61,20,16,Win,76,88,4,3,2,DAL,36,358,297,1
0.333333333,0.466666667,28.26666667,11/8/2009,,,17,18,home,-4,DAL,209,282,82,57,16,20,Loss,88,76,3,4,1,PHI,36,297,358,2
0.583333333,0.357142857,33.05,11/9/2009,,,21,12,away,18,DEN,202,215,28,61,28,10,Win,173,27,3,2,3,PIT,38,375,242,2
0.357142857,0.583333333,26.95,11/9/2009,,,12,21,home,-18,PIT,215,202,25,54,10,28,Loss,27,173,2,3,2,DEN,38,242,375,3
0.470588235,0.428571429,28.45,11/12/2009,,,19,12,away,-4,SFO,307,106,75,73,6,10,Loss,43,110,0,2,1,CHI,16,350,216,5
0.428571429,0.470588235,31.55,11/12/2009,,,12,19,home,4,CHI,106,307,77,53,10,6,Win,110,43,2,0,5,SFO,16,216,350,1
0.357142857,0.647058824,28.66666667,11/15/2009,,,14,20,away,-24,TEN,207,210,65,58,17,41,Loss,89,168,2,0,1,BUF,58,296,378,2
0.647058824,0.357142857,31.33333333,11/15/2009,,,20,14,home,24,BUF,210,207,75,60,41,17,Win,168,89,0,2,2,TEN,58,378,296,1
0.285714286,0.2,29.13333333,11/15/2009,,,14,16,away,6,PIT,157,146,87,61,18,12,Win,61,80,2,4,1,CIN,30,218,226,0
0.2,0.285714286,30.86666667,11/15/2009,,,16,14,home,-6,CIN,146,157,50,62,12,18,Loss,80,61,4,2,0,PIT,30,226,218,1
0.6,0.384615385,27.96666667,11/15/2009,,,19,23,away,5,LAR,217,293,40,56,28,23,Win,203,141,1,2,1,NOS,51,420,434,3
0.384615385,0.6,32.03333333,11/15/2009,,,23,19,home,-5,NOS,293,217,20,71,23,28,Loss,141,203,2,1,3,LAR,51,434,420,1
0.307692308,0.357142857,28.76666667,11/15/2009,,,16,23,away,-2,MIA,180,175,77,62,23,25,Loss,121,199,4,0,2,TBB,48,301,374,2
0.357142857,0.307692308,31.23333333,11/15/2009,,,23,16,home,2,TBB,175,180,30,68,25,23,Win,199,121,0,4,2,MIA,48,374,301,2
0.352941176,0.272727273,29.61666667,11/15/2009,,,19,19,away,-17,MIN,204,340,40,76,10,27,Loss,93,152,3,1,2,DET,37,297,492,1
0.272727273,0.352941176,30.38333333,11/15/2009,,,19,19,home,17,DET,340,204,91,63,27,10,Win,152,93,1,3,1,MIN,37,492,297,2
0.538461538,0.538461538,31.11666667,11/15/2009,,,18,19,away,2,NYJ,208,212,40,60,24,22,Win,139,110,2,0,3,JAX,46,347,322,1
0.538461538,0.538461538,28.88333333,11/15/2009,,,19,18,home,-2,JAX,212,208,26,60,22,24,Loss,110,139,0,2,1,NYJ,46,322,347,3
0.416666667,0.5,24.28333333,11/15/2009,,,14,22,away,-10,WAS,185,214,45,56,17,27,Loss,120,174,3,3,0,DEN,44,305,388,2
0.5,0.416666667,35.71666667,11/15/2009,,,22,14,home,10,DEN,214,185,19,70,27,17,Win,174,120,3,3,2,WAS,44,388,305,0
0.428571429,0.538461538,31.85,11/15/2009,,,22,19,away,-9,CAR,224,195,26,70,19,28,Loss,176,185,0,0,0,ATL,47,400,380,2
0.538461538,0.428571429,28.15,11/15/2009,,,19,22,home,9,ATL,195,224,48,58,28,19,Win,185,176,0,0,2,CAR,47,380,400,0
0.066666667,0.125,28.9,11/15/2009,,,14,11,away,6,OAK,206,90,35,67,16,10,Win,112,182,2,2,2,KCC,26,318,272,3
0.125,0.066666667,31.1,11/15/2009,,,11,14,home,-6,KCC,90,206,88,64,10,16,Loss,182,112,2,2,3,OAK,26,272,318,2
0.4,0.166666667,28.5,11/15/2009,,,29,22,away,-11,ARI,308,340,113,81,20,31,Loss,164,122,4,0,0,SEA,51,472,462,2
0.166666667,0.4,31.5,11/15/2009,,,22,29,home,11,SEA,340,308,136,68,31,20,Win,122,164,0,4,2,ARI,51,462,472,0
0.25,0.466666667,24.03333333,11/15/2009,,,17,20,away,-10,GBP,217,178,67,58,7,17,Loss,61,105,5,4,0,DAL,24,278,283,3
0.466666667,0.25,35.96666667,11/15/2009,,,20,17,home,10,DAL,178,217,100,68,17,7,Win,105,61,4,5,3,GBP,24,283,278,0
0.384615385,0.375,29.61666667,11/15/2009,,,26,22,away,-8,LAC,433,212,70,71,23,31,Loss,29,119,2,2,0,PHI,54,462,331,1
0.375,0.384615385,30.38333333,11/15/2009,,,22,26,home,8,PHI,212,433,31,55,31,23,Win,119,29,2,2,1,LAC,54,331,462,0
0.5,0.416666667,35.03333333,11/15/2009,,,24,25,away,-1,IND,364,316,72,72,34,35,Loss,113,91,2,1,2,NEP,69,477,407,2
0.416666667,0.5,24.96666667,11/15/2009,,,25,24,home,1,NEP,316,364,20,63,35,34,Win,91,113,1,2,2,IND,69,407,477,2
0.285714286,0.3125,31.53333333,11/16/2009,,,14,11,away,16,CLE,146,74,43,58,16,0,Win,128,86,2,4,2,BAL,16,274,160,0
0.3125,0.285714286,28.46666667,11/16/2009,,,11,14,home,-16,BAL,74,146,52,61,0,16,Loss,86,128,4,2,0,CLE,16,160,274,2
0.466666667,0.230769231,30.55,11/19/2009,,,17,22,away,7,CAR,172,201,30,60,24,17,Win,154,182,0,4,1,MIA,41,326,383,0
0.230769231,0.466666667,29.45,11/19/2009,,,22,17,home,-7,MIA,201,172,35,73,17,24,Loss,182,154,4,0,0,CAR,41,383,326,1
0.466666667,0.272727273,28.56666667,11/22/2009,,,14,17,away,-1,DAL,246,152,27,58,6,7,Loss,78,153,1,1,2,WAS,13,324,305,1
0.272727273,0.466666667,31.43333333,11/22/2009,,,17,14,home,1,WAS,152,246,35,61,7,6,Win,153,78,1,1,1,DAL,13,305,324,2
0.526315789,0.5,34.76666667,11/22/2009,,,22,26,away,-1,DET,308,416,69,75,37,38,Loss,131,57,1,2,2,CLE,75,439,473,0
0.5,0.526315789,25.23333333,11/22/2009,,,26,22,home,1,CLE,416,308,41,61,38,37,Win,57,131,2,1,0,DET,75,473,439,2
0.272727273,0.555555556,18.35,11/22/2009,,,11,26,away,-6,GBP,215,326,30,46,24,30,Loss,69,158,3,2,0,SFO,54,284,484,1
0.555555556,0.272727273,41.65,11/22/2009,,,26,11,home,6,SFO,326,215,64,79,30,24,Win,158,69,2,3,1,GBP,54,484,284,0
0.307692308,0.4,44.11666667,11/22/2009,,,27,13,away,-3,KCC,402,214,81,77,0,3,Loss,114,68,2,5,1,PIT,3,516,282,3
0.4,0.307692308,22.41666667,11/22/2009,,,13,27,home,3,PIT,214,402,28,55,3,0,Win,68,114,5,2,3,KCC,3,282,516,1
0.5625,0.5,31.8,11/22/2009,,,27,26,away,-3,NYG,262,368,16,78,0,3,Loss,90,88,2,1,1,ATL,3,352,456,1
0.5,0.5625,32.1,11/22/2009,,,26,27,home,3,ATL,368,262,64,66,3,0,Win,88,90,1,2,1,NYG,3,456,352,1
0.428571429,0.4,32.4,11/22/2009,,,21,14,away,31,TBB,187,100,55,65,38,7,Win,183,119,0,3,4,NOS,45,370,219,0
0.4,0.428571429,27.6,11/22/2009,,,14,21,home,-31,NOS,100,187,18,59,7,38,Loss,119,183,3,0,0,TBB,45,219,370,4
0.272727273,0.6,23.6,11/22/2009,,,14,19,away,-3,JAX,290,208,43,51,15,18,Loss,53,102,2,2,2,BUF,33,343,310,3
0.6,0.272727273,36.4,11/22/2009,,,19,14,home,3,BUF,208,290,50,66,18,15,Win,102,53,2,2,3,JAX,33,310,343,2
0.555555556,0.384615385,27.4,11/22/2009,,,20,20,away,2,BAL,299,256,40,56,17,15,Win,76,98,0,0,2,IND,32,375,354,3
0.384615385,0.555555556,32.6,11/22/2009,,,20,20,home,-2,IND,256,299,20,66,15,17,Loss,98,76,0,0,3,BAL,32,354,375,2
0.1,0.615384615,17.81666667,11/22/2009,,,10,28,away,-26,MIN,208,271,64,43,9,35,Loss,4,160,2,2,0,SEA,44,212,431,2
0.615384615,0.1,42.18333333,11/22/2009,,,28,10,home,26,SEA,271,208,31,72,35,9,Win,160,4,2,2,2,MIN,44,431,212,0
0.545454545,0.25,31.63333333,11/22/2009,,,24,16,away,8,LAR,261,191,40,65,21,13,Win,183,123,2,3,1,ARI,34,444,314,2
0.25,0.545454545,28.36666667,11/22/2009,,,16,24,home,-8,ARI,191,261,50,67,13,21,Loss,123,183,3,2,2,LAR,34,314,444,1
0.2,0.470588235,20.1,11/22/2009,,,12,27,away,-17,NEP,122,299,28,49,14,31,Loss,104,111,2,2,1,NYJ,45,226,410,5
0.470588235,0.2,39.9,11/22/2009,,,27,12,home,17,NYJ,299,122,51,78,31,14,Win,111,104,2,2,5,NEP,45,410,226,1
0.461538462,0.363636364,38.4,11/22/2009,,,23,16,away,-3,OAK,171,183,59,68,17,20,Loss,177,92,3,0,3,CIN,37,348,275,4
0.363636364,0.461538462,21.6,11/22/2009,,,16,23,home,3,CIN,183,171,13,58,20,17,Win,92,177,0,3,4,OAK,37,275,348,3
0.384615385,0.222222222,37.86666667,11/22/2009,,,21,14,away,29,DEN,145,156,15,65,32,3,Win,203,115,0,3,3,LAC,35,348,271,0
0.222222222,0.384615385,22.13333333,11/22/2009,,,14,21,home,-29,LAC,156,145,65,53,3,32,Loss,115,203,3,0,0,DEN,35,271,348,3
0.466666667,0.1875,30.95,11/22/2009,,,18,14,away,4,CHI,220,158,46,66,24,20,Win,157,126,3,1,1,PHI,44,377,284,3
0.1875,0.466666667,29.05,11/22/2009,,,14,18,home,-4,PHI,158,220,64,64,20,24,Loss,126,157,1,3,3,CHI,44,284,377,1
0.461538462,0.466666667,32.31666667,11/23/2009,,,22,17,away,3,HOU,116,283,25,64,20,17,Win,228,57,0,4,0,TEN,37,344,340,1
0.466666667,0.461538462,27.68333333,11/23/2009,,,17,22,home,-3,TEN,283,116,72,60,17,20,Loss,57,228,4,0,1,HOU,37,340,344,0
0.5625,0.375,33.98333333,11/26/2009,,,20,16,away,22,DET,342,199,57,67,34,12,Win,80,73,1,2,5,GBP,46,422,272,2
0.375,0.5625,26.01666667,11/26/2009,,,16,20,home,-22,GBP,199,342,28,68,12,34,Loss,73,80,2,1,2,DET,46,272,422,5
0.285714286,0.333333333,28.76666667,11/26/2009,,,14,18,away,-17,DAL,181,299,70,62,7,24,Loss,124,195,3,2,0,OAK,31,305,494,1
0.333333333,0.285714286,31.23333333,11/26/2009,,,18,14,home,17,OAK,299,181,48,56,24,7,Win,195,124,2,3,1,DAL,31,494,305,0
0.25,0.307692308,24.5,11/26/2009,,,15,23,away,-20,DEN,210,235,45,59,6,26,Loss,57,138,3,1,1,NYG,32,267,373,3
0.307692308,0.25,35.5,11/26/2009,,,23,15,home,20,NYG,235,210,61,69,26,6,Win,138,57,1,3,3,DEN,32,373,267,1
0.25,0.3125,28.4,11/29/2009,,,13,21,away,-3,ATL,245,222,52,57,17,20,Loss,73,75,1,6,1,TBB,37,318,297,1
0.3125,0.25,31.6,11/29/2009,,,21,13,home,3,TBB,222,245,29,76,20,17,Win,75,73,6,1,1,ATL,37,297,318,1
0.384615385,0.3,31.76666667,11/29/2009,,,23,20,away,-17,BUF,168,207,50,70,14,31,Loss,157,129,1,6,1,MIA,45,325,336,4
0.3,0.384615385,28.23333333,11/29/2009,,,20,23,home,17,MIA,207,168,20,57,31,14,Win,129,157,6,1,4,BUF,45,336,325,1
0.285714286,0.470588235,21.81666667,11/29/2009,,,11,21,away,-9,CIN,111,96,30,54,7,16,Loss,58,210,1,3,0,CLE,23,169,306,0
0.470588235,0.285714286,38.18333333,11/29/2009,,,21,11,home,9,CLE,96,111,75,72,16,7,Win,210,58,3,1,0,CIN,23,306,169,0
0.333333333,0.444444444,26.46666667,11/29/2009,,,15,23,away,10,LAR,95,251,52,57,27,17,Win,170,113,1,4,2,SEA,44,265,364,1
0.444444444,0.333333333,33.53333333,11/29/2009,,,23,15,home,-10,SEA,251,95,35,78,17,27,Loss,113,170,4,1,1,LAR,44,364,265,2
0.25,0.384615385,26.7,11/29/2009,,,11,16,away,-11,NYJ,104,144,30,62,6,17,Loss,75,139,3,3,3,CAR,23,179,283,4
0.384615385,0.25,33.3,11/29/2009,,,16,11,home,11,CAR,144,104,24,60,17,6,Win,139,75,3,3,4,NYJ,23,283,179,3
0.470588235,0.333333333,29.7,11/29/2009,,,15,17,away,-3,PHI,221,258,39,63,24,27,Loss,82,123,1,2,1,WAS,51,303,381,2
0.333333333,0.470588235,30.3,11/29/2009,,,17,15,home,3,WAS,258,221,60,67,27,24,Win,123,82,2,1,2,PHI,51,381,303,1
0.333333333,0.5,28.13333333,11/29/2009,,,28,27,away,8,HOU,228,274,25,60,35,27,Win,114,122,2,2,3,IND,62,342,396,2
0.5,0.333333333,31.86666667,11/29/2009,,,27,28,home,-8,IND,274,228,129,68,27,35,Loss,122,114,2,2,2,HOU,62,396,342,3
0.272727273,0.444444444,24.66666667,11/29/2009,,,16,26,away,-29,LAC,170,332,25,57,14,43,Loss,114,94,1,0,1,KCC,57,284,426,4
0.444444444,0.272727273,35.33333333,11/29/2009,,,26,16,home,29,KCC,332,170,55,63,43,14,Win,94,114,0,1,4,LAC,57,426,284,1
0.25,0.5,29.26666667,11/29/2009,,,18,15,away,-17,SFO,261,232,60,61,3,20,Loss,96,52,6,0,0,JAX,23,357,284,2
0.5,0.25,30.73333333,11/29/2009,,,15,18,home,17,JAX,232,261,5,61,20,3,Win,52,96,0,6,2,SFO,23,284,357,0
0.416666667,0.375,28.88333333,11/29/2009,,,15,20,away,-3,TEN,217,369,25,52,17,20,Loss,75,163,1,4,1,ARI,37,292,532,0
0.375,0.416666667,31.11666667,11/29/2009,,,20,15,home,3,ARI,369,217,38,70,20,17,Win,163,75,4,1,0,TEN,37,532,292,1
0.25,0.666666667,19.08333333,11/29/2009,,,8,31,away,-26,MIN,126,378,44,38,10,36,Loss,43,159,4,1,1,CHI,46,169,537,3
0.666666667,0.25,40.91666667,11/29/2009,,,31,8,home,26,CHI,378,126,70,83,36,10,Win,159,43,1,4,3,MIN,46,537,169,1
0.375,0.357142857,35.93333333,11/29/2009,,,16,21,away,-3,BAL,145,261,59,64,0,3,Loss,153,132,0,5,2,PIT,3,298,393,1
0.357142857,0.375,32.36666667,11/29/2009,,,21,16,home,3,PIT,261,145,80,69,3,0,Win,132,153,5,0,1,BAL,3,393,298,2
0.307692308,0.4,33.26666667,11/30/2009,,,23,18,away,-21,NOS,244,367,0,70,17,38,Loss,122,113,2,1,1,NEP,55,366,480,3
0.4,0.307692308,26.73333333,11/30/2009,,,18,23,home,21,NEP,367,244,36,50,38,17,Win,113,122,1,2,3,NOS,55,480,366,1
0.3125,0.090909091,35.16666667,12/3/2009,,,17,10,away,6,BUF,82,71,18,65,19,13,Win,249,123,5,3,2,NYJ,32,331,194,0
0.090909091,0.3125,24.83333333,12/3/2009,,,10,17,home,-6,NYJ,71,82,5,50,13,19,Loss,123,249,3,5,0,BUF,32,194,331,2
0.363636364,0.285714286,29.18333333,12/6/2009,,,20,22,away,27,ATL,277,234,61,55,34,7,Win,103,61,2,2,3,PHI,41,380,295,0
0.285714286,0.363636364,30.81666667,12/6/2009,,,22,20,home,-27,PHI,234,277,30,68,7,34,Loss,61,103,2,2,0,ATL,41,295,380,3
0.142857143,0.307692308,32,12/6/2009,,,14,14,away,-8,CHI,98,128,85,65,9,17,Loss,135,120,3,2,1,LAR,26,233,248,2
0.307692308,0.142857143,28,12/6/2009,,,14,14,home,8,LAR,128,98,35,58,17,9,Win,120,135,2,3,2,CHI,26,248,233,1
0.181818182,0.375,21.2,12/6/2009,,,14,22,away,-10,CIN,165,202,45,52,13,23,Loss,80,119,3,2,3,DET,36,245,321,2
0.375,0.181818182,38.8,12/6/2009,,,22,14,home,10,DET,202,165,75,75,23,13,Win,119,80,2,3,2,CIN,36,321,245,3
0.533333333,0.642857143,32.98333333,12/6/2009,,,24,23,away,-10,IND,233,270,50,77,17,27,Loss,142,88,1,0,0,TEN,44,375,358,2
0.642857143,0.533333333,27.01666667,12/6/2009,,,23,24,home,10,TEN,270,233,40,64,27,17,Win,88,142,0,1,2,IND,44,358,375,0
0.307692308,0.352941176,35.91666667,12/6/2009,,,24,14,away,31,KCC,168,128,20,73,44,13,Win,245,94,3,2,3,DEN,57,413,222,3
0.352941176,0.307692308,24.08333333,12/6/2009,,,14,24,home,-31,DEN,128,168,25,71,13,44,Loss,94,245,2,3,3,KCC,57,222,413,3
0.428571429,0.583333333,35.1,12/6/2009,,,25,28,away,3,WAS,408,367,102,74,3,0,Win,55,88,1,0,4,NOS,3,463,455,1
0.583333333,0.428571429,31.38333333,12/6/2009,,,28,25,home,-3,NOS,367,408,15,67,0,3,Loss,88,55,0,1,1,WAS,3,455,463,4
0.285714286,0.272727273,31.06666667,12/6/2009,,,22,15,away,-10,CAR,315,152,50,72,6,16,Loss,154,157,2,1,2,TBB,22,469,309,5
0.272727273,0.285714286,28.93333333,12/6/2009,,,15,22,home,10,TBB,152,315,37,54,16,6,Win,157,154,1,2,5,CAR,22,309,469,2
0.333333333,0.5,29.88333333,12/6/2009,,,19,19,away,-5,JAX,233,216,37,61,18,23,Loss,72,107,2,4,1,HOU,41,305,323,3
0.5,0.333333333,30.11666667,12/6/2009,,,19,19,home,5,HOU,216,233,45,68,23,18,Win,107,72,4,2,3,JAX,41,323,305,1
0.375,0.333333333,32.81666667,12/6/2009,,,19,19,away,3,PIT,287,269,70,65,27,24,Win,109,132,3,1,1,OAK,51,396,401,0
0.333333333,0.375,27.18333333,12/6/2009,,,19,19,home,-3,OAK,269,287,41,52,24,27,Loss,132,109,1,3,0,PIT,51,401,396,1
0.4,0.526315789,27.38333333,12/6/2009,,,18,24,away,-1,MIA,352,328,82,54,21,22,Loss,96,88,0,1,1,NEP,43,448,416,2
0.526315789,0.4,32.61666667,12/6/2009,,,24,18,home,1,NEP,328,352,10,80,22,21,Win,88,96,1,0,2,MIA,43,416,448,1
0.5,0.5,29.38333333,12/6/2009,,,21,24,away,7,CLE,386,257,5,59,30,23,Win,91,115,1,2,1,LAC,53,477,372,0
0.5,0.5,30.61666667,12/6/2009,,,24,21,home,-7,LAC,257,386,30,69,23,30,Loss,115,91,2,1,0,CLE,53,372,477,1
0.076923077,0.25,28.81666667,12/6/2009,,,14,17,away,-3,SEA,303,185,57,58,17,20,Loss,53,107,1,5,1,SFO,37,356,292,2
0.25,0.076923077,31.18333333,12/6/2009,,,17,14,home,3,SFO,185,303,48,69,20,17,Win,107,53,5,1,2,SEA,37,292,356,1
0.529411765,0.4,38.83333333,12/6/2009,,,27,15,away,-7,NYG,379,237,30,80,24,31,Loss,45,100,2,1,2,DAL,55,424,337,1
0.4,0.529411765,21.16666667,12/6/2009,,,15,27,home,7,DAL,237,379,10,49,31,24,Win,100,45,1,2,1,NYG,55,337,424,2
0.333333333,0.4,31.28333333,12/6/2009,,,22,20,away,-13,ARI,253,285,50,68,17,30,Loss,62,113,3,0,1,MIN,47,315,398,2
0.4,0.333333333,28.71666667,12/6/2009,,,20,22,home,13,MIN,285,253,50,57,30,17,Win,113,62,0,3,2,ARI,47,398,315,1
0.461538462,0.461538462,24.63333333,12/7/2009,,,17,25,away,-13,GBP,119,256,135,60,14,27,Loss,66,94,3,1,3,BAL,41,185,350,4
0.461538462,0.461538462,35.36666667,12/7/2009,,,25,17,home,13,BAL,256,119,175,68,27,14,Win,94,66,1,3,4,GBP,41,350,185,3
0.214285714,0.375,30.75,12/10/2009,,,16,12,away,-7,CLE,141,84,40,62,6,13,Loss,77,171,8,1,0,PIT,19,218,255,0
0.375,0.214285714,29.25,12/10/2009,,,12,16,home,7,PIT,84,141,55,57,13,6,Win,171,77,1,8,0,CLE,19,255,218,0
0.666666667,0.5,36.73333333,12/13/2009,,,24,19,away,3,ATL,296,303,59,67,26,23,Win,95,89,0,1,1,NOS,49,391,392,0
0.5,0.666666667,23.26666667,12/13/2009,,,19,24,home,-3,NOS,303,296,55,56,23,26,Loss,89,95,1,0,0,ATL,49,392,391,1
0.384615385,0.384615385,31.2,12/13/2009,,,16,14,away,7,CHI,157,195,30,57,21,14,Win,158,59,3,3,2,GBP,35,315,254,2
0.384615385,0.384615385,28.8,12/13/2009,,,14,16,home,-7,GBP,195,157,109,56,14,21,Loss,59,158,3,3,2,CHI,35,254,315,2
0.352941176,0.5625,31.45,12/13/2009,,,20,21,away,-12,IND,262,220,65,74,16,28,Loss,95,92,3,0,3,DEN,44,357,312,1
0.5625,0.352941176,28.55,12/13/2009,,,21,20,home,12,DEN,220,262,20,70,28,16,Win,92,95,0,3,1,IND,44,312,357,3
0.25,0.388888889,30.56666667,12/13/2009,,,13,16,away,6,KCC,73,209,40,57,16,10,Win,200,145,2,3,4,BUF,26,273,354,3
0.388888889,0.25,29.43333333,12/13/2009,,,16,13,home,-6,BUF,209,73,43,73,10,16,Loss,145,200,3,2,3,KCC,26,354,273,4
0.277777778,0,34.1,12/13/2009,,,14,6,away,23,TBB,135,81,63,66,26,3,Win,175,43,1,3,3,NYJ,29,310,124,1
0,0.277777778,25.9,12/13/2009,,,6,14,home,-23,NYJ,81,135,34,56,3,26,Loss,43,175,3,1,1,TBB,29,124,310,3
0.533333333,0.214285714,35.1,12/13/2009,,,22,10,away,4,JAX,208,122,27,71,14,10,Win,146,95,2,3,0,MIA,24,354,217,3
0.214285714,0.533333333,24.9,12/13/2009,,,10,22,home,-4,MIA,122,208,10,54,10,14,Loss,95,146,3,2,3,JAX,24,217,354,0
0.294117647,0.461538462,30.25,12/13/2009,,,13,24,away,-45,BAL,126,240,40,67,3,48,Loss,103,308,1,0,1,DET,51,229,548,2
0.461538462,0.294117647,29.75,12/13/2009,,,24,13,home,45,DET,240,126,50,63,48,3,Win,308,103,0,1,2,BAL,51,548,229,1
0.071428571,0.384615385,26.4,12/13/2009,,,13,23,away,-27,HOU,220,365,63,63,7,34,Loss,62,85,3,0,2,SEA,41,282,450,1
0.384615385,0.071428571,33.6,12/13/2009,,,23,13,home,27,SEA,365,220,35,67,34,7,Win,85,62,0,3,1,HOU,41,450,282,2
0.428571429,0.571428571,27.75,12/13/2009,,,13,21,away,-20,MIN,91,180,85,53,10,30,Loss,119,142,1,2,1,CIN,40,210,322,1
0.571428571,0.428571429,32.25,12/13/2009,,,21,13,home,20,CIN,180,91,69,69,30,10,Win,142,119,2,1,1,MIN,40,322,210,1
0.230769231,0.272727273,25.75,12/13/2009,,,14,26,away,-10,NEP,179,192,92,56,10,20,Loss,126,185,2,0,3,CAR,30,305,377,0
0.272727273,0.230769231,34.25,12/13/2009,,,26,14,home,10,CAR,192,179,25,72,20,10,Win,185,126,0,2,0,NEP,30,377,305,3
0.333333333,0.307692308,31.95,12/13/2009,,,15,19,away,-40,TEN,160,286,82,65,7,47,Loss,80,160,1,0,1,LAR,54,240,446,5
0.307692308,0.333333333,28.05,12/13/2009,,,19,15,home,40,LAR,286,160,40,57,47,7,Win,160,80,0,1,5,TEN,54,446,240,1
0.416666667,0.266666667,27.88333333,12/13/2009,,,21,15,away,21,OAK,195,162,45,58,34,13,Win,100,65,3,8,1,WAS,47,295,227,1
0.266666667,0.416666667,32.11666667,12/13/2009,,,15,21,home,-21,WAS,162,195,118,66,13,34,Loss,65,100,8,3,1,OAK,47,227,295,1
0.416666667,0.125,30.08333333,12/13/2009,,,21,22,away,3,DAL,268,239,24,64,20,17,Win,73,108,1,1,0,LAC,37,341,347,1
0.125,0.416666667,29.91666667,12/13/2009,,,22,21,home,-3,LAC,239,268,68,58,17,20,Loss,108,73,1,1,1,DAL,37,347,341,0
0.375,0.416666667,25.23333333,12/13/2009,,,20,27,away,7,NYG,297,379,45,53,45,38,Win,77,133,1,3,4,PHI,83,374,512,1
0.416666667,0.375,34.76666667,12/13/2009,,,27,20,home,-7,PHI,379,297,54,72,38,45,Loss,133,77,3,1,1,NYG,83,512,374,4
0.363636364,0.5,23.25,12/14/2009,,,11,18,away,-15,SFO,160,138,78,51,9,24,Loss,85,189,4,1,2,ARI,33,245,327,7
0.5,0.363636364,36.75,12/14/2009,,,18,11,home,15,ARI,138,160,55,72,24,9,Win,189,85,1,4,7,SFO,33,327,245,2
0.666666667,0.625,24.56666667,12/17/2009,,,18,25,away,4,JAX,308,206,40,53,35,31,Win,61,139,0,2,1,IND,66,369,345,1
0.625,0.666666667,35.43333333,12/17/2009,,,25,18,home,-4,IND,206,308,22,76,31,35,Loss,139,61,2,0,1,JAX,66,345,369,1
0.533333333,0.142857143,36.43333333,12/19/2009,,,24,23,away,7,NOS,294,271,49,73,24,17,Win,145,65,3,4,3,DAL,41,439,336,0
0.142857143,0.533333333,23.56666667,12/19/2009,,,23,24,home,-7,DAL,271,294,30,62,17,24,Loss,65,145,4,3,0,NOS,41,336,439,3
0.416666667,0.166666667,26.46666667,12/20/2009,,,19,16,away,7,BUF,115,136,52,57,17,10,Win,109,105,0,6,1,NEP,27,224,241,1
0.166666667,0.416666667,33.53333333,12/20/2009,,,16,19,home,-7,NEP,136,115,124,56,10,17,Loss,105,109,6,0,1,BUF,27,241,224,1
0.333333333,0.333333333,29.71666667,12/20/2009,,,21,15,away,7,DET,218,121,65,65,31,24,Win,122,161,2,2,3,ARI,55,340,282,3
0.333333333,0.333333333,30.28333333,12/20/2009,,,15,21,home,-7,ARI,121,218,45,60,24,31,Loss,161,122,2,2,3,DET,55,282,340,3
0.4,0.461538462,34.38333333,12/20/2009,,,23,19,away,-3,TEN,347,236,60,77,0,3,Loss,121,128,1,2,2,MIA,3,468,364,4
0.461538462,0.4,29.31666667,12/20/2009,,,19,23,home,3,MIA,236,347,46,60,3,0,Win,128,121,2,1,4,TEN,3,364,468,2
0.384615385,0.307692308,34.41666667,12/20/2009,,,20,22,away,7,KCC,66,323,20,67,41,34,Win,351,168,0,1,1,CLE,75,417,491,3
0.307692308,0.384615385,25.58333333,12/20/2009,,,22,20,home,-7,CLE,323,66,34,71,34,41,Loss,168,351,1,0,3,KCC,75,491,417,1
0.357142857,0.533333333,30.66666667,12/20/2009,,,22,15,away,3,LAR,367,149,30,64,16,13,Win,52,88,0,3,2,HOU,29,419,237,2
0.533333333,0.357142857,29.33333333,12/20/2009,,,15,22,home,-3,HOU,149,367,15,56,13,16,Loss,88,52,3,0,2,LAR,29,237,419,2
0.388888889,0.333333333,29.6,12/20/2009,,,12,17,away,3,NYJ,152,215,25,62,10,7,Win,86,99,0,2,3,ATL,17,238,314,0
0.333333333,0.388888889,30.4,12/20/2009,,,17,12,home,-3,ATL,215,152,65,67,7,10,Loss,99,86,2,0,0,NYJ,17,314,238,3
0.466666667,0.454545455,31.76666667,12/20/2009,,,19,20,away,-3,LAC,293,296,55,63,24,27,Loss,114,70,2,2,2,CIN,51,407,366,1
0.454545455,0.466666667,28.23333333,12/20/2009,,,20,19,home,3,CIN,296,293,30,60,27,24,Win,70,114,2,2,1,LAC,51,366,407,2
0.307692308,0.266666667,31.43333333,12/20/2009,,,22,19,away,1,DEN,102,257,62,64,20,19,Win,241,80,1,3,0,OAK,39,343,337,2
0.266666667,0.307692308,28.56666667,12/20/2009,,,19,22,home,-1,OAK,257,102,67,65,19,20,Loss,80,241,3,1,2,DEN,39,337,343,0
0,0.428571429,28.95,12/20/2009,,,13,21,away,-14,PHI,154,306,55,58,13,27,Loss,107,116,3,0,2,SFO,40,261,422,4
0.428571429,0,31.05,12/20/2009,,,21,13,home,14,SFO,306,154,69,69,27,13,Win,116,107,0,3,4,PHI,40,422,261,2
0.625,0.4375,24.63333333,12/20/2009,,,18,28,away,-1,PIT,376,472,53,61,36,37,Loss,60,65,1,5,0,GBP,73,436,537,0
0.4375,0.625,35.36666667,12/20/2009,,,28,18,home,1,GBP,472,376,84,70,37,36,Win,65,60,5,1,0,PIT,73,537,436,0
0.333333333,0.333333333,27.7,12/20/2009,,,13,18,away,-24,BAL,98,222,9,64,7,31,Loss,122,124,2,2,1,CHI,38,220,346,6
0.333333333,0.333333333,32.3,12/20/2009,,,18,13,home,24,CHI,222,98,26,66,31,7,Win,124,122,2,2,6,BAL,38,346,220,1
0.4375,0.384615385,32.06666667,12/20/2009,,,15,23,away,17,SEA,205,252,35,60,24,7,Win,134,128,0,1,5,TBB,31,339,380,1
0.384615385,0.4375,27.93333333,12/20/2009,,,23,15,home,-17,TBB,252,205,50,72,7,24,Loss,128,134,1,0,1,SEA,31,380,339,5
0.1,0.470588235,22.01666667,12/20/2009,,,10,23,away,-19,CAR,196,273,45,45,7,26,Loss,41,124,4,2,0,MIN,33,237,397,2
0.470588235,0.1,37.98333333,12/20/2009,,,23,10,home,19,MIN,273,196,49,75,26,7,Win,124,41,2,4,2,CAR,33,397,237,0
0.733333333,0.416666667,34.25,12/21/2009,,,23,15,away,33,WAS,273,213,15,62,45,12,Win,114,89,2,5,3,NYG,57,387,302,0
0.416666667,0.733333333,25.75,12/21/2009,,,15,23,home,-33,NYG,213,273,52,55,12,45,Loss,89,114,5,2,0,WAS,57,302,387,3
0.727272727,0.25,39.11666667,12/25/2009,,,30,17,away,25,TEN,259,88,45,69,42,17,Win,166,182,1,1,3,LAC,59,425,270,1
0.25,0.727272727,20.88333333,12/25/2009,,,17,30,home,-25,LAC,88,259,74,49,17,42,Loss,182,166,1,1,1,TEN,59,270,425,3
0.2,0.470588235,25.58333333,12/27/2009,,,11,24,away,-28,ATL,138,234,60,49,3,31,Loss,40,157,2,3,0,BUF,34,178,391,3
0.470588235,0.2,34.41666667,12/27/2009,,,24,11,home,28,BUF,234,138,70,75,31,3,Win,157,40,3,2,3,ATL,34,391,178,0
0.466666667,0.466666667,26.13333333,12/27/2009,,,17,17,away,-7,CIN,172,130,40,66,10,17,Loss,123,144,1,1,1,KCC,27,295,274,2
0.466666667,0.466666667,33.86666667,12/27/2009,,,17,17,home,7,KCC,130,172,36,62,17,10,Win,144,123,1,1,2,CIN,27,274,295,1
0.230769231,0.375,29.63333333,12/27/2009,,,19,16,away,-14,CLE,301,118,126,68,9,23,Loss,88,164,4,2,1,OAK,32,389,282,3
0.375,0.230769231,30.36666667,12/27/2009,,,16,19,home,14,OAK,118,301,64,65,23,9,Win,164,88,2,4,3,CLE,32,282,389,1
0.352941176,0.571428571,27.76666667,12/27/2009,,,17,20,away,-38,GBP,176,264,86,69,10,48,Loss,115,153,3,1,0,SEA,58,291,417,4
0.571428571,0.352941176,32.23333333,12/27/2009,,,20,17,home,38,SEA,264,176,50,62,48,10,Win,153,115,1,3,4,GBP,58,417,291,0
0.384615385,0.384615385,32.55,12/27/2009,,,20,17,away,-3,PIT,148,238,113,67,20,23,Loss,175,48,4,4,2,BAL,43,323,286,3
0.384615385,0.384615385,27.45,12/27/2009,,,17,20,home,3,BAL,238,148,20,60,23,20,Win,48,175,4,4,3,PIT,43,286,323,2
0.363636364,0.5,32.63333333,12/27/2009,,,21,23,away,7,MIA,280,303,15,64,27,20,Win,126,60,1,3,1,HOU,47,406,363,1
0.5,0.363636364,27.36666667,12/27/2009,,,23,21,home,-7,HOU,303,280,30,74,20,27,Loss,60,126,3,1,1,MIA,47,363,406,1
0.363636364,0.6,27.58333333,12/27/2009,,,16,26,away,-28,NEP,177,267,5,52,7,35,Loss,98,197,2,0,1,JAX,42,275,464,2
0.6,0.363636364,32.41666667,12/27/2009,,,26,16,home,28,JAX,267,177,10,62,35,7,Win,197,98,0,2,2,NEP,42,464,275,1
0.583333333,0.545454545,36.25,12/27/2009,,,24,23,away,3,NOS,263,249,42,68,3,0,Win,176,124,3,1,1,TBB,3,439,373,2
0.545454545,0.583333333,30.65,12/27/2009,,,23,24,home,-3,TBB,249,263,14,61,0,3,Loss,124,176,1,3,2,NOS,3,373,439,1
0.666666667,0.384615385,32.26666667,12/27/2009,,,25,22,away,32,NYG,169,257,20,67,41,9,Win,247,60,1,4,4,CAR,50,416,317,0
0.384615385,0.666666667,27.73333333,12/27/2009,,,22,25,home,-32,CAR,257,169,29,66,9,41,Loss,60,247,4,1,0,NYG,50,317,416,4
0.428571429,0.357142857,25.81666667,12/27/2009,,,14,26,away,-21,ARI,150,297,20,57,10,31,Loss,88,110,4,2,1,LAR,41,238,407,4
0.357142857,0.428571429,34.18333333,12/27/2009,,,26,14,home,21,LAR,297,150,15,72,31,10,Win,110,88,2,4,4,ARI,41,407,238,1
0.166666667,0.294117647,29.36666667,12/27/2009,,,16,13,away,-14,SFO,175,226,10,66,6,20,Loss,114,84,2,1,1,DET,26,289,310,6
0.294117647,0.166666667,30.63333333,12/27/2009,,,13,16,home,14,DET,226,175,29,64,20,6,Win,84,114,1,2,6,SFO,26,310,289,1
0.333333333,0.307692308,29.28333333,12/27/2009,,,13,22,away,-3,PHI,171,289,95,62,27,30,Loss,70,105,3,4,3,DEN,57,241,394,1
0.307692308,0.333333333,30.71666667,12/27/2009,,,22,13,home,3,DEN,289,171,59,67,30,27,Win,105,70,4,3,1,PHI,57,394,241,3
0.4375,0.181818182,33.1,12/27/2009,,,17,18,away,14,IND,91,222,52,65,29,15,Win,202,64,2,2,2,NYJ,44,293,286,0
0.181818182,0.4375,26.9,12/27/2009,,,18,17,home,-14,NYJ,222,91,15,57,15,29,Loss,64,202,2,2,0,IND,44,286,293,2
0.538461538,0.285714286,35.03333333,12/27/2009,,,22,15,away,17,WAS,285,165,21,69,17,0,Win,108,43,1,4,1,DAL,17,393,208,1
0.285714286,0.538461538,24.96666667,12/27/2009,,,15,22,home,-17,DAL,165,285,33,60,0,17,Loss,43,108,4,1,1,WAS,17,208,393,1
0.357142857,0.357142857,36.41666667,12/28/2009,,,26,19,away,-6,CHI,300,258,47,76,0,6,Loss,123,105,3,2,1,MIN,6,423,363,2
0.357142857,0.357142857,29.33333333,12/28/2009,,,19,26,home,6,MIN,258,300,31,65,6,0,Win,105,123,2,3,2,CHI,6,363,423,1
0.272727273,0.357142857,22.43333333,1/3/2010,,,11,19,away,-23,BUF,132,155,15,52,7,30,Loss,25,248,1,0,0,IND,37,157,403,3
0.357142857,0.272727273,37.56666667,1/3/2010,,,19,11,home,23,IND,155,132,40,67,30,7,Win,248,25,0,1,3,BUF,37,403,157,0
0.529411765,0.357142857,27.03333333,1/3/2010,,,18,18,away,-6,CLE,197,86,20,66,17,23,Loss,131,214,3,0,1,JAX,40,328,300,1
0.357142857,0.529411765,32.96666667,1/3/2010,,,18,18,home,6,JAX,86,197,15,60,23,17,Win,214,131,0,3,1,CLE,40,300,328,1
0.466666667,0.357142857,29.21666667,1/3/2010,,,22,18,away,14,DET,268,249,35,66,37,23,Win,150,100,2,2,2,CHI,60,418,349,0
0.357142857,0.466666667,30.78333333,1/3/2010,,,18,22,home,-14,CHI,249,268,35,61,23,37,Loss,100,150,2,2,0,DET,60,349,418,2
0.466666667,0.466666667,35.48333333,1/3/2010,,,24,13,away,10,TBB,214,166,15,73,20,10,Win,183,40,1,1,2,ATL,30,397,206,3
0.466666667,0.466666667,24.51666667,1/3/2010,,,13,24,home,-10,ATL,166,214,51,55,10,20,Loss,40,183,1,1,3,TBB,30,206,397,2
0.153846154,0.2,29.36666667,1/3/2010,,,14,15,away,-13,CAR,102,149,35,61,10,23,Loss,111,178,0,2,0,NOS,33,213,327,3
0.2,0.153846154,30.63333333,1/3/2010,,,15,14,home,13,NOS,149,102,29,62,23,10,Win,178,111,2,0,3,CAR,33,327,213,0
0.4,0.428571429,28.43333333,1/3/2010,,,21,29,away,-7,HOU,243,295,55,59,27,34,Loss,74,144,2,1,1,NEP,61,317,439,2
0.428571429,0.4,31.56666667,1/3/2010,,,29,21,home,7,NEP,295,243,35,67,34,27,Win,144,74,1,2,2,HOU,61,439,317,1
0.266666667,0.111111111,33.13333333,1/3/2010,,,16,6,away,22,LAR,204,22,40,63,28,6,Win,125,87,3,8,0,SFO,34,329,109,0
0.111111111,0.266666667,26.86666667,1/3/2010,,,6,16,home,-22,SFO,22,204,50,62,6,28,Loss,87,125,8,3,0,LAR,34,109,329,0
0.5,0.583333333,32.15,1/3/2010,,,22,20,away,6,MIA,201,204,40,67,30,24,Win,202,99,3,3,3,PIT,54,403,303,2
0.583333333,0.5,27.85,1/3/2010,,,20,22,home,-6,PIT,204,201,45,58,24,30,Loss,99,202,3,3,2,MIA,54,303,403,3
0.125,0.333333333,23.13333333,1/3/2010,,,11,28,away,-37,MIN,146,358,95,43,7,44,Loss,35,129,3,0,0,NYG,51,181,487,2
0.333333333,0.125,36.86666667,1/3/2010,,,28,11,home,37,NYG,358,146,45,69,44,7,Win,129,35,0,3,2,MIN,51,487,181,0
0.25,0.384615385,19.61666667,1/3/2010,,,10,21,away,-24,DAL,191,295,58,50,0,24,Loss,37,179,4,2,1,PHI,24,228,474,1
0.384615385,0.25,40.38333333,1/3/2010,,,21,10,home,24,PHI,295,191,80,68,24,0,Win,179,37,2,4,1,DAL,24,474,228,1
0.416666667,0.5,37.45,1/3/2010,,,24,13,away,26,ARI,236,139,19,64,33,7,Win,109,48,1,0,3,GBP,40,345,187,1
0.5,0.416666667,22.55,1/3/2010,,,13,24,home,-26,GBP,139,236,76,45,7,33,Loss,48,109,0,1,1,ARI,40,187,345,3
0.5,0.461538462,32.55,1/3/2010,,,18,19,away,-3,LAC,275,314,14,65,20,23,Loss,66,50,1,1,1,WAS,43,341,364,0
0.461538462,0.5,27.45,1/3/2010,,,19,18,home,3,WAS,314,275,17,63,23,20,Win,50,66,1,1,0,LAC,43,364,341,1
0.428571429,0.307692308,32.36666667,1/3/2010,,,19,16,away,4,SEA,171,169,76,67,17,13,Win,133,140,0,3,1,TEN,30,304,309,2
0.307692308,0.428571429,27.63333333,1/3/2010,,,16,19,home,-4,TEN,169,171,40,60,13,17,Loss,140,133,3,0,2,SEA,30,309,304,1
0.428571429,0.461538462,27.76666667,1/3/2010,,,16,20,away,8,OAK,90,274,37,58,21,13,Win,240,51,4,3,2,BAL,34,330,325,0
0.461538462,0.428571429,32.23333333,1/3/2010,,,20,16,home,-8,BAL,274,90,30,62,13,21,Loss,51,240,3,4,0,OAK,34,325,330,2
0.3,0.466666667,26.95,1/3/2010,,,22,30,away,20,DEN,207,428,76,60,44,24,Win,317,84,0,2,3,KCC,68,524,512,2
0.466666667,0.3,33.05,1/3/2010,,,30,22,home,-20,KCC,428,207,54,80,24,44,Loss,84,317,2,0,2,DEN,68,512,524,3
0.090909091,0.611111111,18.76666667,1/3/2010,,,5,21,away,-37,NYJ,0,63,44,40,0,37,Loss,72,257,3,0,0,CIN,37,72,320,3
0.611111111,0.090909091,41.23333333,1/3/2010,,,21,5,home,37,CIN,63,0,20,73,37,0,Win,257,72,0,3,3,NYJ,37,320,72,0
0.25,0.357142857,33.03333333,1/9/2010,,,15,18,away,10,CIN,182,110,76,56,24,14,Win,171,171,0,3,2,NYJ,38,353,281,0
0.357142857,0.25,26.96666667,1/9/2010,,,18,15,home,-10,NYJ,110,182,55,61,14,24,Loss,171,171,3,0,0,CIN,38,281,353,2
0.181818182,0.5625,20.43333333,1/9/2010,,,17,27,away,-20,DAL,284,228,116,56,14,34,Loss,56,198,4,2,1,PHI,48,340,426,4
0.5625,0.181818182,39.56666667,1/9/2010,,,27,17,home,20,PHI,228,284,112,72,34,14,Win,198,56,2,4,4,DAL,48,426,340,1
0.625,0.25,32.35,1/10/2010,,,16,15,away,19,NEP,34,132,15,62,33,14,Win,234,64,0,3,4,BAL,47,268,196,2
0.25,0.625,27.65,1/10/2010,,,15,16,home,-19,BAL,132,34,41,63,14,33,Loss,64,234,3,0,2,NEP,47,196,268,4
0.454545455,0.6,29.85,1/10/2010,,,32,30,away,-6,ARI,404,375,76,67,0,6,Loss,89,156,5,1,1,GBP,6,493,531,3
0.6,0.454545455,31.45,1/10/2010,,,30,32,home,6,GBP,375,404,56,57,6,0,Win,156,89,1,5,3,ARI,6,531,493,1
0.125,0.538461538,23.55,1/16/2010,,,15,27,away,-31,NOS,258,247,22,52,14,45,Loss,101,171,1,0,0,ARI,59,359,418,2
0.538461538,0.125,36.45,1/16/2010,,,27,15,home,31,ARI,247,258,44,66,45,14,Win,171,101,0,1,2,NOS,59,418,359,0
0.384615385,0.4,26.03333333,1/16/2010,,,12,22,away,-17,IND,183,233,64,55,3,20,Loss,87,42,1,2,1,BAL,23,270,275,4
0.4,0.384615385,33.96666667,1/16/2010,,,22,12,home,17,BAL,233,183,25,71,20,3,Win,42,87,2,1,4,IND,23,275,270,1
0.230769231,0.307692308,30.56666667,1/17/2010,,,16,16,away,-31,MIN,156,214,10,66,3,34,Loss,92,109,6,3,0,DAL,37,248,323,3
0.307692308,0.230769231,29.43333333,1/17/2010,,,16,16,home,31,DAL,214,156,50,60,34,3,Win,109,92,3,6,3,MIN,37,323,248,0
0.375,0.307692308,31.51666667,1/17/2010,,,14,18,away,3,LAC,93,283,37,63,17,14,Win,169,61,1,2,2,NYJ,31,262,344,1
0.307692308,0.375,28.48333333,1/17/2010,,,18,14,home,-3,NYJ,283,93,87,60,14,17,Loss,61,169,2,1,1,LAC,31,344,262,2
0.428571429,0.363636364,28.58333333,1/24/2010,,,17,27,away,-13,IND,302,360,46,60,17,30,Loss,86,101,0,2,1,NYJ,47,388,461,1
0.363636364,0.428571429,31.41666667,1/24/2010,,,27,17,home,13,NYJ,360,302,5,65,30,17,Win,101,86,2,0,1,IND,47,461,388,1
0.583333333,0.25,36.81666667,1/24/2010,,,31,15,away,-3,NOS,310,189,32,82,0,3,Loss,165,68,0,1,1,MIN,3,475,257,5
0.25,0.583333333,27.93333333,1/24/2010,,,15,31,home,3,MIN,189,310,88,55,3,0,Win,68,165,1,0,5,NOS,3,257,475,1
0.333333333,0.461538462,30.18333333,2/7/2010,,,20,23,away,14,IND,281,333,19,58,31,17,Win,51,99,1,0,1,NOS,48,332,432,0
0.461538462,0.333333333,29.81666667,2/7/2010,,,23,20,home,-14,NOS,333,281,45,64,17,31,Loss,99,51,0,1,0,IND,48,432,332,1
0.384615385,0.272727273,26.28333333,9/9/2010,,,12,18,away,-5,NOS,162,229,60,51,9,14,Loss,91,79,1,1,0,MIN,23,253,308,1
0.272727273,0.384615385,33.71666667,9/9/2010,,,18,12,home,5,MIN,229,162,20,62,14,9,Win,79,91,1,1,1,NOS,23,308,253,0
0.444444444,0.214285714,36.88333333,9/12/2010,,,19,9,away,5,BUF,164,116,15,73,15,10,Win,132,50,3,3,0,MIA,25,296,166,0
0.214285714,0.444444444,23.11666667,9/12/2010,,,9,19,home,-5,MIA,116,164,35,54,10,15,Loss,50,132,3,3,0,BUF,25,166,296,0
0.375,0.285714286,30.48333333,9/12/2010,,,18,14,away,-6,PIT,237,211,24,71,0,6,Loss,58,143,2,3,1,ATL,6,295,354,1
0.285714286,0.375,32.1,9/12/2010,,,14,18,home,6,ATL,211,237,25,60,6,0,Win,143,58,3,2,1,PIT,6,354,295,1
0.3,0.3,30.5,9/12/2010,,,21,18,away,-7,JAX,274,165,70,61,17,24,Loss,89,134,3,1,0,DEN,41,363,299,2
0.3,0.3,29.5,9/12/2010,,,18,21,home,7,DEN,165,274,47,56,24,17,Win,134,89,1,3,2,JAX,41,299,363,0
0.333333333,0.545454545,29.11666667,9/12/2010,,,25,23,away,-10,HOU,419,98,73,69,24,34,Loss,44,257,2,2,1,IND,58,463,355,1
0.545454545,0.333333333,30.88333333,9/12/2010,,,23,25,home,10,IND,98,419,50,61,34,24,Win,257,44,2,2,1,HOU,58,355,463,1
0.384615385,0.411764706,27.65,9/12/2010,,,15,13,away,-3,TBB,236,169,47,61,14,17,Loss,104,119,0,3,2,CLE,31,340,288,3
0.411764706,0.384615385,32.35,9/12/2010,,,13,15,home,3,CLE,169,236,55,61,17,14,Win,119,104,3,0,3,TBB,31,288,340,2
0.470588235,0.357142857,25.35,9/12/2010,,,14,21,away,-13,NYG,148,258,63,63,18,31,Loss,89,118,4,1,4,CAR,49,237,376,5
0.357142857,0.470588235,34.65,9/12/2010,,,21,14,home,13,CAR,258,148,95,67,31,18,Win,118,89,1,4,5,NYG,49,376,237,4
0.533333333,0.692307692,31.83333333,9/12/2010,,,26,20,away,-14,NEP,341,258,5,76,24,38,Loss,87,118,1,0,0,CIN,62,428,376,2
0.692307692,0.533333333,28.16666667,9/12/2010,,,20,26,home,14,CIN,258,341,30,58,38,24,Win,118,87,0,1,2,NEP,62,376,428,0
0.214285714,0.533333333,28.93333333,9/12/2010,,,21,17,away,-25,TEN,150,140,77,67,13,38,Loss,136,205,4,2,1,OAK,51,286,345,2
0.533333333,0.214285714,31.06666667,9/12/2010,,,17,21,home,25,OAK,140,150,81,58,38,13,Win,205,136,2,4,2,TEN,51,345,286,1
0.285714286,0.428571429,25.3,9/12/2010,,,13,23,away,-5,CHI,148,362,40,57,14,19,Loss,20,101,2,4,4,DET,33,168,463,3
0.428571429,0.285714286,34.7,9/12/2010,,,23,13,home,5,DET,362,148,100,70,19,14,Win,101,20,4,2,3,CHI,33,463,168,4
0.384615385,0.4,27.15,9/12/2010,,,21,20,away,4,LAR,266,240,72,64,17,13,Win,112,85,2,2,4,ARI,30,378,325,4
0.4,0.384615385,32.85,9/12/2010,,,20,21,home,-4,ARI,240,266,40,81,13,17,Loss,85,112,2,2,4,LAR,30,325,378,4
0.428571429,0.384615385,31.91666667,9/12/2010,,,22,16,away,7,PHI,167,171,15,67,27,20,Win,132,149,3,6,1,GBP,47,299,320,2
0.384615385,0.428571429,28.08333333,9/12/2010,,,16,22,home,-7,GBP,171,167,80,60,20,27,Loss,149,132,6,3,2,PHI,47,320,299,1
0.066666667,0.454545455,32.75,9/12/2010,,,14,14,away,-25,SEA,214,165,60,66,6,31,Loss,49,77,2,1,1,SFO,37,263,242,2
0.454545455,0.066666667,27.25,9/12/2010,,,14,14,home,25,SFO,165,214,35,47,31,6,Win,77,49,1,2,2,SEA,37,242,263,1
0.384615385,0.230769231,34.05,9/12/2010,,,24,17,away,-6,WAS,277,161,81,71,7,13,Loss,103,89,1,1,0,DAL,20,380,250,1
0.230769231,0.384615385,25.95,9/12/2010,,,17,24,home,6,DAL,161,277,42,56,13,7,Win,89,103,1,1,1,WAS,20,250,380,0
0.578947368,0.090909091,38.53333333,9/13/2010,,,20,6,away,1,NYJ,233,60,38,75,10,9,Win,49,116,2,2,1,BAL,19,282,176,3
0.090909091,0.578947368,21.46666667,9/13/2010,,,6,20,home,-1,BAL,60,233,125,44,9,10,Loss,116,49,2,2,3,NYJ,19,176,282,1
0.266666667,0.090909091,37.46666667,9/13/2010,,,18,9,away,-7,KCC,280,62,30,70,14,21,Loss,109,135,2,1,0,LAC,35,389,197,1
0.090909091,0.266666667,22.53333333,9/13/2010,,,9,18,home,7,LAC,62,280,35,49,21,14,Win,135,109,1,2,1,KCC,35,197,389,0
0.133333333,0.285714286,33.66666667,9/19/2010,,,7,14,away,8,TEN,21,192,35,54,19,11,Win,106,46,4,4,7,PIT,30,127,238,1
0.285714286,0.133333333,26.33333333,9/19/2010,,,14,7,home,-8,PIT,192,21,72,61,11,19,Loss,46,106,4,4,1,TEN,30,238,127,7
0.428571429,0.3125,30.81666667,9/19/2010,,,14,16,away,13,CAR,178,159,30,59,20,7,Win,95,119,0,4,3,TBB,27,273,278,0
0.3125,0.428571429,29.18333333,9/19/2010,,,16,14,home,-13,TBB,159,178,48,66,7,20,Loss,119,95,4,0,0,CAR,27,278,273,3
0.333333333,0.307692308,33.21666667,9/19/2010,,,16,13,away,2,CLE,172,226,30,68,16,14,Win,140,73,1,1,2,KCC,30,312,299,2
0.307692308,0.333333333,26.78333333,9/19/2010,,,13,16,home,-2,KCC,226,172,78,58,14,16,Loss,73,140,1,1,2,CLE,30,299,312,2
0.454545455,0.357142857,24.2,9/19/2010,,,12,22,away,4,MIN,106,208,15,46,14,10,Win,120,156,2,3,4,MIA,24,226,364,2
0.357142857,0.454545455,35.8,9/19/2010,,,22,12,home,-4,MIA,208,106,44,72,10,14,Loss,156,120,3,2,2,MIN,24,364,226,4
0,0.647058824,20.78333333,9/19/2010,,,11,33,away,-34,ATL,149,223,109,48,7,41,Loss,118,221,2,1,1,ARI,48,267,444,3
0.647058824,0,39.21666667,9/19/2010,,,33,11,home,34,ARI,223,149,75,78,41,7,Win,221,118,1,2,3,ATL,48,444,267,1
0.428571429,0.4,30.86666667,9/19/2010,,,24,22,away,3,DET,248,329,75,68,35,32,Win,162,115,5,2,2,PHI,67,410,444,0
0.4,0.428571429,29.13333333,9/19/2010,,,22,24,home,-3,PHI,329,248,51,73,32,35,Loss,115,162,2,5,0,DET,67,444,410,2
0.090909091,0.461538462,26.33333333,9/19/2010,,,14,23,away,7,DAL,270,374,10,49,27,20,Win,38,36,1,0,3,CHI,47,308,410,0
0.461538462,0.090909091,33.66666667,9/19/2010,,,23,14,home,-7,CHI,374,270,50,71,20,27,Loss,36,38,0,1,0,DAL,47,410,308,3
0.266666667,0.166666667,25.73333333,9/19/2010,,,14,14,away,-5,CIN,150,159,45,63,10,15,Loss,109,94,1,1,0,BAL,25,259,253,4
0.166666667,0.266666667,34.26666667,9/19/2010,,,14,14,home,5,BAL,159,150,56,67,15,10,Win,94,109,1,1,4,CIN,25,253,259,0
0.333333333,0.583333333,29.06666667,9/19/2010,,,14,18,away,-27,GBP,62,255,35,54,7,34,Loss,124,91,4,0,0,BUF,41,186,346,2
0.583333333,0.333333333,30.93333333,9/19/2010,,,18,14,home,27,BUF,255,62,49,56,34,7,Win,91,124,0,4,2,GBP,41,346,186,0
0.2,0.411764706,23.18333333,9/19/2010,,,16,25,away,-2,OAK,135,231,92,49,14,16,Loss,75,173,3,2,2,LAR,30,210,404,1
0.411764706,0.2,36.81666667,9/19/2010,,,25,16,home,2,LAR,231,135,90,78,16,14,Win,173,75,2,3,1,OAK,30,404,210,2
0.636363636,0.7,22.55,9/19/2010,,,17,23,away,-17,DEN,230,304,64,56,14,31,Loss,109,65,1,1,0,SEA,45,339,369,4
0.7,0.636363636,37.45,9/19/2010,,,23,17,home,17,SEA,304,230,35,74,31,14,Win,65,109,1,1,4,DEN,45,369,339,0
0.428571429,0.2,39.81666667,9/19/2010,,,29,21,away,3,WAS,468,403,45,81,3,0,Win,58,18,5,3,0,HOU,3,526,421,1
0.2,0.428571429,31.78333333,9/19/2010,,,21,29,home,-3,HOU,403,468,58,58,0,3,Loss,18,58,3,5,1,WAS,3,421,526,0
0.454545455,0.461538462,27.46666667,9/19/2010,,,20,23,away,-14,NYJ,239,200,79,57,14,28,Loss,52,136,1,3,0,NEP,42,291,336,3
0.461538462,0.454545455,32.53333333,9/19/2010,,,23,20,home,14,NEP,200,239,58,65,28,14,Win,136,52,3,1,3,NYJ,42,336,291,0
0.5,0.5,30.4,9/19/2010,,,20,25,away,-25,LAC,279,326,33,68,13,38,Loss,71,151,2,1,3,JAX,51,350,477,6
0.5,0.5,29.6,9/19/2010,,,25,20,home,25,JAX,326,279,25,60,38,13,Win,151,71,1,2,6,LAC,51,477,350,3
0.272727273,0.363636364,24.9,9/19/2010,,,13,24,away,-24,IND,137,250,25,53,14,38,Loss,120,160,4,1,1,NYG,52,257,410,3
0.363636364,0.272727273,35.1,9/19/2010,,,24,13,home,24,NYG,250,137,55,70,38,14,Win,160,120,1,4,3,IND,52,410,257,1
0.428571429,0.555555556,32.66666667,9/20/2010,,,17,24,away,3,SFO,237,275,54,64,25,22,Win,50,142,2,0,4,NOS,47,287,417,0
0.555555556,0.428571429,27.33333333,9/20/2010,,,24,17,home,-3,NOS,275,237,40,58,22,25,Loss,142,50,0,2,0,SFO,47,417,287,4
0.5,0.583333333,27.8,9/26/2010,,,19,25,away,-8,NEP,240,245,45,53,30,38,Loss,134,200,1,1,1,BUF,68,374,445,2
0.583333333,0.5,32.2,9/26/2010,,,25,19,home,8,BUF,245,240,35,66,38,30,Win,200,134,1,1,2,NEP,68,445,374,1
0.25,0.272727273,28.13333333,9/26/2010,,,17,21,away,-14,MIN,232,185,67,63,10,24,Loss,63,183,1,2,3,DET,34,295,368,3
0.272727273,0.25,31.86666667,9/26/2010,,,21,17,home,14,DET,185,232,100,66,24,10,Win,183,63,2,1,3,MIN,34,368,295,3
0.294117647,0.181818182,36.36666667,9/26/2010,,,21,17,away,13,CAR,185,180,74,75,20,7,Win,120,87,1,1,4,CIN,27,305,267,2
0.181818182,0.294117647,23.63333333,9/26/2010,,,17,21,home,-13,CIN,180,185,45,58,7,20,Loss,87,120,1,1,2,CAR,27,267,305,4
0.5,0.545454545,45.83333333,9/26/2010,,,25,20,away,3,NOS,215,355,40,82,3,0,Win,202,43,2,2,3,ATL,3,417,398,1
0.545454545,0.5,27.25,9/26/2010,,,20,25,home,-3,ATL,355,215,38,56,0,3,Loss,43,202,2,2,1,NOS,3,398,417,3
0.444444444,0.428571429,26.9,9/26/2010,,,17,18,away,25,TBB,186,228,20,49,38,13,Win,201,75,0,4,2,PIT,51,387,303,2
0.428571429,0.444444444,33.1,9/26/2010,,,18,17,home,-25,PIT,228,186,45,62,13,38,Loss,75,201,4,0,2,TBB,51,303,387,2
0.363636364,0.5,29.86666667,9/26/2010,,,18,19,away,-7,BAL,131,256,60,55,17,24,Loss,173,109,2,0,0,CLE,41,304,365,0
0.5,0.363636364,30.13333333,9/26/2010,,,19,18,home,7,CLE,256,131,60,59,24,17,Win,109,173,0,2,0,BAL,41,365,304,0
0.461538462,0.5,28.36666667,9/26/2010,,,17,26,away,19,NYG,110,364,80,58,29,10,Win,161,107,1,2,3,TEN,39,271,471,0
0.5,0.461538462,31.63333333,9/26/2010,,,26,17,home,-19,TEN,364,110,86,70,10,29,Loss,107,161,2,1,0,NYG,39,471,271,3
0.235294118,0.5,26.16666667,9/26/2010,,,11,21,away,-21,KCC,208,250,55,62,10,31,Loss,43,207,5,0,1,SFO,41,251,457,1
0.5,0.235294118,33.83333333,9/26/2010,,,21,11,home,21,SFO,250,208,40,66,31,10,Win,207,43,0,5,1,KCC,41,457,251,1
0.363636364,0.444444444,32.33333333,9/26/2010,,,21,24,away,14,HOU,284,216,49,57,27,13,Win,101,124,0,4,3,DAL,40,385,340,0
0.444444444,0.363636364,27.66666667,9/26/2010,,,24,21,home,-14,DAL,216,284,32,58,13,27,Loss,124,101,4,0,0,HOU,40,340,385,3
0.1,0.4375,25.16666667,9/26/2010,,,15,24,away,-14,LAR,233,232,65,50,16,30,Loss,116,133,1,1,2,WAS,46,349,365,2
0.4375,0.1,34.83333333,9/26/2010,,,24,15,home,14,WAS,232,233,99,75,30,16,Win,133,116,1,1,2,LAR,46,365,349,2
0.384615385,0.294117647,27.11666667,9/26/2010,,,15,16,away,25,JAX,267,52,84,55,28,3,Win,106,139,3,7,1,PHI,31,373,191,0
0.294117647,0.384615385,32.88333333,9/26/2010,,,16,15,home,-25,PHI,52,267,67,69,3,28,Loss,139,106,7,3,0,JAX,31,191,373,1
0.428571429,0.461538462,36.06666667,9/26/2010,,,27,13,away,-7,SEA,429,203,83,78,20,27,Loss,89,68,4,3,2,LAC,47,518,271,5
0.461538462,0.428571429,23.93333333,9/26/2010,,,13,27,home,7,LAC,203,429,32,56,27,20,Win,68,89,3,4,5,SEA,47,271,518,2
0.266666667,0.384615385,32.96666667,9/26/2010,,,20,18,away,-1,ARI,231,108,123,70,23,24,Loss,133,119,3,2,3,OAK,47,364,227,1
0.384615385,0.266666667,27.03333333,9/26/2010,,,18,20,home,1,OAK,108,231,104,54,24,23,Win,119,133,2,3,1,ARI,47,227,364,3
0.428571429,0.333333333,30.13333333,9/26/2010,,,18,23,away,14,DEN,325,472,27,65,27,13,Win,40,47,0,1,2,IND,40,365,519,0
0.333333333,0.428571429,29.86666667,9/26/2010,,,23,18,home,-14,IND,472,325,60,76,13,27,Loss,47,40,1,0,0,DEN,40,519,365,2
0.545454545,0.466666667,27.2,9/26/2010,,,20,24,away,8,MIA,256,352,81,57,31,23,Win,146,84,0,2,1,NYJ,54,402,436,0
0.466666667,0.545454545,32.8,9/26/2010,,,24,20,home,-8,NYJ,352,256,52,70,23,31,Loss,84,146,2,0,0,MIA,54,436,402,1
0.4,0.333333333,35.81666667,9/27/2010,,,21,18,away,-3,CHI,316,199,152,60,17,20,Loss,63,77,0,3,1,GBP,37,379,276,2
0.333333333,0.4,24.18333333,9/27/2010,,,18,21,home,3,GBP,199,316,38,48,20,17,Win,77,63,3,0,2,CHI,37,276,379,1
0.466666667,0,40.48333333,10/3/2010,,,25,12,away,24,BUF,171,109,30,75,38,14,Win,273,114,0,3,2,NYJ,52,444,223,0
0,0.466666667,19.51666667,10/3/2010,,,12,25,home,-24,NYJ,109,171,32,46,14,38,Loss,114,273,3,0,0,BUF,52,223,444,2
0.266666667,0.4375,27.16666667,10/3/2010,,,15,19,away,-17,LAR,193,261,49,65,3,20,Loss,64,88,4,4,1,SEA,23,257,349,2
0.4375,0.266666667,32.83333333,10/3/2010,,,19,15,home,17,SEA,261,193,41,73,20,3,Win,88,64,4,4,2,LAR,23,349,257,1
0.5,0.357142857,30.68333333,10/3/2010,,,17,23,away,-2,ATL,181,259,41,56,14,16,Loss,81,98,1,3,2,SFO,30,262,357,3
0.357142857,0.5,29.31666667,10/3/2010,,,23,17,home,2,SFO,259,181,60,75,16,14,Win,98,81,3,1,3,ATL,30,357,262,2
0.588235294,0.428571429,37.61666667,10/3/2010,,,24,16,away,-2,GBP,308,169,102,78,26,28,Loss,123,92,3,2,4,DET,54,431,261,3
0.428571429,0.588235294,22.38333333,10/3/2010,,,16,24,home,2,DET,169,308,31,40,28,26,Win,92,123,2,3,3,GBP,54,261,431,4
0.454545455,0.428571429,29.23333333,10/3/2010,,,21,21,away,-3,CLE,346,179,79,58,20,23,Loss,67,116,4,1,1,CIN,43,413,295,2
0.428571429,0.454545455,30.76666667,10/3/2010,,,21,21,home,3,CIN,179,346,44,66,23,20,Win,116,67,1,4,2,CLE,43,295,413,1
0.2,0.25,35.3,10/3/2010,,,22,13,away,6,TEN,308,167,74,76,26,20,Win,19,121,6,2,2,DEN,46,327,288,1
0.25,0.2,24.7,10/3/2010,,,13,22,home,-6,DEN,167,308,111,52,20,26,Loss,121,19,2,6,1,TEN,46,288,327,2
0.333333333,0.571428571,21.63333333,10/3/2010,,,10,27,away,-2,NOS,133,262,66,47,14,16,Loss,118,121,3,2,2,CAR,30,251,383,1
0.571428571,0.333333333,38.36666667,10/3/2010,,,27,10,home,2,CAR,262,133,36,79,16,14,Win,121,118,2,3,1,NOS,30,383,251,2
0.363636364,0.363636364,30.51666667,10/3/2010,,,22,14,away,3,PIT,250,126,52,65,17,14,Win,70,84,1,2,1,BAL,31,320,210,2
0.363636364,0.363636364,29.48333333,10/3/2010,,,14,22,home,-3,BAL,126,250,88,50,14,17,Loss,84,70,2,1,2,PIT,31,210,320,1
0.7,0.692307692,30.23333333,10/3/2010,,,28,20,away,-3,JAX,348,163,35,66,28,31,Loss,58,174,1,0,0,IND,59,406,337,2
0.692307692,0.7,29.76666667,10/3/2010,,,20,28,home,3,IND,163,348,45,57,31,28,Win,174,58,0,1,2,JAX,59,337,406,0
0.461538462,0.416666667,29.48333333,10/3/2010,,,21,24,away,7,OAK,192,245,26,65,31,24,Win,249,118,0,4,3,HOU,55,441,363,0
0.416666667,0.461538462,30.51666667,10/3/2010,,,24,21,home,-7,HOU,245,192,23,68,24,31,Loss,118,249,4,0,0,OAK,55,363,441,3
0.454545455,0.357142857,27.05,10/3/2010,,,16,21,away,5,PHI,124,243,30,55,17,12,Win,169,110,1,1,2,WAS,29,293,353,1
0.357142857,0.454545455,32.95,10/3/2010,,,21,16,home,-5,WAS,243,124,80,68,12,17,Loss,110,169,1,1,1,PHI,29,353,293,2
0.333333333,0.5,25.03333333,10/3/2010,,,10,23,away,-31,LAC,87,239,34,51,10,41,Loss,47,180,9,1,1,ARI,51,134,419,3
0.5,0.333333333,34.96666667,10/3/2010,,,23,10,home,31,ARI,239,87,44,60,41,10,Win,180,47,1,9,3,LAC,51,419,134,1
0,0.25,26.58333333,10/3/2010,,,6,18,away,-14,NYG,51,183,40,52,3,17,Loss,59,189,10,2,3,CHI,20,110,372,3
0.25,0,33.41666667,10/3/2010,,,18,6,home,14,CHI,183,51,44,64,17,3,Win,189,59,2,10,3,NYG,20,372,110,3
0.454545455,0.666666667,27.71666667,10/4/2010,,,19,23,away,27,MIA,146,308,31,59,41,14,Win,119,92,3,2,4,NEP,55,265,400,0
0.666666667,0.454545455,32.28333333,10/4/2010,,,23,19,home,-27,NEP,308,146,40,67,14,41,Loss,92,119,2,3,0,MIA,55,400,265,4
0.2,0.166666667,30.31666667,10/10/2010,,,13,8,away,17,CAR,29,62,45,64,23,6,Win,218,85,3,5,3,CHI,29,247,147,4
0.166666667,0.2,29.68333333,10/10/2010,,,8,13,home,-17,CHI,62,29,53,62,6,23,Loss,85,218,5,3,4,CAR,29,147,247,3
0.1,0.470588235,25.58333333,10/10/2010,,,16,23,away,-10,IND,148,244,38,57,9,19,Loss,113,97,1,1,1,KCC,28,261,341,1
0.470588235,0.1,34.41666667,10/10/2010,,,23,16,home,10,KCC,244,148,45,76,19,9,Win,97,113,1,1,1,IND,28,341,261,1
0.4,0.466666667,30.1,10/10/2010,,,17,18,away,10,CLE,173,221,60,61,20,10,Win,165,48,2,3,3,ATL,30,338,269,1
0.466666667,0.4,29.9,10/10/2010,,,18,17,home,-10,ATL,221,173,58,62,10,20,Loss,48,165,3,2,1,CLE,30,269,338,3
0.384615385,0.538461538,23.71666667,10/10/2010,,,16,28,away,-14,BAL,307,182,90,52,17,31,Loss,39,233,1,1,0,DEN,48,346,415,1
0.538461538,0.384615385,36.28333333,10/10/2010,,,28,16,home,14,DEN,182,307,66,73,31,17,Win,233,39,1,1,1,BAL,48,415,346,0
0.357142857,0.181818182,38.85,10/10/2010,,,26,11,away,24,HOU,297,171,84,74,34,10,Win,117,24,0,3,2,NYG,44,414,195,2
0.181818182,0.357142857,21.15,10/10/2010,,,11,26,home,-24,NYG,171,297,67,52,10,34,Loss,24,117,3,0,2,HOU,44,195,414,2
0.428571429,0.461538462,33.26666667,10/10/2010,,,23,20,away,-38,DET,213,233,40,74,6,44,Loss,128,89,1,1,0,LAR,50,341,322,3
0.461538462,0.428571429,26.73333333,10/10/2010,,,20,23,home,38,LAR,233,213,78,61,44,6,Win,89,128,1,1,3,DET,50,322,341,0
0.153846154,0.294117647,32.66666667,10/10/2010,,,17,21,away,-3,WAS,270,322,63,67,0,3,Loss,157,51,4,5,1,GBP,3,427,373,2
0.294117647,0.153846154,34.23333333,10/10/2010,,,21,17,home,3,GBP,322,270,28,75,3,0,Win,51,157,5,4,2,WAS,3,373,427,1
0.454545455,0.307692308,30.41666667,10/10/2010,,,21,20,away,3,CIN,266,209,25,60,24,21,Win,125,149,3,0,4,TBB,45,391,358,3
0.307692308,0.454545455,29.58333333,10/10/2010,,,20,21,home,-3,TBB,209,266,60,64,21,24,Loss,149,125,0,3,3,CIN,45,358,391,4
0.363636364,0.272727273,34.35,10/10/2010,,,21,17,away,10,BUF,165,196,38,62,36,26,Win,216,110,2,3,0,JAX,62,381,306,3
0.272727273,0.363636364,25.65,10/10/2010,,,17,21,home,-10,JAX,196,165,35,54,26,36,Loss,110,216,3,2,3,BUF,62,306,381,0
0.454545455,0.266666667,30.01666667,10/10/2010,,,19,12,away,-10,ARI,273,153,45,62,20,30,Loss,85,41,1,4,1,NOS,50,358,194,4
0.266666667,0.454545455,29.98333333,10/10/2010,,,12,19,home,10,NOS,153,273,20,57,30,20,Win,41,85,4,1,4,ARI,50,194,358,1
0.416666667,0.4,32.76666667,10/10/2010,,,29,14,away,-8,OAK,415,168,53,71,27,35,Loss,91,111,3,3,0,LAC,62,506,279,3
0.4,0.416666667,27.23333333,10/10/2010,,,14,29,home,8,LAC,168,415,85,58,35,27,Win,111,91,3,3,3,OAK,62,279,506,0
0.333333333,0.5,23.26666667,10/10/2010,,,17,25,away,7,DAL,163,370,40,55,34,27,Win,158,141,3,6,3,TEN,61,321,511,0
0.5,0.333333333,36.73333333,10/10/2010,,,25,17,home,-7,TEN,370,163,133,75,27,34,Loss,141,158,6,3,0,DAL,61,511,321,3
0.25,0.615384615,30.8,10/10/2010,,,17,21,away,3,SFO,227,290,30,62,27,24,Win,125,74,4,2,5,PHI,51,352,364,1
0.615384615,0.25,29.2,10/10/2010,,,21,17,home,-3,PHI,290,227,65,63,24,27,Loss,74,125,2,4,1,SFO,51,364,352,5
0.466666667,0.294117647,26.08333333,10/11/2010,,,16,20,away,-9,NYJ,240,173,51,62,20,29,Loss,96,155,4,2,0,MIN,49,336,328,3
0.294117647,0.466666667,33.91666667,10/11/2010,,,20,16,home,9,MIN,173,240,55,78,29,20,Win,155,96,2,4,3,NYJ,49,328,336,0
0.285714286,0.5,25.95,10/17/2010,,,20,23,away,-14,PHI,228,320,30,64,17,31,Loss,65,154,3,1,1,ATL,48,293,474,2
0.5,0.285714286,34.05,10/17/2010,,,23,20,home,14,ATL,320,228,78,68,31,17,Win,154,65,1,3,2,PHI,48,474,293,1
0.333333333,0.411764706,26.61666667,10/17/2010,,,22,20,away,-3,LAR,208,183,31,61,17,20,Loss,79,117,7,3,0,LAC,37,287,300,1
0.411764706,0.333333333,33.38333333,10/17/2010,,,20,22,home,3,LAC,183,208,35,69,20,17,Win,117,79,3,7,1,LAR,37,300,287,0
0.75,0.4,31.48333333,10/17/2010,,,27,21,away,25,TBB,263,235,80,64,31,6,Win,212,42,0,1,1,NOS,37,475,277,1
0.4,0.75,28.51666667,10/17/2010,,,21,27,home,-25,NOS,235,263,30,66,6,31,Loss,42,212,1,0,1,TBB,37,277,475,1
0.45,0.384615385,27.3,10/17/2010,,,16,24,away,-8,NYG,302,167,91,72,20,28,Loss,64,167,2,2,1,DET,48,366,334,3
0.384615385,0.45,32.7,10/17/2010,,,24,16,home,8,DET,167,302,15,62,28,20,Win,167,64,2,2,3,NYG,48,334,366,1
0.428571429,0.230769231,37.93333333,10/17/2010,,,26,16,away,3,GBP,231,283,30,78,3,0,Win,150,76,0,5,1,MIA,3,381,359,1
0.230769231,0.428571429,28.05,10/17/2010,,,16,26,home,-3,MIA,283,231,45,59,0,3,Loss,76,150,5,0,1,GBP,3,359,381,1
0.388888889,0,34.38333333,10/17/2010,,,20,15,away,3,CHI,242,246,83,71,23,20,Win,111,61,0,6,0,SEA,43,353,307,0
0,0.388888889,25.61666667,10/17/2010,,,15,20,home,-3,SEA,246,242,18,59,20,23,Loss,61,111,6,0,0,CHI,43,307,353,0
0.3125,0.285714286,40.23333333,10/17/2010,,,21,23,away,-3,NEP,278,267,67,72,0,3,Loss,99,127,3,3,2,BAL,3,377,394,0
0.285714286,0.3125,32.83333333,10/17/2010,,,23,21,home,3,BAL,267,278,78,73,3,0,Win,127,99,3,3,0,NEP,3,394,377,2
0.461538462,0.5,28.06666667,10/17/2010,,,17,22,away,-18,PIT,258,257,41,60,10,28,Loss,69,121,6,0,1,CLE,38,327,378,3
0.5,0.461538462,31.93333333,10/17/2010,,,22,17,home,18,CLE,257,258,25,62,28,10,Win,121,69,0,6,3,PIT,38,378,327,1
0.5625,0.5,33.46666667,10/17/2010,,,25,23,away,-4,HOU,189,289,35,68,31,35,Loss,228,132,1,2,0,KCC,66,417,421,0
0.5,0.5625,26.53333333,10/17/2010,,,23,25,home,4,KCC,289,189,53,57,35,31,Win,132,228,2,1,0,HOU,66,421,417,0
0.384615385,0.388888889,29.61666667,10/17/2010,,,17,21,away,4,DEN,190,201,74,62,24,20,Win,129,145,2,1,2,NYJ,44,319,346,3
0.388888889,0.384615385,30.38333333,10/17/2010,,,21,17,home,-4,NYJ,201,190,81,72,20,24,Loss,145,129,1,2,3,DEN,44,346,319,2
0.333333333,0.411764706,26.65,10/17/2010,,,10,17,away,-8,SFO,69,191,60,53,9,17,Loss,110,158,2,2,0,OAK,26,179,349,2
0.411764706,0.333333333,33.35,10/17/2010,,,17,10,home,8,OAK,191,69,143,66,17,9,Win,158,110,2,2,2,SFO,26,349,179,0
0.529411765,0.5,32.16666667,10/17/2010,,,16,14,away,-3,MIN,220,93,91,60,21,24,Loss,94,95,0,3,1,DAL,45,314,188,2
0.5,0.529411765,27.83333333,10/17/2010,,,14,16,home,3,DAL,93,220,45,50,24,21,Win,95,94,3,0,2,MIN,45,188,314,1
0.3,0.307692308,27.5,10/17/2010,,,22,23,away,3,WAS,299,222,15,68,27,24,Win,170,113,1,3,2,IND,51,469,335,3
0.307692308,0.3,32.5,10/17/2010,,,23,22,home,-3,IND,222,299,53,72,24,27,Loss,113,170,3,1,3,WAS,51,335,469,2
0.571428571,0.230769231,32.75,10/18/2010,,,20,17,away,27,JAX,171,173,57,60,30,3,Win,153,76,0,2,4,TEN,33,324,249,0
0.230769231,0.571428571,27.25,10/18/2010,,,17,20,home,-27,TEN,173,171,55,63,3,30,Loss,76,153,2,0,0,JAX,33,249,324,4
0.555555556,0.307692308,33.4,10/24/2010,,,21,15,away,-18,TEN,227,253,100,73,19,37,Loss,99,75,1,3,3,PHI,56,326,328,4
0.307692308,0.555555556,26.6,10/24/2010,,,15,21,home,18,PHI,253,227,37,60,37,19,Win,75,99,3,1,4,TEN,56,328,326,3
0.307692308,0.466666667,23.91666667,10/24/2010,,,15,22,away,-3,CAR,183,303,81,56,20,23,Loss,99,76,2,1,3,SFO,43,282,379,1
0.466666667,0.307692308,36.08333333,10/24/2010,,,22,15,home,3,SFO,303,183,35,76,23,20,Win,76,99,1,2,1,CAR,43,379,282,3
0.3,0.545454545,26,10/24/2010,,,19,25,away,-22,KCC,216,190,43,58,20,42,Loss,84,236,1,1,0,JAX,62,300,426,3
0.545454545,0.3,34,10/24/2010,,,25,19,home,22,JAX,190,216,92,61,42,20,Win,236,84,1,1,3,KCC,62,426,300,0
0.4,0.25,30.81666667,10/24/2010,,,15,15,away,1,MIA,290,249,34,57,23,22,Win,58,64,3,1,2,PIT,45,348,313,2
0.25,0.4,29.18333333,10/24/2010,,,15,15,home,-1,PIT,249,290,24,58,22,23,Loss,64,58,1,3,2,MIA,45,313,348,2
0.583333333,0.538461538,30.36666667,10/24/2010,,,28,22,away,-7,ATL,385,299,36,74,32,39,Loss,84,153,3,0,2,CIN,71,469,452,1
0.538461538,0.583333333,29.63333333,10/24/2010,,,22,28,home,7,CIN,299,385,41,63,39,32,Win,153,84,0,3,1,ATL,71,452,469,2
0.153846154,0.2,29.2,10/24/2010,,,13,19,away,3,CHI,187,256,48,62,17,14,Win,121,66,2,4,6,WAS,31,308,322,3
0.2,0.153846154,30.8,10/24/2010,,,19,13,home,-3,WAS,256,187,51,60,14,17,Loss,66,121,4,2,3,CHI,31,322,308,6
0.181818182,0.333333333,24.43333333,10/24/2010,,,12,25,away,13,NOS,85,336,30,46,30,17,Win,125,58,1,3,4,CLE,47,210,394,0
0.333333333,0.181818182,35.56666667,10/24/2010,,,25,12,home,-13,CLE,336,85,98,77,17,30,Loss,58,125,3,1,0,NOS,47,394,210,4
0.647058824,0.181818182,38.6,10/24/2010,,,27,21,away,-3,BAL,382,229,78,79,0,3,Loss,132,135,1,2,2,BUF,3,514,364,4
0.181818182,0.647058824,25.5,10/24/2010,,,21,27,home,3,BUF,229,382,18,62,3,0,Win,135,132,2,1,4,BAL,3,364,514,2
0.5,0.333333333,28.68333333,10/24/2010,,,19,17,away,-1,TBB,124,189,45,59,17,18,Loss,161,124,1,3,0,LAR,35,285,313,1
0.333333333,0.5,31.31666667,10/24/2010,,,17,19,home,1,LAR,189,124,92,64,18,17,Win,124,161,3,1,1,TBB,35,313,285,0
0.166666667,0.333333333,22.71666667,10/24/2010,,,13,16,away,-12,SEA,114,158,32,55,10,22,Loss,113,144,2,5,1,ARI,32,227,302,5
0.333333333,0.166666667,37.28333333,10/24/2010,,,16,13,home,12,ARI,158,114,95,79,22,10,Win,144,113,5,2,5,SEA,32,302,227,1
0.461538462,0.181818182,38.65,10/24/2010,,,29,11,away,45,DEN,180,165,94,74,59,14,Win,328,75,2,4,3,OAK,73,508,240,0
0.181818182,0.461538462,21.35,10/24/2010,,,11,29,home,-45,OAK,165,180,64,50,14,59,Loss,75,328,4,2,0,DEN,73,240,508,3
0.25,0.466666667,25.58333333,10/24/2010,,,15,23,away,3,LAC,128,325,51,58,23,20,Win,51,38,4,2,4,NEP,43,179,363,0
0.466666667,0.25,34.41666667,10/24/2010,,,23,15,home,-3,NEP,325,128,69,71,20,23,Loss,38,51,2,4,0,LAC,43,363,179,4
0.428571429,0.545454545,31.06666667,10/24/2010,,,21,20,away,-4,GBP,206,295,40,66,24,28,Loss,196,84,1,0,2,MIN,52,402,379,3
0.545454545,0.428571429,28.93333333,10/24/2010,,,20,21,home,4,MIN,295,206,20,58,28,24,Win,84,196,0,1,3,GBP,52,379,402,2
0.384615385,0,37.51666667,10/25/2010,,,25,14,away,6,DAL,297,213,46,73,41,35,Win,200,41,1,3,2,NYG,76,497,254,5
0,0.384615385,22.48333333,10/25/2010,,,14,25,home,-6,NYG,213,297,42,56,35,41,Loss,41,200,3,1,5,DAL,76,254,497,2
0.5,0.4,23.53333333,10/31/2010,,,14,15,away,-10,LAR,176,184,30,57,10,20,Loss,25,62,3,2,0,CAR,30,201,246,4
0.4,0.5,36.46666667,10/31/2010,,,15,14,home,10,CAR,184,176,65,63,20,10,Win,62,25,2,3,4,LAR,30,246,201,0
0.47826087,0.266666667,39.36666667,10/31/2010,,,23,24,away,-3,KCC,191,140,35,84,0,3,Loss,137,274,3,3,0,BUF,3,328,414,1
0.266666667,0.47826087,35.63333333,10/31/2010,,,24,23,home,3,BUF,140,191,50,74,3,0,Win,274,137,3,3,1,KCC,3,414,328,0
0.5,0.461538462,32.58333333,10/31/2010,,,20,25,away,18,DAL,238,365,36,58,35,17,Win,149,50,3,2,4,JAX,52,387,415,1
0.461538462,0.5,27.41666667,10/31/2010,,,25,20,home,-18,JAX,365,238,20,73,17,35,Loss,50,149,2,3,1,DAL,52,415,387,4
0.333333333,0.375,33.48333333,10/31/2010,,,20,16,away,8,CIN,217,156,42,68,22,14,Win,137,106,0,0,1,MIA,36,354,262,2
0.375,0.333333333,26.51666667,10/31/2010,,,16,20,home,-8,MIA,156,217,36,64,14,22,Loss,106,137,0,0,2,CIN,36,262,354,1
0.142857143,0.411764706,28.61666667,10/31/2010,,,13,15,away,9,NYJ,156,241,15,62,9,0,Win,81,119,2,2,3,GBP,9,237,360,0
0.411764706,0.142857143,31.38333333,10/31/2010,,,15,13,home,-9,GBP,241,156,55,69,0,9,Loss,119,81,2,2,0,NYJ,9,360,237,3
0.142857143,0.235294118,27.83333333,10/31/2010,,,13,19,away,-12,DET,195,202,77,63,25,37,Loss,80,102,7,1,2,WAS,62,275,304,2
0.235294118,0.142857143,32.16666667,10/31/2010,,,19,13,home,12,WAS,202,195,65,71,37,25,Win,102,80,1,7,2,DET,62,304,275,2
0.2,0.384615385,26.43333333,10/31/2010,,,22,16,away,-8,SFO,339,196,60,61,16,24,Loss,59,143,4,0,0,DEN,40,398,339,2
0.384615385,0.2,33.56666667,10/31/2010,,,16,22,home,8,DEN,196,339,66,61,24,16,Win,143,59,0,4,2,SFO,40,339,398,0
0.307692308,0.666666667,22.21666667,10/31/2010,,,15,23,away,-8,LAC,305,300,80,55,25,33,Loss,65,156,0,1,1,TEN,58,370,456,0
0.666666667,0.307692308,37.78333333,10/31/2010,,,23,15,home,8,TEN,300,305,62,71,33,25,Win,156,65,1,0,0,LAC,58,456,370,1
0.333333333,0.538461538,30.48333333,10/31/2010,,,19,22,away,3,ARI,253,296,80,57,38,35,Win,154,100,2,1,4,TBB,73,407,396,2
0.538461538,0.333333333,29.51666667,10/31/2010,,,22,19,home,-3,TBB,296,253,12,64,35,38,Loss,100,154,1,2,2,ARI,73,396,407,4
0.0625,0.294117647,23.93333333,10/31/2010,,,10,18,away,-30,OAK,117,306,55,59,3,33,Loss,47,239,8,2,0,SEA,36,164,545,1
0.294117647,0.0625,36.06666667,10/31/2010,,,18,10,home,30,SEA,306,117,102,68,33,3,Win,239,47,2,8,1,OAK,36,545,164,0
0.363636364,0.545454545,35.13333333,10/31/2010,,,23,18,away,-10,NEP,285,240,35,67,18,28,Loss,125,122,1,0,0,MIN,46,410,362,1
0.545454545,0.363636364,24.86666667,10/31/2010,,,18,23,home,10,MIN,240,285,47,54,28,18,Win,122,125,0,1,1,NEP,46,362,410,0
0.3,0.4375,25.9,10/31/2010,,,13,19,away,-10,NOS,171,288,38,52,10,20,Loss,108,30,3,2,2,PIT,30,279,318,2
0.4375,0.3,34.1,10/31/2010,,,19,13,home,10,PIT,288,171,35,67,20,10,Win,30,108,2,3,2,NOS,30,318,279,2
0.272727273,0.466666667,23.58333333,11/1/2010,,,19,24,away,-13,IND,183,259,30,59,17,30,Loss,108,107,3,1,0,HOU,47,291,366,2
0.466666667,0.272727273,36.41666667,11/1/2010,,,24,19,home,13,HOU,259,183,69,74,30,17,Win,107,108,1,3,2,IND,47,366,291,0
0.444444444,0.461538462,26.18333333,11/7/2010,,,18,25,away,6,HOU,290,252,62,50,29,23,Win,77,140,1,2,1,LAC,52,367,392,2
0.461538462,0.444444444,33.81666667,11/7/2010,,,25,18,home,-6,LAC,252,290,31,68,23,29,Loss,140,77,2,1,2,HOU,52,392,367,1
0.5,0.461538462,21.63333333,11/7/2010,,,17,23,away,-16,BAL,216,256,23,53,10,26,Loss,73,146,2,4,0,MIA,36,289,402,3
0.461538462,0.5,38.36666667,11/7/2010,,,23,17,home,16,MIA,256,216,40,71,26,10,Win,146,73,4,2,3,BAL,36,402,289,0
0.583333333,0.625,31.21666667,11/7/2010,,,19,22,away,3,BUF,178,294,45,62,22,19,Win,105,46,1,1,3,CHI,41,283,340,1
0.625,0.583333333,28.78333333,11/7/2010,,,22,19,home,-3,CHI,294,178,33,70,19,22,Loss,46,105,1,1,1,BUF,41,340,283,3
0.615384615,0.571428571,25.9,11/7/2010,,,14,26,away,-6,ATL,182,235,30,50,21,27,Loss,96,130,1,0,0,TBB,48,278,365,2
0.571428571,0.615384615,34.1,11/7/2010,,,26,14,home,6,TBB,235,182,53,69,27,21,Win,130,96,0,1,2,ATL,48,365,278,0
0.272727273,0.538461538,21.86666667,11/7/2010,,,19,22,away,-20,CLE,215,174,20,59,14,34,Loss,68,230,1,0,1,NEP,48,283,404,3
0.538461538,0.272727273,38.13333333,11/7/2010,,,22,19,home,20,NEP,174,215,28,63,34,14,Win,230,68,0,1,3,CLE,48,404,283,1
0.5,0.083333333,34.68333333,11/7/2010,,,27,15,away,31,CAR,243,68,64,76,34,3,Win,165,127,1,4,2,NOS,37,408,195,1
0.083333333,0.5,25.31666667,11/7/2010,,,15,27,home,-31,NOS,68,243,65,64,3,34,Loss,127,165,4,1,1,CAR,37,195,408,2
0.230769231,0.25,27.21666667,11/7/2010,,,13,28,away,-3,MIN,172,427,39,54,0,3,Loss,53,80,6,3,3,ARI,3,225,507,1
0.25,0.230769231,38.08333333,11/7/2010,,,28,13,home,3,ARI,427,172,65,70,3,0,Win,80,53,3,6,1,MIN,3,507,225,3
0.384615385,0.333333333,29.53333333,11/7/2010,,,23,21,away,3,DET,327,228,99,70,3,0,Win,110,78,1,2,0,NYJ,3,437,306,2
0.333333333,0.384615385,32.76666667,11/7/2010,,,21,23,home,-3,NYJ,228,327,102,67,0,3,Loss,78,110,2,1,2,DET,3,306,437,0
0.461538462,0.125,42.56666667,11/7/2010,,,30,8,away,34,SEA,290,113,40,79,41,7,Win,197,49,0,0,3,NYG,48,487,162,1
0.125,0.461538462,17.43333333,11/7/2010,,,8,30,home,-34,NYG,113,290,70,37,7,41,Loss,49,197,0,0,1,SEA,48,162,487,3
0.2,0.25,33.16666667,11/7/2010,,,21,17,away,-3,OAK,200,209,100,72,0,3,Loss,104,112,3,4,3,KCC,3,304,321,2
0.25,0.2,29.71666667,11/7/2010,,,17,21,home,3,KCC,209,200,140,64,3,0,Win,112,104,4,3,2,OAK,3,321,304,3
0.428571429,0.466666667,28.16666667,11/7/2010,,,27,19,away,-2,PHI,276,207,59,73,24,26,Loss,62,195,3,3,0,IND,50,338,402,2
0.466666667,0.428571429,31.83333333,11/7/2010,,,19,27,home,2,IND,207,276,125,63,26,24,Win,195,62,3,3,2,PHI,50,402,338,0
0.4,0.666666667,22.06666667,11/7/2010,,,12,26,away,-38,GBP,166,277,40,48,7,45,Loss,39,138,4,1,0,DAL,52,205,415,4
0.666666667,0.4,37.93333333,11/7/2010,,,26,12,home,38,DAL,277,166,20,71,45,7,Win,138,39,1,4,4,GBP,52,415,205,0
0.428571429,0.25,32.31666667,11/8/2010,,,14,18,away,6,CIN,193,218,73,61,27,21,Win,121,54,1,4,2,PIT,48,314,272,2
0.25,0.428571429,27.68333333,11/8/2010,,,18,14,home,-6,PIT,218,193,30,58,21,27,Loss,54,121,4,1,2,CIN,48,272,314,2
0.545454545,0.6,24.85,11/11/2010,,,20,23,away,-5,ATL,204,302,51,57,21,26,Loss,116,60,2,2,0,BAL,47,320,362,2
0.6,0.545454545,35.15,11/11/2010,,,23,20,home,5,BAL,302,204,5,75,26,21,Win,60,116,2,2,2,ATL,47,362,320,0
0.263157895,0.333333333,32.4,11/14/2010,,,19,12,away,-2,BUF,314,139,60,77,12,14,Loss,76,149,1,1,1,DET,26,390,288,1
0.333333333,0.263157895,27.6,11/14/2010,,,12,19,home,2,DET,139,314,30,58,14,12,Win,149,76,1,1,1,BUF,26,288,390,1
0.4,0.363636364,24.61666667,11/14/2010,,,20,29,away,-7,JAX,314,326,49,53,24,31,Loss,81,165,0,2,0,HOU,55,395,491,1
0.363636364,0.4,35.38333333,11/14/2010,,,29,20,home,7,HOU,326,314,62,69,31,24,Win,165,81,2,0,1,JAX,55,491,395,0
0.3125,0.529411765,26.93333333,11/14/2010,,,15,21,away,-12,MIA,124,316,55,65,17,29,Loss,135,88,2,1,1,TEN,46,259,404,3
0.529411765,0.3125,33.06666667,11/14/2010,,,21,15,home,12,TEN,316,124,63,68,29,17,Win,88,135,1,2,3,MIA,46,404,259,1
0.111111111,0.578947368,25.35,11/14/2010,,,15,18,away,-14,CHI,170,230,19,54,13,27,Loss,70,130,1,2,2,MIN,40,240,360,4
0.578947368,0.111111111,34.65,11/14/2010,,,18,15,home,14,MIN,230,170,116,74,27,13,Win,130,70,2,1,4,CHI,40,360,240,2
0.523809524,0.333333333,47.13333333,11/14/2010,,,28,19,away,6,CLE,284,196,70,91,6,0,Win,172,107,2,3,2,NYJ,6,456,303,1
0.333333333,0.523809524,27.6,11/14/2010,,,19,28,home,-6,NYJ,196,284,52,59,0,6,Loss,107,172,3,2,1,CLE,6,303,456,2
0.384615385,0.357142857,34.18333333,11/14/2010,,,19,16,away,-6,IND,269,180,38,65,17,23,Loss,72,76,3,2,0,CIN,40,341,256,5
0.357142857,0.384615385,25.81666667,11/14/2010,,,16,19,home,6,CIN,180,269,45,60,23,17,Win,76,72,2,3,5,IND,40,256,341,0
0.4,0.5,28.66666667,11/14/2010,,,18,21,away,-15,TBB,182,235,71,62,16,31,Loss,118,186,2,1,2,CAR,47,300,421,1
0.5,0.4,31.33333333,11/14/2010,,,21,18,home,15,CAR,235,182,80,55,31,16,Win,186,118,1,2,1,TBB,47,421,300,2
0.384615385,0.6,31.85,11/14/2010,,,30,25,away,-20,DEN,433,299,40,79,29,49,Loss,51,153,4,0,0,KCC,78,484,452,1
0.6,0.384615385,28.15,11/14/2010,,,25,30,home,20,KCC,299,433,28,66,49,29,Win,153,51,0,4,1,DEN,78,452,484,0
0.4,0.181818182,35.08333333,11/14/2010,,,24,19,away,18,ARI,380,286,51,73,36,18,Win,110,41,2,5,2,SEA,54,490,327,1
0.181818182,0.4,24.91666667,11/14/2010,,,19,24,home,-18,SEA,286,380,50,64,18,36,Loss,41,110,5,2,1,ARI,54,327,490,2
0.272727273,0.4,22.15,11/14/2010,,,15,25,away,13,NYG,327,373,60,50,33,20,Win,100,107,0,0,3,DAL,53,427,480,1
0.4,0.272727273,37.85,11/14/2010,,,25,15,home,-13,DAL,373,327,69,76,20,33,Loss,107,100,0,0,1,NYG,53,480,427,3
0.142857143,0,35.05,11/14/2010,,,22,19,away,-3,SFO,228,323,135,69,0,3,Loss,104,98,3,5,0,LAR,3,332,421,0
0,0.142857143,30.3,11/14/2010,,,19,22,home,3,LAR,323,228,105,59,3,0,Win,98,104,5,3,0,SFO,3,421,332,0
0.3,0.416666667,31.46666667,11/14/2010,,,26,27,away,13,PIT,350,349,113,67,39,26,Win,103,76,0,5,1,NEP,65,453,425,0
0.416666667,0.3,28.53333333,11/14/2010,,,27,26,home,-13,NEP,349,350,45,70,26,39,Loss,76,103,5,0,0,PIT,65,425,453,1
0.615384615,0,38.18333333,11/15/2010,,,28,15,away,31,WAS,332,270,35,67,59,28,Win,260,105,1,2,3,PHI,87,592,375,0
0,0.615384615,21.81666667,11/15/2010,,,15,28,home,-31,PHI,270,332,41,51,28,59,Loss,105,260,2,1,0,WAS,87,375,592,3
0.555555556,0.090909091,37.85,11/18/2010,,,19,10,away,16,MIA,133,148,45,68,16,0,Win,135,39,3,6,1,CHI,16,268,187,1
0.090909091,0.555555556,22.15,11/18/2010,,,10,19,home,-16,CHI,148,133,45,48,0,16,Loss,39,135,6,3,1,MIA,16,187,268,1
0.533333333,0.307692308,33.26666667,11/21/2010,,,20,15,away,28,MIN,283,207,5,65,31,3,Win,91,93,3,1,2,GBP,34,374,300,0
0.307692308,0.533333333,26.73333333,11/21/2010,,,15,20,home,-28,GBP,207,283,50,57,3,31,Loss,93,91,1,3,0,MIN,34,300,374,2
0.181818182,0.076923077,34.55,11/21/2010,,,22,9,away,24,CAR,278,150,20,67,37,13,Win,100,120,3,3,2,BAL,50,378,270,2
0.076923077,0.181818182,25.45,11/21/2010,,,9,22,home,-24,BAL,150,278,54,53,13,37,Loss,120,100,3,3,2,CAR,50,270,378,2
0.333333333,0.466666667,25.68333333,11/21/2010,,,17,22,away,-3,NYJ,246,298,25,60,27,30,Loss,97,103,1,3,2,HOU,57,343,401,1
0.466666667,0.333333333,34.31666667,11/21/2010,,,22,17,home,3,HOU,298,246,39,72,30,27,Win,103,97,3,1,1,NYJ,57,401,343,2
0.5,0.272727273,40.15,11/21/2010,,,32,15,away,3,TEN,358,222,20,86,3,0,Win,107,151,3,1,2,WAS,3,465,373,1
0.272727273,0.5,26.56666667,11/21/2010,,,15,32,home,-3,WAS,222,358,81,51,0,3,Loss,151,107,1,3,1,TEN,3,373,465,2
0.5,0.5625,27.85,11/21/2010,,,23,26,away,18,CIN,308,228,58,60,49,31,Win,141,133,1,2,3,BUF,80,449,361,2
0.5625,0.5,32.15,11/21/2010,,,26,23,home,-18,BUF,228,308,57,69,31,49,Loss,133,141,2,1,2,CIN,80,361,449,3
0.4375,0.363636364,28.53333333,11/21/2010,,,15,24,away,-4,JAX,195,226,45,60,20,24,Loss,88,145,6,4,6,CLE,44,283,371,1
0.363636364,0.4375,31.46666667,11/21/2010,,,24,15,home,4,CLE,226,195,10,67,24,20,Win,145,88,4,6,1,JAX,44,371,283,6
0.555555556,0.545454545,29.93333333,11/21/2010,,,17,19,away,-16,DAL,263,131,76,70,19,35,Loss,75,134,3,2,1,DET,54,338,265,2
0.545454545,0.555555556,30.06666667,11/21/2010,,,19,17,home,16,DET,131,263,39,56,35,19,Win,134,75,2,3,2,DAL,54,265,338,1
0.214285714,0.5,27.21666667,11/21/2010,,,17,18,away,-32,PIT,121,269,55,65,3,35,Loss,61,162,6,2,1,OAK,38,182,431,3
0.5,0.214285714,32.78333333,11/21/2010,,,18,17,home,32,OAK,269,121,163,64,35,3,Win,162,61,2,6,3,PIT,38,431,182,1
0.266666667,0.363636364,32.36666667,11/21/2010,,,19,17,away,-18,KCC,281,193,96,68,13,31,Loss,101,159,2,0,0,ARI,44,382,352,0
0.363636364,0.266666667,27.63333333,11/21/2010,,,17,19,home,18,ARI,193,281,23,53,31,13,Win,159,101,0,2,0,KCC,44,352,382,0
0.529411765,0.1,35.91666667,11/21/2010,,,24,15,away,17,LAR,253,233,30,70,34,17,Win,138,71,0,0,1,ATL,51,391,304,0
0.1,0.529411765,24.08333333,11/21/2010,,,15,24,home,-17,ATL,233,253,54,54,17,34,Loss,71,138,0,0,0,LAR,51,304,391,1
0.5,0.25,36.4,11/21/2010,,,20,11,away,21,SFO,137,118,35,66,21,0,Win,162,71,2,6,2,TBB,21,299,189,0
0.25,0.5,23.6,11/21/2010,,,11,20,home,-21,TBB,118,137,18,55,0,21,Loss,71,162,6,2,0,SFO,21,189,299,2
0.583333333,0.733333333,26.25,11/21/2010,,,21,26,away,-15,NOS,366,382,79,61,19,34,Loss,58,112,0,0,2,SEA,53,424,494,2
0.733333333,0.583333333,33.75,11/21/2010,,,26,21,home,15,SEA,382,366,24,72,34,19,Win,112,58,0,0,2,NOS,53,494,424,2
0.785714286,0.636363636,29.35,11/21/2010,,,28,22,away,-3,NEP,396,178,48,72,28,31,Loss,71,168,0,1,0,IND,59,467,346,3
0.636363636,0.785714286,30.65,11/21/2010,,,22,28,home,3,IND,178,396,15,60,31,28,Win,168,71,1,0,3,NEP,59,346,467,0
0.454545455,0.214285714,25.93333333,11/21/2010,,,13,17,away,-10,PHI,147,244,54,52,17,27,Loss,61,148,0,3,2,NYG,44,208,392,5
0.214285714,0.454545455,34.06666667,11/21/2010,,,17,13,home,10,NYG,244,147,119,67,27,17,Win,148,61,3,0,5,PHI,44,392,208,2
0.083333333,0.5,25.68333333,11/22/2010,,,16,21,away,-21,LAC,172,253,56,58,14,35,Loss,63,147,5,1,1,DEN,49,235,400,1
0.5,0.083333333,34.31666667,11/22/2010,,,21,16,home,21,DEN,253,172,40,65,35,14,Win,147,63,1,5,1,LAC,49,400,235,1
0.5,0.5,28.91666667,11/25/2010,,,20,25,away,21,DET,338,277,50,53,45,24,Win,109,129,1,2,2,NEP,69,447,406,0
0.5,0.5,31.08333333,11/25/2010,,,25,20,home,-21,NEP,277,338,66,75,24,45,Loss,129,109,2,1,0,DET,69,406,447,2
0.428571429,0.466666667,25.31666667,11/25/2010,,,21,24,away,3,DAL,333,313,30,62,30,27,Win,81,144,2,1,3,NOS,57,414,457,2
0.466666667,0.428571429,34.68333333,11/25/2010,,,24,21,home,-3,NOS,313,333,19,75,27,30,Loss,144,81,1,2,2,DAL,57,457,414,3
0.266666667,0.230769231,26.51666667,11/25/2010,,,13,18,away,-16,NYJ,117,149,25,62,10,26,Loss,46,170,3,2,1,CIN,36,163,319,3
0.230769231,0.266666667,33.48333333,11/25/2010,,,18,13,home,16,CIN,149,117,64,67,26,10,Win,170,46,2,3,3,NYJ,36,319,163,1
0.4,0.466666667,33.08333333,11/28/2010,,,17,10,away,4,WAS,162,187,15,63,17,13,Win,137,29,2,4,1,MIN,30,299,216,0
0.466666667,0.4,26.91666667,11/28/2010,,,10,17,home,-4,MIN,187,162,35,52,13,17,Loss,29,137,4,2,0,WAS,30,216,299,1
0.272727273,0.5,20.31666667,11/28/2010,,,9,24,away,-20,HOU,138,158,79,44,0,20,Loss,24,188,1,2,0,TEN,20,162,346,3
0.5,0.272727273,39.68333333,11/28/2010,,,24,9,home,20,TEN,158,138,68,76,20,0,Win,188,24,2,1,3,HOU,20,346,162,0
0.363636364,0.333333333,28.33333333,11/28/2010,,,22,19,away,-3,ATL,341,177,66,59,17,20,Loss,77,117,1,2,0,GBP,37,418,294,1
0.333333333,0.363636364,31.66666667,11/28/2010,,,19,22,home,3,GBP,177,341,50,57,20,17,Win,117,77,2,1,1,ATL,37,294,418,0
0.466666667,0.363636364,28.26666667,11/28/2010,,,16,26,away,-1,CLE,175,227,68,58,23,24,Loss,151,152,3,2,3,CAR,47,326,379,1
0.363636364,0.466666667,31.73333333,11/28/2010,,,26,16,home,1,CAR,227,175,46,70,24,23,Win,152,151,2,3,1,CLE,47,379,326,3
0.631578947,0.307692308,45.38333333,11/28/2010,,,28,19,away,3,BUF,220,255,107,83,3,0,Win,206,74,5,2,2,PIT,3,426,329,1
0.307692308,0.631578947,27.38333333,11/28/2010,,,19,28,home,-3,PIT,255,220,20,64,0,3,Loss,74,206,2,5,1,BUF,3,329,426,2
0.625,0.3,35.45,11/28/2010,,,26,17,away,-4,NYG,121,226,20,73,20,24,Loss,207,135,4,0,0,JAX,44,328,361,2
0.3,0.625,24.55,11/28/2010,,,17,26,home,4,JAX,226,121,25,50,24,20,Win,135,207,0,4,2,NYG,44,361,328,0
0.473684211,0.222222222,41.63333333,11/28/2010,,,24,11,away,16,OAK,285,247,35,82,33,17,Win,186,16,3,1,3,MIA,50,471,263,1
0.222222222,0.473684211,18.36666667,11/28/2010,,,11,24,home,-16,MIA,247,285,20,45,17,33,Loss,16,186,1,3,1,OAK,50,263,471,3
0.647058824,0.25,41.05,11/28/2010,,,28,13,away,18,SEA,233,268,50,80,42,24,Win,270,20,0,2,3,KCC,66,503,288,1
0.25,0.647058824,18.95,11/28/2010,,,13,28,home,-18,KCC,268,233,26,51,24,42,Loss,20,270,2,0,1,SEA,66,288,503,3
0.375,0.25,28.96666667,11/28/2010,,,14,18,away,-7,BAL,162,257,78,60,10,17,Loss,101,92,0,4,1,TBB,27,263,349,0
0.25,0.375,31.03333333,11/28/2010,,,18,14,home,7,TBB,257,162,30,65,17,10,Win,92,101,4,0,0,BAL,27,349,263,1
0.307692308,0.3,31.96666667,11/28/2010,,,24,18,away,-5,CHI,293,218,19,70,26,31,Loss,105,131,4,4,0,PHI,57,398,349,1
0.3,0.307692308,28.03333333,11/28/2010,,,18,24,home,5,PHI,218,293,56,53,31,26,Win,131,105,4,4,1,CHI,57,349,398,0
0.375,0.111111111,34.28333333,11/28/2010,,,24,24,away,3,DEN,308,330,30,74,36,33,Win,123,119,2,3,2,LAR,69,431,449,0
0.111111111,0.375,25.71666667,11/28/2010,,,24,24,home,-3,LAR,330,308,60,62,33,36,Loss,119,123,3,2,0,DEN,69,449,431,2
0,0.25,35.63333333,11/28/2010,,,18,16,away,22,IND,172,279,40,59,36,14,Win,129,24,2,1,5,LAC,50,301,303,0
0.25,0,24.36666667,11/28/2010,,,16,18,home,-22,LAC,279,172,15,62,14,36,Loss,24,129,1,2,0,IND,50,303,301,5
0.538461538,0.181818182,39.01666667,11/29/2010,,,26,8,away,21,ARI,125,190,40,71,27,6,Win,261,13,1,1,2,SFO,33,386,203,1
0.181818182,0.538461538,20.98333333,11/29/2010,,,8,26,home,-21,SFO,190,125,61,47,6,27,Loss,13,261,1,1,1,ARI,33,203,386,2
0.6,0.5,28.18333333,12/2/2010,,,27,22,away,-10,PHI,323,301,25,64,24,34,Loss,108,115,2,1,1,HOU,58,431,416,2
0.5,0.6,31.81666667,12/2/2010,,,22,27,home,10,HOU,301,323,85,63,34,24,Win,115,108,1,2,2,PHI,58,416,431,1
0.4,0.181818182,39.9,12/5/2010,,,23,11,away,11,TEN,119,163,31,73,17,6,Win,258,57,1,1,2,JAX,23,377,220,0
0.181818182,0.4,20.1,12/5/2010,,,11,23,home,-11,JAX,163,119,30,47,6,17,Loss,57,258,1,1,0,TEN,23,220,377,2
0.555555556,0.428571429,33.31666667,12/5/2010,,,23,14,away,4,DET,197,168,25,58,24,20,Win,114,134,4,2,0,CHI,44,311,302,1
0.428571429,0.555555556,26.68333333,12/5/2010,,,14,23,home,-4,CHI,168,197,42,53,20,24,Loss,134,114,2,4,1,DET,44,302,311,0
0.25,0.333333333,26.05,12/5/2010,,,10,22,away,-24,MIN,155,177,54,49,14,38,Loss,84,210,1,1,4,BUF,52,239,387,5
0.333333333,0.25,33.95,12/5/2010,,,22,10,home,24,BUF,177,155,20,64,38,14,Win,210,84,1,1,5,MIN,52,387,239,4
0.25,0.428571429,22.76666667,12/5/2010,,,13,21,away,-4,KCC,86,174,35,55,6,10,Loss,161,185,4,2,1,DEN,16,247,359,1
0.428571429,0.25,37.23333333,12/5/2010,,,21,13,home,4,DEN,174,86,60,72,10,6,Win,185,161,2,4,1,KCC,16,359,247,1
0.25,0.6,22.81666667,12/5/2010,,,11,21,away,-18,GBP,172,274,32,51,16,34,Loss,97,136,4,4,0,SFO,50,269,410,1
0.6,0.25,37.18333333,12/5/2010,,,21,11,home,18,SFO,274,172,40,68,34,16,Win,136,97,4,4,1,GBP,50,410,269,0
0.125,0.357142857,27.45,12/5/2010,,,19,21,away,4,CIN,290,215,100,53,34,30,Win,146,96,2,3,0,NOS,64,436,311,1
0.357142857,0.125,32.55,12/5/2010,,,21,19,home,-4,NOS,215,290,43,62,30,34,Loss,96,146,3,2,1,CIN,64,311,436,0
0.142857143,0.285714286,29.4,12/5/2010,,,12,17,away,3,MIA,200,167,45,58,13,10,Win,52,114,2,1,3,CLE,23,252,281,0
0.285714286,0.142857143,30.6,12/5/2010,,,17,12,home,-3,CLE,167,200,37,65,10,13,Loss,114,52,1,2,0,MIA,23,281,252,3
0.416666667,0.2,25.53333333,12/5/2010,,,19,22,away,-24,NYG,264,161,35,64,7,31,Loss,74,197,4,0,1,WAS,38,338,358,6
0.2,0.416666667,34.46666667,12/5/2010,,,22,19,home,24,WAS,161,264,35,61,31,7,Win,197,74,0,4,6,NYG,38,358,338,1
0.533333333,0.3,38.65,12/5/2010,,,22,18,away,15,LAC,117,265,105,69,28,13,Win,251,21,1,4,2,OAK,41,368,286,1
0.3,0.533333333,21.35,12/5/2010,,,18,22,home,-15,OAK,265,117,19,51,13,28,Loss,21,251,4,1,1,LAC,41,286,368,2
0.545454545,0.333333333,28,12/5/2010,,,20,19,away,4,TBB,205,174,55,63,28,24,Win,85,151,0,1,1,ATL,52,290,325,2
0.333333333,0.545454545,32,12/5/2010,,,19,20,home,-4,ATL,174,205,102,69,24,28,Loss,151,85,1,0,2,TBB,52,325,290,1
0.533333333,0.545454545,40,12/5/2010,,,24,24,away,3,IND,151,365,35,74,3,0,Win,217,40,2,0,4,DAL,3,368,405,0
0.545454545,0.533333333,27.08333333,12/5/2010,,,24,24,home,-3,DAL,365,151,28,65,0,3,Loss,40,217,0,2,0,IND,3,405,368,4
0.352941176,0.090909091,33.76666667,12/5/2010,,,18,14,away,13,ARI,169,119,15,67,19,6,Win,119,105,2,4,2,LAR,25,288,224,1
0.090909091,0.352941176,26.23333333,12/5/2010,,,14,18,home,-13,LAR,119,169,54,52,6,19,Loss,105,119,4,2,1,ARI,25,224,288,2
0.333333333,0.5,30.5,12/5/2010,,,18,25,away,-17,SEA,152,210,53,67,14,31,Loss,131,161,3,3,2,CAR,45,283,371,1
0.5,0.333333333,29.5,12/5/2010,,,25,18,home,17,CAR,210,152,20,64,31,14,Win,161,131,3,3,1,SEA,45,371,283,2
0.285714286,0.307692308,34.13333333,12/5/2010,,,17,14,away,3,BAL,234,226,61,65,13,10,Win,54,43,3,4,1,PIT,23,288,269,1
0.307692308,0.285714286,25.86666667,12/5/2010,,,14,17,home,-3,PIT,226,234,53,57,10,13,Loss,43,54,4,3,1,BAL,23,269,288,1
0.25,0.4,28.98333333,12/6/2010,,,18,23,away,-42,NEP,149,304,56,65,3,45,Loss,152,101,1,3,0,NYJ,48,301,405,3
0.4,0.25,31.01666667,12/6/2010,,,23,18,home,42,NYJ,304,149,10,58,45,3,Win,101,152,3,1,3,NEP,48,405,301,0
0.533333333,0.454545455,32.51666667,12/9/2010,,,21,22,away,2,TEN,312,244,60,68,30,28,Win,87,121,1,0,2,IND,58,399,365,0
0.454545455,0.533333333,27.48333333,12/9/2010,,,22,21,home,-2,IND,244,312,29,64,28,30,Loss,121,87,0,1,0,TEN,58,365,399,2
0.416666667,0.375,28.86666667,12/12/2010,,,15,22,away,1,WAS,262,211,14,52,17,16,Win,103,188,1,2,1,TBB,33,365,399,2
0.375,0.416666667,31.13333333,12/12/2010,,,22,15,home,-1,TBB,211,262,25,65,16,17,Loss,188,103,2,1,2,WAS,33,399,365,1
0.529411765,0.230769231,34.83333333,12/12/2010,,,24,13,away,21,CAR,200,76,10,73,31,10,Win,127,212,3,5,2,ATL,41,327,288,1
0.230769231,0.529411765,25.16666667,12/12/2010,,,13,24,home,-21,ATL,76,200,50,58,10,31,Loss,212,127,5,3,1,CAR,41,288,327,2
0.25,0.466666667,25.48333333,12/12/2010,,,14,18,away,-16,PIT,156,231,25,49,7,23,Loss,34,123,3,4,0,CIN,30,190,354,3
0.466666667,0.25,34.51666667,12/12/2010,,,18,14,home,16,CIN,231,156,89,64,23,7,Win,123,34,4,3,3,PIT,30,354,190,0
0.461538462,0.416666667,30.08333333,12/12/2010,,,21,19,away,-7,JAX,323,151,25,61,31,38,Loss,153,234,3,2,1,OAK,69,476,385,2
0.416666667,0.461538462,29.91666667,12/12/2010,,,19,21,home,7,OAK,151,323,52,58,38,31,Win,234,153,2,3,2,JAX,69,385,476,1
0.166666667,0.2,29.2,12/12/2010,,,13,15,away,-4,DET,192,96,20,61,3,7,Loss,66,190,4,2,2,GBP,10,258,286,3
0.2,0.166666667,30.8,12/12/2010,,,15,13,home,4,GBP,96,192,35,65,7,3,Win,190,66,2,4,3,DET,10,286,258,2
0.2,0.357142857,23.83333333,12/12/2010,,,9,19,away,-7,BUF,82,131,10,46,6,13,Loss,105,192,1,2,1,CLE,19,187,323,3
0.357142857,0.2,36.16666667,12/12/2010,,,19,9,home,7,CLE,131,82,44,67,13,6,Win,192,105,2,1,3,BUF,19,323,187,1
0.4,0.411764706,29.11666667,12/12/2010,,,20,10,away,-19,SFO,277,241,75,65,21,40,Loss,84,95,1,2,0,SEA,61,361,336,5
0.411764706,0.4,30.88333333,12/12/2010,,,10,20,home,19,SEA,241,277,15,56,40,21,Win,95,84,2,1,5,SFO,61,336,361,0
0.090909091,0.6875,26.98333333,12/12/2010,,,14,22,away,-18,NOS,191,213,39,59,13,31,Loss,136,132,3,1,3,LAR,44,327,345,3
0.6875,0.090909091,33.01666667,12/12/2010,,,22,14,home,18,LAR,213,191,55,70,31,13,Win,132,136,1,3,3,NOS,44,345,327,3
0.631578947,0.375,39.68333333,12/12/2010,,,27,12,away,29,CHI,351,138,43,78,36,7,Win,124,47,3,2,4,NEP,43,475,185,0
0.375,0.631578947,20.31666667,12/12/2010,,,12,27,home,-29,NEP,138,351,30,42,7,36,Loss,47,124,2,3,0,CHI,43,185,475,4
0,0.733333333,19.83333333,12/12/2010,,,5,25,away,-31,LAC,19,219,15,41,0,31,Loss,48,207,4,2,2,KCC,31,67,426,0
0.733333333,0,40.16666667,12/12/2010,,,25,5,home,31,KCC,219,19,47,69,31,0,Win,207,48,2,4,0,LAC,31,426,67,2
0.2,0.285714286,26.2,12/12/2010,,,6,14,away,4,NYJ,30,193,36,56,10,6,Win,101,87,5,6,2,MIA,16,131,280,3
0.285714286,0.2,33.8,12/12/2010,,,14,6,home,-4,MIA,193,30,50,81,6,10,Loss,87,101,6,5,3,NYJ,16,280,131,2
0.2,0.25,29.65,12/12/2010,,,20,21,away,-30,ARI,156,146,66,73,13,43,Loss,132,211,1,0,1,DEN,56,288,357,6
0.25,0.2,30.35,12/12/2010,,,21,20,home,30,DEN,146,156,62,72,43,13,Win,211,132,0,1,6,ARI,56,357,288,1
0.363636364,0.272727273,27.85,12/12/2010,,,18,22,away,3,DAL,258,239,59,55,30,27,Win,171,110,2,1,2,PHI,57,429,349,2
0.272727273,0.363636364,32.15,12/12/2010,,,22,18,home,-3,PHI,239,258,40,60,27,30,Loss,110,171,1,2,2,DAL,57,349,429,2
0.230769231,0.125,32.7,12/13/2010,,,21,10,away,18,MIN,182,103,55,66,21,3,Win,213,61,1,4,1,NYG,24,395,164,2
0.125,0.230769231,27.3,12/13/2010,,,10,21,home,-18,NYG,103,182,71,61,3,21,Loss,61,213,4,1,2,MIN,24,164,395,1
0.533333333,0.388888889,31.3,12/13/2010,,,19,28,away,6,HOU,190,378,15,62,6,0,Win,63,111,5,2,2,BAL,6,253,489,0
0.388888889,0.533333333,31.78333333,12/13/2010,,,28,19,home,-6,BAL,378,190,51,86,0,6,Loss,111,63,2,5,0,HOU,6,489,253,2
0.166666667,0.5,22.81666667,12/16/2010,,,11,24,away,-27,LAC,131,266,60,50,7,34,Loss,61,108,6,1,0,SFO,41,192,374,1
0.5,0.166666667,37.18333333,12/16/2010,,,24,11,home,27,SFO,266,131,35,67,34,7,Win,108,61,1,6,1,LAC,41,374,192,0
0.384615385,0.384615385,30.36666667,12/19/2010,,,20,19,away,-10,IND,289,221,55,61,24,34,Loss,67,155,1,1,0,JAX,58,356,376,2
0.384615385,0.384615385,29.63333333,12/19/2010,,,19,20,home,10,JAX,221,289,68,64,34,24,Win,155,67,1,1,2,IND,58,376,356,0
0.294117647,0.352941176,31.73333333,12/19/2010,,,21,14,away,14,LAR,173,155,40,74,27,13,Win,210,69,3,3,2,KCC,40,383,224,1
0.352941176,0.294117647,28.26666667,12/19/2010,,,14,21,home,-14,KCC,155,173,60,67,13,27,Loss,69,210,3,3,1,LAR,40,224,383,2
0.363636364,0.384615385,24.65,12/19/2010,,,23,25,away,-3,DAL,286,300,25,63,30,33,Loss,55,134,5,2,0,WAS,63,341,434,3
0.384615385,0.363636364,35.35,12/19/2010,,,25,23,home,3,WAS,300,286,70,70,33,30,Win,134,55,2,5,3,DAL,63,434,341,0
0.333333333,0.333333333,28.61666667,12/19/2010,,,15,22,away,3,MIA,211,261,44,55,17,14,Win,71,65,2,3,2,BUF,31,282,326,1
0.333333333,0.333333333,31.38333333,12/19/2010,,,22,15,home,-3,BUF,261,211,35,67,14,17,Loss,65,71,3,2,1,MIA,31,326,282,2
0.25,0.461538462,21.95,12/19/2010,,,14,22,away,-2,CIN,219,209,25,43,17,19,Loss,59,188,4,0,0,CLE,36,278,397,0
0.461538462,0.25,38.05,12/19/2010,,,22,14,home,2,CLE,209,219,55,68,19,17,Win,188,59,0,4,0,CIN,36,397,278,0
0.5,0.416666667,33.08333333,12/19/2010,,,26,22,away,3,TBB,252,227,57,66,3,0,Win,181,176,0,3,0,DET,3,433,403,0
0.416666667,0.5,32.06666667,12/19/2010,,,22,26,home,-3,DET,227,252,65,64,0,3,Loss,176,181,3,0,0,TBB,3,403,433,0
0.384615385,0.272727273,32.48333333,12/19/2010,,,26,19,away,-14,TEN,293,212,66,75,17,31,Loss,30,147,4,3,1,HOU,48,323,359,1
0.272727273,0.384615385,27.51666667,12/19/2010,,,19,26,home,14,HOU,212,293,76,57,31,17,Win,147,30,3,4,1,TEN,48,359,323,1
0.363636364,0.470588235,26.51666667,12/19/2010,,,19,20,away,7,NYG,221,264,30,59,38,31,Win,197,100,3,2,2,PHI,69,418,364,3
0.470588235,0.363636364,33.48333333,12/19/2010,,,20,19,home,-7,PHI,264,221,35,72,31,38,Loss,100,197,2,3,3,NYG,69,364,418,2
0.384615385,0.357142857,28.51666667,12/19/2010,,,21,17,away,-6,BAL,242,148,68,63,24,30,Loss,27,208,3,3,0,NOS,54,269,356,1
0.357142857,0.384615385,31.48333333,12/19/2010,,,17,21,home,6,NOS,148,242,68,62,30,24,Win,208,27,3,3,1,BAL,54,356,269,0
0.266666667,0.266666667,23.06666667,12/19/2010,,,11,16,away,-7,CAR,175,126,39,53,12,19,Loss,43,177,3,2,1,ARI,31,218,303,2
0.266666667,0.266666667,36.93333333,12/19/2010,,,16,11,home,7,ARI,126,175,58,66,19,12,Win,177,43,2,3,2,CAR,31,303,218,1
0.473684211,0.333333333,35.41666667,12/19/2010,,,21,15,away,16,SEA,168,143,35,73,34,18,Win,98,91,1,2,3,ATL,52,266,234,1
0.333333333,0.473684211,24.58333333,12/19/2010,,,15,21,home,-16,ATL,143,168,76,56,18,34,Loss,91,98,2,1,1,SEA,52,234,266,3
0.166666667,0.181818182,26.05,12/19/2010,,,9,20,away,-16,OAK,129,238,93,51,23,39,Loss,106,264,2,0,3,DEN,62,235,502,1
0.181818182,0.166666667,33.95,12/19/2010,,,20,9,home,16,DEN,238,129,84,67,39,23,Win,264,106,0,2,1,OAK,62,502,235,3
0.461538462,0.647058824,28.7,12/19/2010,,,17,25,away,5,PIT,170,232,19,57,22,17,Win,106,146,1,3,0,NYJ,39,276,378,0
0.647058824,0.461538462,31.3,12/19/2010,,,25,17,home,-5,NYJ,232,170,35,72,17,22,Loss,146,106,3,1,0,PIT,39,378,276,0
0.578947368,0.4,40.8,12/19/2010,,,26,14,away,-4,NEP,226,136,15,80,27,31,Loss,143,113,5,3,0,GBP,58,369,249,2
0.4,0.578947368,19.2,12/19/2010,,,14,26,home,4,GBP,136,226,52,43,31,27,Win,113,143,3,5,2,NEP,58,249,369,0
0.2,0.272727273,31.5,12/20/2010,,,17,16,away,26,MIN,189,159,72,58,40,14,Win,104,114,1,4,5,CHI,54,293,273,1
0.272727273,0.2,28.5,12/20/2010,,,16,17,home,-26,CHI,159,189,55,61,14,40,Loss,114,104,4,1,1,MIN,54,273,293,5
0.230769231,0.333333333,24.6,12/23/2010,,,7,22,away,-24,PIT,45,293,62,49,3,27,Loss,74,115,4,3,2,CAR,30,119,408,2
0.333333333,0.230769231,35.4,12/23/2010,,,22,7,home,24,CAR,293,45,40,68,27,3,Win,115,74,3,4,2,PIT,30,408,119,2
0.444444444,0.181818182,38.08333333,12/25/2010,,,24,10,away,-1,ARI,199,178,49,76,26,27,Loss,183,93,5,1,0,DAL,53,382,271,3
0.181818182,0.444444444,21.91666667,12/25/2010,,,10,24,home,1,DAL,178,199,43,47,27,26,Win,93,183,1,5,3,ARI,53,271,382,0
0.25,0.285714286,26.86666667,12/26/2010,,,12,19,away,-8,LAR,246,275,87,59,17,25,Loss,85,60,4,1,1,SFO,42,331,335,2
0.285714286,0.25,33.13333333,12/26/2010,,,19,12,home,8,SFO,275,246,41,66,25,17,Win,60,85,1,4,2,LAR,42,335,331,1
0.470588235,0.3,32.5,12/26/2010,,,20,16,away,31,BUF,131,244,40,69,34,3,Win,217,125,1,3,7,NEP,37,348,369,0
0.3,0.470588235,27.5,12/26/2010,,,16,20,home,-31,NEP,244,131,40,60,3,34,Loss,125,217,3,1,0,BUF,37,369,348,7
0.538461538,0.636363636,31.76666667,12/26/2010,,,15,17,away,10,CLE,97,178,5,58,20,10,Win,161,102,1,0,4,BAL,30,258,280,1
0.636363636,0.538461538,28.23333333,12/26/2010,,,17,15,home,-10,BAL,178,97,20,56,10,20,Loss,102,161,0,1,1,CLE,30,280,258,4
0.5,0.333333333,33.85,12/26/2010,,,24,16,away,-4,CHI,269,202,34,68,34,38,Loss,124,120,0,2,1,NYJ,72,393,322,2
0.333333333,0.5,26.15,12/26/2010,,,16,24,home,4,NYJ,202,269,31,54,38,34,Win,120,124,2,0,2,CHI,72,322,393,1
0.266666667,0.411764706,29.88333333,12/26/2010,,,15,15,away,3,JAX,172,258,40,64,3,0,Win,79,78,1,4,2,WAS,3,251,336,1
0.411764706,0.266666667,32.9,12/26/2010,,,15,15,home,-3,WAS,258,172,66,65,0,3,Loss,78,79,4,1,1,JAX,3,336,251,2
0.25,0.5,20.93333333,12/26/2010,,,16,23,away,-20,KCC,213,306,74,56,14,34,Loss,57,152,3,1,2,TEN,48,270,458,2
0.5,0.25,39.06666667,12/26/2010,,,23,16,home,20,TEN,306,213,84,77,34,14,Win,152,57,1,3,2,KCC,48,458,270,2
0.333333333,0.470588235,22.75,12/26/2010,,,14,28,away,7,MIA,208,271,53,49,34,27,Win,67,154,2,2,3,DET,61,275,425,0
0.470588235,0.333333333,37.25,12/26/2010,,,28,14,home,-7,DET,271,208,63,83,27,34,Loss,154,67,2,2,0,MIA,61,425,275,3
0.363636364,0.266666667,29.98333333,12/26/2010,,,27,16,away,5,OAK,179,210,42,69,31,26,Win,191,80,0,3,0,IND,57,370,290,2
0.266666667,0.363636364,30.01666667,12/26/2010,,,16,27,home,-5,IND,210,179,116,65,26,31,Loss,80,191,3,0,2,OAK,57,290,370,0
0.125,0.454545455,28.16666667,12/26/2010,,,21,25,away,-1,DEN,310,305,24,55,23,24,Loss,91,126,0,1,1,HOU,47,401,431,1
0.454545455,0.125,31.83333333,12/26/2010,,,25,21,home,1,HOU,305,310,27,63,24,23,Win,126,91,1,0,1,DEN,47,431,401,1
0.461538462,0.571428571,29.85,12/26/2010,,,23,18,away,-14,CIN,249,269,5,63,20,34,Loss,64,102,1,0,1,LAC,54,313,371,2
0.571428571,0.461538462,30.15,12/26/2010,,,18,23,home,14,LAC,269,249,57,59,34,20,Win,102,64,0,1,2,CIN,54,371,313,1
0.333333333,0.545454545,28.53333333,12/26/2010,,,10,22,away,-23,TBB,84,231,10,53,15,38,Loss,90,208,3,2,0,SEA,53,174,439,0
0.545454545,0.333333333,31.46666667,12/26/2010,,,22,10,home,23,SEA,231,84,22,56,38,15,Win,208,90,2,3,0,TBB,53,439,174,0
0.333333333,0.461538462,22.98333333,12/26/2010,,,16,27,away,-28,GBP,296,396,45,55,17,45,Loss,90,119,1,2,1,NYG,62,386,515,6
0.461538462,0.333333333,37.01666667,12/26/2010,,,27,16,home,28,NYG,396,296,31,74,45,17,Win,119,90,2,1,6,GBP,62,515,386,1
0.470588235,0.25,36.58333333,12/27/2010,,,23,14,away,3,ATL,296,140,92,74,17,14,Win,72,75,1,1,2,NOS,31,368,215,2
0.25,0.470588235,23.41666667,12/27/2010,,,14,23,home,-3,NOS,140,296,10,52,14,17,Loss,75,72,1,1,2,ATL,31,215,368,2
0.461538462,0.363636364,30.35,12/28/2010,,,21,24,away,10,PHI,176,224,74,59,24,14,Win,161,107,2,6,3,MIN,38,337,331,1
0.363636364,0.461538462,29.65,12/28/2010,,,24,21,home,-10,MIN,224,176,62,71,14,24,Loss,107,161,6,2,1,PHI,38,331,337,3
0.230769231,0.363636364,24.5,1/2/2011,,,12,24,away,-21,ATL,154,253,97,56,10,31,Loss,137,99,3,1,1,CAR,41,291,352,2
0.363636364,0.230769231,35.5,1/2/2011,,,24,12,home,21,CAR,253,154,20,71,31,10,Win,99,137,1,3,2,ATL,41,352,291,1
0.3,0.5,29.05,1/2/2011,,,18,20,away,10,NOS,233,199,54,54,23,13,Win,84,106,3,3,3,TBB,36,317,305,2
0.5,0.3,30.95,1/2/2011,,,20,18,home,-10,TBB,199,233,45,66,13,23,Loss,106,84,3,3,2,NOS,36,305,317,3
0.428571429,0.6,29.13333333,1/2/2011,,,16,22,away,-7,DET,137,250,25,59,13,20,Loss,74,107,3,1,2,MIN,33,211,357,1
0.6,0.428571429,30.86666667,1/2/2011,,,22,16,home,7,MIN,250,137,33,67,20,13,Win,107,74,1,3,1,DET,33,357,211,2
0.333333333,0.5,24.41666667,1/2/2011,,,6,17,away,-31,NYJ,125,112,15,47,7,38,Loss,37,276,3,1,1,BUF,45,162,388,6
0.5,0.333333333,35.58333333,1/2/2011,,,17,6,home,31,BUF,112,125,25,66,38,7,Win,276,37,1,3,6,NYJ,45,388,162,1
0.307692308,0.647058824,23.68333333,1/2/2011,,,16,24,away,-31,NEP,206,321,40,58,7,38,Loss,44,181,5,0,1,MIA,45,250,502,2
0.647058824,0.307692308,36.31666667,1/2/2011,,,24,16,home,31,MIA,321,206,72,74,38,7,Win,181,44,0,5,2,NEP,45,502,250,1
0.615384615,0.352941176,33.23333333,1/2/2011,,,24,17,away,32,CLE,318,182,25,62,41,9,Win,100,43,2,4,3,PIT,50,418,225,0
0.352941176,0.615384615,26.76666667,1/2/2011,,,17,24,home,-32,PIT,182,318,46,64,9,41,Loss,43,100,4,2,0,CLE,50,225,418,3
0.461538462,0.388888889,33.46666667,1/2/2011,,,21,17,away,21,KCC,135,86,77,67,31,10,Win,209,115,4,7,2,OAK,41,344,201,1
0.388888889,0.461538462,26.53333333,1/2/2011,,,17,21,home,-21,OAK,86,135,39,72,10,31,Loss,115,209,7,4,1,KCC,41,201,344,2
0.411764706,0.181818182,34.7,1/2/2011,,,20,10,away,-6,BAL,305,101,49,76,7,13,Loss,90,98,0,4,2,CIN,20,395,199,5
0.181818182,0.411764706,25.3,1/2/2011,,,10,20,home,6,CIN,101,305,45,50,13,7,Win,98,90,4,0,5,BAL,20,199,395,2
0.3125,0.25,32.33333333,1/2/2011,,,14,20,away,3,WAS,243,318,24,61,17,14,Win,82,67,0,2,4,NYG,31,325,385,1
0.25,0.3125,27.66666667,1/2/2011,,,20,14,home,-3,NYG,318,243,25,66,14,17,Loss,67,82,2,0,1,WAS,31,385,325,4
0.3125,0.25,29.16666667,1/2/2011,,,14,14,away,1,PHI,113,123,45,63,14,13,Win,159,121,2,5,4,DAL,27,272,244,1
0.25,0.3125,30.83333333,1/2/2011,,,14,14,home,-1,DAL,123,113,40,69,13,14,Loss,121,159,5,2,1,PHI,27,244,272,4
0.1,0.454545455,30.8,1/2/2011,,,23,22,away,-17,HOU,124,253,15,62,17,34,Loss,198,244,2,0,0,JAX,51,322,497,2
0.454545455,0.1,29.2,1/2/2011,,,22,23,home,17,JAX,253,124,48,59,34,17,Win,244,198,0,2,2,HOU,51,497,322,0
0.3125,0.181818182,30.66666667,1/2/2011,,,13,14,away,-7,GBP,117,224,46,65,3,10,Loss,110,60,6,2,2,CHI,13,227,284,2
0.181818182,0.3125,29.33333333,1/2/2011,,,14,13,home,7,CHI,224,117,30,53,10,3,Win,60,110,2,6,2,GBP,13,284,227,2
0.4,0.363636364,31.28333333,1/2/2011,,,17,24,away,-3,IND,290,257,58,64,20,23,Loss,51,101,1,1,1,TEN,43,341,358,1
0.363636364,0.4,28.71666667,1/2/2011,,,24,17,home,3,TEN,257,290,25,67,23,20,Win,101,51,1,1,1,IND,43,358,341,1
0.45,0.181818182,32.8,1/2/2011,,,19,16,away,-31,SFO,201,262,43,81,7,38,Loss,78,100,6,2,0,ARI,45,279,362,2
0.181818182,0.45,27.2,1/2/2011,,,16,19,home,31,ARI,262,201,25,56,38,7,Win,100,78,2,6,2,SFO,45,362,279,0
0.388888889,0.357142857,34.36666667,1/2/2011,,,20,18,away,5,DEN,283,191,32,73,33,28,Win,164,146,5,3,2,LAC,61,447,337,1
0.357142857,0.388888889,25.63333333,1/2/2011,,,18,20,home,-5,LAC,191,283,45,68,28,33,Loss,146,164,3,5,1,DEN,61,337,447,2
0.142857143,0.266666667,25.25,1/2/2011,,,10,19,away,-10,SEA,137,192,46,54,6,16,Loss,47,141,3,0,1,LAR,22,184,333,1
0.266666667,0.142857143,34.75,1/2/2011,,,19,10,home,10,LAR,192,137,70,71,16,6,Win,141,47,0,3,1,SEA,22,333,184,1
0.461538462,0.428571429,32.01666667,1/8/2011,,,32,19,away,-5,SEA,397,265,39,83,36,41,Loss,77,150,1,2,1,NOS,77,474,415,1
0.428571429,0.461538462,27.98333333,1/8/2011,,,19,32,home,5,NOS,265,397,39,61,41,36,Win,150,77,2,1,1,SEA,77,415,474,1
0.533333333,0.461538462,33.11666667,1/8/2011,,,23,16,away,1,IND,184,219,15,70,17,16,Win,169,93,1,1,0,NYJ,33,353,312,1
0.461538462,0.533333333,26.88333333,1/8/2011,,,16,23,home,-1,NYJ,219,184,10,54,16,17,Loss,93,169,1,1,1,IND,33,312,353,0
0.529411765,0.125,41.73333333,1/9/2011,,,26,8,away,23,KCC,248,53,20,78,30,7,Win,142,108,4,3,5,BAL,37,390,161,2
0.125,0.529411765,18.26666667,1/9/2011,,,8,26,home,-23,BAL,53,248,40,40,7,30,Loss,108,142,3,4,2,KCC,37,161,390,5
0.615384615,0.384615385,32,1/9/2011,,,20,18,away,5,PHI,171,271,15,61,21,16,Win,138,81,2,3,1,GBP,37,309,352,2
0.384615385,0.615384615,28,1/9/2011,,,18,20,home,-5,GBP,271,171,50,60,16,21,Loss,81,138,3,2,2,PHI,37,352,309,1
0.416666667,0.5,25.53333333,1/15/2011,,,12,21,away,-7,PIT,91,192,74,53,24,31,Loss,35,71,5,6,2,BAL,55,126,263,3
0.5,0.416666667,34.46666667,1/15/2011,,,21,12,home,7,BAL,192,91,93,69,31,24,Win,71,35,6,5,3,PIT,55,263,126,2
0.666666667,0.3,38.31666667,1/15/2011,,,28,15,away,27,ATL,346,149,65,69,48,21,Win,96,45,2,5,4,GBP,69,442,194,1
0.3,0.666666667,21.68333333,1/15/2011,,,15,28,home,-27,GBP,149,346,32,48,21,48,Loss,45,96,5,2,1,ATL,69,194,442,4
0.214285714,0.555555556,22.83333333,1/16/2011,,,18,21,away,-11,CHI,242,261,20,60,24,35,Loss,34,176,2,3,1,SEA,59,276,437,0
0.555555556,0.214285714,37.18333333,1/16/2011,,,21,18,home,11,SEA,261,242,71,77,35,24,Win,176,34,3,2,0,CHI,59,437,276,1
0.461538462,0.357142857,25.06666667,1/16/2011,,,14,26,away,7,NEP,194,259,35,54,28,21,Win,120,113,0,5,1,NYJ,49,314,372,0
0.357142857,0.461538462,34.93333333,1/16/2011,,,26,14,home,-7,NYJ,259,194,44,78,21,28,Loss,113,120,5,0,0,NEP,49,372,314,1
0.181818182,0.076923077,34.06666667,1/23/2011,,,23,17,away,7,CHI,236,218,40,63,21,14,Win,120,83,1,2,3,GBP,35,356,301,2
0.076923077,0.181818182,25.93333333,1/23/2011,,,17,23,home,-7,GBP,218,236,89,64,14,21,Loss,83,120,2,1,2,CHI,35,301,356,3
0.357142857,0.545454545,25.31666667,1/23/2011,,,17,23,away,-5,PIT,219,121,50,57,19,24,Loss,70,166,2,2,2,NYJ,43,289,287,1
0.545454545,0.357142857,34.68333333,1/23/2011,,,23,17,home,5,NYJ,121,219,25,64,24,19,Win,166,70,2,2,1,PIT,43,287,289,2
0.538461538,0.461538462,33.41666667,2/6/2011,,,19,15,away,-6,GBP,261,288,55,64,25,31,Loss,126,50,1,3,0,PIT,56,387,338,3
0.461538462,0.538461538,26.58333333,2/6/2011,,,15,19,home,6,PIT,288,261,67,55,31,25,Win,50,126,3,1,3,GBP,56,338,387,0
0.642857143,0.666666667,27.1,9/8/2011,,,27,24,away,-8,GBP,396,296,15,73,34,42,Loss,81,103,3,2,0,NOS,76,477,399,1
0.666666667,0.642857143,32.9,9/8/2011,,,24,27,home,8,NOS,296,396,48,64,42,34,Win,103,81,2,3,1,GBP,76,399,477,0
0.363636364,0.5,20.36666667,9/11/2011,,,13,20,away,-2,JAX,249,160,60,49,14,16,Loss,43,163,2,2,1,TEN,30,292,323,1
0.5,0.363636364,39.63333333,9/11/2011,,,20,13,home,2,TEN,160,249,39,73,16,14,Win,163,43,2,2,1,JAX,30,323,292,1
0.111111111,0.454545455,23.26666667,9/11/2011,,,15,26,away,-27,HOU,172,217,60,50,7,34,Loss,64,167,3,1,3,IND,41,236,384,2
0.454545455,0.111111111,36.73333333,9/11/2011,,,26,15,home,27,IND,217,172,30,66,34,7,Win,167,64,1,3,2,HOU,41,384,236,3
0.411764706,0.266666667,30.38333333,9/11/2011,,,17,17,away,10,CLE,155,202,22,64,27,17,Win,139,83,4,2,1,CIN,44,294,285,0
0.266666667,0.411764706,29.61666667,9/11/2011,,,17,17,home,-10,CIN,202,155,72,68,17,27,Loss,83,139,2,4,0,CLE,44,285,294,1
0.5,0.230769231,37.03333333,9/11/2011,,,23,13,away,34,KCC,201,105,30,66,41,7,Win,163,108,1,2,3,BUF,48,364,213,1
0.230769231,0.5,22.96666667,9/11/2011,,,13,23,home,-34,BUF,105,201,3,56,7,41,Loss,108,163,2,1,1,KCC,48,213,364,3
0.333333333,0.4375,27.48333333,9/11/2011,,,20,17,away,-28,BAL,246,215,53,61,7,35,Loss,66,170,4,1,0,PIT,42,312,385,7
0.4375,0.333333333,32.51666667,9/11/2011,,,17,20,home,28,PIT,215,246,75,61,35,7,Win,170,66,1,4,7,BAL,42,385,312,0
0.307692308,0.375,26.68333333,9/11/2011,,,20,17,away,-18,CHI,276,289,65,66,12,30,Loss,110,88,5,5,1,ATL,42,386,377,3
0.375,0.307692308,33.31666667,9/11/2011,,,17,20,home,18,ATL,289,276,56,64,30,12,Win,88,110,5,5,3,CHI,42,377,386,1
0.615384615,0.166666667,30.23333333,9/11/2011,,,27,21,away,18,LAR,167,181,91,67,31,13,Win,236,154,3,5,1,PHI,44,403,335,1
0.166666667,0.615384615,29.76666667,9/11/2011,,,21,27,home,-18,PHI,181,167,60,66,13,31,Loss,154,236,5,3,1,LAR,44,335,403,1
0.181818182,0.428571429,36.41666667,9/11/2011,,,25,17,away,7,TBB,305,259,68,68,27,20,Win,126,56,0,2,2,DET,47,431,315,1
0.428571429,0.181818182,23.58333333,9/11/2011,,,17,25,home,-7,DET,259,305,39,64,20,27,Loss,56,126,2,0,1,TBB,47,315,431,2
0.1,0.333333333,27.4,9/11/2011,,,15,21,away,-14,WAS,240,258,63,56,14,28,Loss,75,74,4,4,1,NYG,42,315,332,1
0.333333333,0.1,32.6,9/11/2011,,,21,15,home,14,NYG,258,240,25,64,28,14,Win,74,75,4,4,1,WAS,42,332,315,1
0.363636364,0.461538462,22.71666667,9/11/2011,,,10,31,away,-7,LAC,28,330,78,43,17,24,Loss,159,77,2,2,2,MIN,41,187,407,1
0.461538462,0.363636364,37.28333333,9/11/2011,,,31,10,home,7,MIN,330,28,26,77,24,17,Win,77,159,2,2,1,LAC,41,407,187,2
0.272727273,0.416666667,32.78333333,9/11/2011,,,26,15,away,-7,ARI,403,295,74,68,21,28,Loss,74,99,4,2,1,CAR,49,477,394,1
0.416666667,0.272727273,27.21666667,9/11/2011,,,15,26,home,7,CAR,295,403,61,54,28,21,Win,99,74,2,4,1,ARI,49,394,477,1
0.333333333,0.083333333,28.88333333,9/11/2011,,,18,12,away,-16,SFO,155,124,72,64,17,33,Loss,64,85,5,0,0,SEA,50,219,209,3
0.083333333,0.333333333,31.11666667,9/11/2011,,,12,18,home,16,SEA,124,155,102,52,33,17,Win,85,64,0,5,3,SFO,50,209,219,0
0.333333333,0.428571429,33.88333333,9/11/2011,,,21,19,away,-3,NYJ,326,315,40,66,24,27,Loss,64,45,4,4,2,DAL,51,390,360,3
0.428571429,0.333333333,26.11666667,9/11/2011,,,19,21,home,3,DAL,315,326,0,64,27,24,Win,45,64,4,4,3,NYJ,51,360,390,2
0.615384615,0.142857143,28.45,9/12/2011,,,27,25,away,14,MIA,516,390,50,71,38,24,Win,106,98,1,4,1,NEP,62,622,488,1
0.142857143,0.615384615,31.55,9/12/2011,,,25,27,home,-14,NEP,390,516,60,73,24,38,Loss,98,106,4,1,1,MIA,62,488,622,1
0.357142857,0.461538462,32.58333333,9/12/2011,,,20,25,away,3,DEN,99,272,131,62,23,20,Win,190,38,1,5,3,OAK,43,289,310,1
0.461538462,0.357142857,27.41666667,9/12/2011,,,25,20,home,-3,OAK,272,99,91,64,20,23,Loss,38,190,5,1,1,DEN,43,310,289,3
0.166666667,0.470588235,23.76666667,9/18/2011,,,18,16,away,-17,NOS,186,264,47,63,13,30,Loss,60,118,6,1,1,CHI,43,246,382,1
0.470588235,0.166666667,36.23333333,9/18/2011,,,16,18,home,17,CHI,264,186,41,67,30,13,Win,118,60,1,6,1,NOS,43,382,246,1
0.666666667,0.363636364,29.21666667,9/18/2011,,,26,34,away,-3,BUF,323,258,85,63,35,38,Loss,131,223,0,1,1,OAK,73,454,481,2
0.363636364,0.666666667,30.78333333,9/18/2011,,,34,26,home,3,OAK,258,323,26,71,38,35,Win,223,131,1,0,2,BUF,73,481,454,1
0.5,0.285714286,34.56666667,9/18/2011,,,18,19,away,8,IND,197,176,49,67,27,19,Win,106,109,1,2,2,CLE,46,303,285,1
0.285714286,0.5,25.43333333,9/18/2011,,,19,18,home,-8,CLE,176,197,21,66,19,27,Loss,109,106,2,1,1,IND,46,285,303,2
0.583333333,0.454545455,26.5,9/18/2011,,,19,25,away,4,MIN,230,212,53,52,24,20,Win,105,186,2,2,1,TBB,44,335,398,1
0.454545455,0.583333333,33.5,9/18/2011,,,25,19,home,-4,TBB,212,230,65,65,20,24,Loss,186,105,2,2,1,MIN,44,398,335,1
0.416666667,0.461538462,27.43333333,9/18/2011,,,16,26,away,7,CAR,295,404,57,52,30,23,Win,124,71,1,4,4,GBP,53,419,475,1
0.461538462,0.416666667,32.56666667,9/18/2011,,,26,16,home,-7,GBP,404,295,50,71,23,30,Loss,71,124,4,1,1,CAR,53,475,419,4
0.166666667,0.533333333,21.26666667,9/18/2011,,,8,23,away,-24,PIT,133,297,66,47,0,24,Loss,31,124,5,2,0,SEA,24,164,421,0
0.533333333,0.166666667,38.73333333,9/18/2011,,,23,8,home,24,SEA,297,133,48,68,24,0,Win,124,31,2,5,0,PIT,24,421,164,0
0.25,0.25,26.61666667,9/18/2011,,,11,15,away,-29,NYJ,91,182,50,54,3,32,Loss,112,101,2,1,2,JAX,35,203,283,4
0.25,0.25,33.38333333,9/18/2011,,,15,11,home,29,JAX,182,91,60,57,32,3,Win,101,112,1,2,4,NYJ,35,283,203,2
0.3,0.411764706,24.13333333,9/18/2011,,,15,21,away,-13,TEN,184,358,44,52,13,26,Loss,45,74,3,0,1,BAL,39,229,432,3
0.411764706,0.3,35.86666667,9/18/2011,,,21,15,home,13,BAL,358,184,70,71,26,13,Win,74,45,0,3,3,TEN,39,432,229,1
0.181818182,0.333333333,27.6,9/18/2011,,,12,23,away,-45,DET,116,322,70,54,3,48,Loss,151,89,2,0,1,KCC,51,267,411,6
0.333333333,0.181818182,32.4,9/18/2011,,,23,12,home,45,KCC,322,116,35,70,48,3,Win,89,151,0,2,6,DET,51,411,267,1
0.333333333,0.352941176,21.5,9/18/2011,,,16,28,away,-1,WAS,231,283,97,48,21,22,Loss,93,172,3,1,2,ARI,43,324,455,2
0.352941176,0.333333333,38.5,9/18/2011,,,28,16,home,1,ARI,283,231,15,79,22,21,Win,172,93,1,3,2,WAS,43,455,324,2
0.428571429,0.5,32.16666667,9/18/2011,,,20,14,away,3,SFO,427,132,83,66,3,0,Win,45,74,1,6,1,DAL,3,472,206,2
0.5,0.428571429,30.71666667,9/18/2011,,,14,20,home,-3,DAL,132,427,25,54,0,3,Loss,74,45,6,1,2,SFO,3,206,472,1
0.090909091,0.416666667,29.75,9/18/2011,,,18,19,away,-2,DEN,310,187,69,63,22,24,Loss,72,131,2,2,2,CIN,46,382,318,0
0.416666667,0.090909091,30.25,9/18/2011,,,19,18,home,2,CIN,187,310,55,63,24,22,Win,131,72,2,2,0,DEN,46,318,382,2
0.833333333,0.636363636,30.96666667,9/18/2011,,,29,28,away,-14,NEP,372,410,44,66,21,35,Loss,98,94,2,2,0,LAC,56,470,504,4
0.636363636,0.833333333,29.03333333,9/18/2011,,,28,29,home,14,LAC,410,372,80,67,35,21,Win,94,98,2,2,4,NEP,56,504,470,0
0.333333333,0.333333333,34.1,9/18/2011,,,19,18,away,10,MIA,207,153,76,68,23,13,Win,138,153,3,2,2,HOU,36,345,306,0
0.333333333,0.333333333,25.9,9/18/2011,,,18,19,home,-10,HOU,153,207,20,60,13,23,Loss,153,138,2,3,0,MIA,36,306,345,2
0.454545455,0.461538462,30.05,9/18/2011,,,27,20,away,-4,ATL,314,180,20,67,31,35,Loss,133,138,0,4,2,PHI,66,447,318,3
0.461538462,0.454545455,29.95,9/18/2011,,,20,27,home,4,PHI,180,314,57,61,35,31,Win,138,133,4,0,3,ATL,66,318,447,2
0.294117647,0.333333333,25.8,9/19/2011,,,14,22,away,-12,NYG,308,204,62,67,16,28,Loss,59,119,2,3,1,LAR,44,367,323,2
0.333333333,0.294117647,34.2,9/19/2011,,,22,14,home,12,LAR,204,308,55,71,28,16,Win,119,59,3,2,2,NYG,44,323,367,1
0.307692308,0.272727273,37.85,9/25/2011,,,22,19,away,-1,CLE,231,210,93,72,16,17,Loss,138,70,5,0,1,MIA,33,369,280,2
0.272727273,0.307692308,22.15,9/25/2011,,,19,22,home,1,MIA,210,231,85,58,17,16,Win,70,138,0,5,2,CLE,33,280,369,1
0.416666667,0.466666667,23.15,9/25/2011,,,14,25,away,13,PHI,232,199,21,51,29,16,Win,102,177,3,2,3,NYG,45,334,376,0
0.466666667,0.416666667,36.85,9/25/2011,,,25,14,home,-13,NYG,199,232,36,72,16,29,Loss,177,102,2,3,0,PHI,45,376,334,3
0.428571429,0.615384615,30.1,9/25/2011,,,21,27,away,-7,NOS,364,354,56,66,33,40,Loss,109,100,2,2,2,HOU,73,473,454,1
0.615384615,0.428571429,29.9,9/25/2011,,,27,21,home,7,HOU,354,364,26,68,40,33,Win,100,109,2,2,1,NOS,73,454,473,2
0.333333333,0.363636364,31.25,9/25/2011,,,30,24,away,-3,BUF,387,369,93,71,31,34,Loss,108,79,0,0,2,NEP,65,495,448,4
0.363636364,0.333333333,28.75,9/25/2011,,,24,30,home,3,NEP,369,387,77,60,34,31,Win,79,108,0,0,4,BUF,65,448,495,2
0.214285714,0.375,30.43333333,9/25/2011,,,13,16,away,-6,CAR,129,158,60,57,10,16,Loss,128,107,2,0,0,JAX,26,257,265,1
0.375,0.214285714,29.56666667,9/25/2011,,,16,13,home,6,JAX,158,129,69,62,16,10,Win,107,128,0,2,1,CAR,26,265,257,0
0.333333333,0.1,35.33333333,9/25/2011,,,16,14,away,5,CIN,176,149,70,64,13,8,Win,50,79,5,1,3,SFO,21,226,228,1
0.1,0.333333333,24.66666667,9/25/2011,,,14,16,home,-5,SFO,149,176,40,53,8,13,Loss,79,50,1,5,1,CIN,21,228,226,3
0.411764706,0.285714286,34.15,9/25/2011,,,19,16,away,3,MIN,338,189,65,70,3,0,Win,20,132,5,4,0,DET,3,358,321,0
0.285714286,0.411764706,27.83333333,9/25/2011,,,16,19,home,-3,DET,189,338,79,63,0,3,Loss,132,20,4,5,0,MIN,3,321,358,0
0.533333333,0.533333333,29.1,9/25/2011,,,19,17,away,-3,TEN,172,295,15,63,14,17,Loss,59,38,1,2,2,DEN,31,231,333,2
0.533333333,0.533333333,30.9,9/25/2011,,,17,19,home,3,DEN,295,172,80,61,17,14,Win,38,59,2,1,2,TEN,31,333,231,2
0.4,0.285714286,31.18333333,9/25/2011,,,25,17,away,30,LAR,385,132,32,76,37,7,Win,168,112,2,5,2,BAL,44,553,244,1
0.285714286,0.4,28.81666667,9/25/2011,,,17,25,home,-30,BAL,132,385,117,63,7,37,Loss,112,168,5,2,1,LAR,44,244,553,2
0.428571429,0,33.33333333,9/25/2011,,,25,23,away,-10,OAK,339,149,61,73,24,34,Loss,100,234,4,1,0,NYJ,58,439,383,2
0,0.428571429,26.66666667,9/25/2011,,,23,25,home,10,NYJ,149,339,55,60,34,24,Win,234,100,1,4,2,OAK,58,383,439,0
0.416666667,0.571428571,25.28333333,9/25/2011,,,13,22,away,-3,LAC,171,258,65,52,17,20,Loss,81,117,1,2,2,KCC,37,252,375,1
0.571428571,0.416666667,34.71666667,9/25/2011,,,22,13,home,3,KCC,258,171,40,70,20,17,Win,117,81,2,1,1,LAC,37,375,252,2
0.384615385,0.357142857,24.13333333,9/25/2011,,,21,20,away,-3,TBB,295,180,50,66,13,16,Loss,30,115,4,0,2,ATL,29,325,295,3
0.357142857,0.384615385,35.86666667,9/25/2011,,,20,21,home,3,ATL,180,295,66,68,16,13,Win,115,30,0,4,3,TBB,29,295,325,2
0.384615385,0.25,37.48333333,9/25/2011,,,24,12,away,10,CHI,292,278,35,69,27,17,Win,100,13,2,3,2,GBP,44,392,291,2
0.25,0.384615385,22.51666667,9/25/2011,,,12,24,home,-10,GBP,278,292,70,52,17,27,Loss,13,100,3,2,2,CHI,44,291,392,2
0.214285714,0.375,31.81666667,9/25/2011,,,20,16,away,-3,SEA,234,139,20,70,10,13,Loss,90,122,3,4,1,ARI,23,324,261,2
0.375,0.214285714,28.18333333,9/25/2011,,,16,20,home,3,ARI,139,234,39,65,13,10,Win,122,90,4,3,2,SEA,23,261,324,1
0.533333333,0.4375,33.96666667,9/25/2011,,,19,14,away,3,IND,341,144,38,68,23,20,Win,67,97,3,1,1,PIT,43,408,241,3
0.4375,0.533333333,26.03333333,9/25/2011,,,14,19,home,-3,PIT,144,341,21,62,20,23,Loss,97,67,1,3,3,IND,43,241,408,1
0.25,0.230769231,28.4,9/26/2011,,,20,17,away,-2,DAL,233,250,35,62,16,18,Loss,65,125,3,1,2,WAS,34,298,375,2
0.230769231,0.25,31.6,9/26/2011,,,17,20,home,2,WAS,250,233,55,63,18,16,Win,125,65,1,3,2,DAL,34,375,298,2
0.5,0.266666667,37.08333333,10/2/2011,,,30,15,away,13,JAX,326,170,50,81,23,10,Win,177,104,3,3,1,NOS,33,503,274,2
0.266666667,0.5,22.91666667,10/2/2011,,,15,30,home,-13,NOS,170,326,15,62,10,23,Loss,104,177,3,3,2,JAX,33,274,503,1
0.166666667,0.3,33.48333333,10/2/2011,,,24,15,away,-5,CHI,374,93,52,72,29,34,Loss,169,224,0,1,1,CAR,63,543,317,1
0.3,0.166666667,26.51666667,10/2/2011,,,15,24,home,5,CAR,93,374,45,49,34,29,Win,224,169,1,0,1,CHI,63,317,543,1
0.307692308,0.384615385,23.35,10/2/2011,,,18,25,away,4,DAL,240,321,75,60,34,30,Win,63,113,0,1,3,DET,64,303,434,1
0.384615385,0.307692308,36.65,10/2/2011,,,25,18,home,-4,DET,321,240,33,75,30,34,Loss,113,63,1,0,1,DAL,64,434,303,3
0.357142857,0.4,32.16666667,10/2/2011,,,17,15,away,-5,KCC,190,247,45,62,17,22,Loss,151,103,2,3,0,MIN,39,341,350,1
0.4,0.357142857,27.83333333,10/2/2011,,,15,17,home,5,MIN,247,190,57,60,22,17,Win,103,151,3,2,1,KCC,39,350,341,0
0.285714286,0.416666667,28.65,10/2/2011,,,12,25,away,-3,CIN,190,287,26,56,20,23,Loss,83,171,1,2,2,BUF,43,273,458,0
0.416666667,0.285714286,31.35,10/2/2011,,,25,12,home,3,BUF,287,190,15,70,23,20,Win,171,83,2,1,0,CIN,43,458,273,2
0.333333333,0.4,23.11666667,10/2/2011,,,13,25,away,18,CLE,220,332,45,50,31,13,Win,112,84,0,4,1,TEN,44,332,416,1
0.4,0.333333333,36.88333333,10/2/2011,,,25,13,home,-18,TEN,332,220,40,87,13,31,Loss,84,112,4,0,1,CLE,44,416,332,1
0.5,0.333333333,35.16666667,10/2/2011,,,16,14,away,7,LAR,143,127,96,69,17,10,Win,196,45,0,7,1,WAS,27,339,172,2
0.333333333,0.5,24.83333333,10/2/2011,,,14,16,home,-7,WAS,127,143,65,67,10,17,Loss,45,196,7,0,2,LAR,27,172,339,1
0.416666667,0.384615385,28.86666667,10/2/2011,,,22,23,away,1,PHI,278,405,40,61,24,23,Win,164,108,3,2,3,SFO,47,442,513,1
0.384615385,0.416666667,31.13333333,10/2/2011,,,23,22,home,-1,SFO,405,278,55,68,23,24,Loss,108,164,2,3,1,PHI,47,513,442,3
0.416666667,0.5,28.28333333,10/2/2011,,,20,17,away,-7,HOU,178,138,45,57,10,17,Loss,118,180,5,0,0,PIT,27,296,318,1
0.5,0.416666667,31.71666667,10/2/2011,,,17,20,home,7,PIT,138,178,64,56,17,10,Win,180,118,0,5,1,HOU,27,318,296,0
0.5625,0.545454545,40.16666667,10/2/2011,,,25,20,away,2,SEA,291,319,35,78,30,28,Win,121,53,0,0,2,ATL,58,412,372,0
0.545454545,0.5625,19.83333333,10/2/2011,,,20,25,home,-2,ATL,319,291,40,53,28,30,Loss,53,121,0,0,0,SEA,58,372,412,2
0.461538462,0.25,28.01666667,10/2/2011,,,24,22,away,4,ARI,306,212,55,65,31,27,Win,54,156,1,4,2,NYG,58,360,368,2
0.25,0.461538462,31.98333333,10/2/2011,,,22,24,home,-4,NYG,212,306,118,70,27,31,Loss,156,54,4,1,2,ARI,58,368,360,2
0.444444444,0.615384615,26.66666667,10/2/2011,,,25,24,away,12,OAK,226,344,45,61,31,19,Win,183,160,1,0,2,NEP,50,409,504,0
0.615384615,0.444444444,33.33333333,10/2/2011,,,24,25,home,-12,NEP,344,226,85,66,19,31,Loss,160,183,0,1,0,OAK,50,504,409,2
0.363636364,0.692307692,26.98333333,10/2/2011,,,18,26,away,-26,GBP,265,396,24,56,23,49,Loss,119,111,1,2,2,DEN,72,384,507,4
0.692307692,0.363636364,33.01666667,10/2/2011,,,26,18,home,26,DEN,396,265,27,69,49,23,Win,111,119,2,1,4,GBP,72,507,384,2
0.3,0.5,26.7,10/2/2011,,,16,21,away,-10,LAC,176,295,41,55,16,26,Loss,72,116,3,2,0,MIA,42,248,411,2
0.5,0.3,33.3,10/2/2011,,,21,16,home,10,MIA,295,176,80,61,26,16,Win,116,72,2,3,2,LAC,42,411,248,0
0.266666667,0.333333333,22.53333333,10/2/2011,,,7,16,away,-17,BAL,112,155,69,56,17,34,Loss,38,112,2,2,3,NYJ,51,150,267,4
0.333333333,0.266666667,37.46666667,10/2/2011,,,16,7,home,17,NYJ,155,112,46,73,34,17,Win,112,38,2,2,4,BAL,51,267,150,3
0.307692308,0.411764706,21,10/3/2011,,,13,25,away,-7,TBB,256,274,50,52,17,24,Loss,62,192,4,2,0,IND,41,318,466,1
0.411764706,0.307692308,39,10/3/2011,,,25,13,home,7,IND,274,256,106,77,24,17,Win,192,62,2,4,1,TBB,41,466,318,0
0.466666667,0.583333333,27.63333333,10/9/2011,,,20,26,away,-21,PIT,240,257,70,70,17,38,Loss,66,174,3,1,1,TEN,55,306,431,1
0.583333333,0.466666667,32.36666667,10/9/2011,,,26,20,home,21,TEN,257,240,51,64,38,17,Win,174,66,1,3,1,PIT,55,431,306,1
0.421052632,0.375,32.55,10/9/2011,,,13,12,away,10,JAX,162,200,33,66,30,20,Win,77,96,2,3,2,CIN,50,239,296,1
0.375,0.421052632,27.45,10/9/2011,,,12,13,home,-10,CIN,200,162,15,58,20,30,Loss,96,77,3,2,1,JAX,50,296,239,2
0.705882353,0.583333333,34.66666667,10/9/2011,,,27,20,away,3,CAR,343,219,82,75,30,27,Win,101,162,2,1,1,NOS,57,444,381,1
0.583333333,0.705882353,25.33333333,10/9/2011,,,20,27,home,-3,NOS,219,343,65,54,27,30,Loss,162,101,1,2,1,CAR,57,381,444,1
0.2,0.4,25.58333333,10/9/2011,,,11,21,away,5,HOU,184,403,89,60,25,20,Win,94,70,3,3,2,OAK,45,278,473,1
0.4,0.2,34.41666667,10/9/2011,,,21,11,home,-5,OAK,403,184,50,79,20,25,Loss,70,94,3,3,1,HOU,45,473,278,2
0.222222222,0.428571429,26.36666667,10/9/2011,,,24,21,away,-7,BUF,315,188,46,60,24,31,Loss,174,143,0,1,1,PHI,55,489,331,5
0.428571429,0.222222222,33.63333333,10/9/2011,,,21,24,home,7,PHI,188,315,40,63,31,24,Win,143,174,1,0,5,BUF,55,331,489,1
0.444444444,0.3,31.01666667,10/9/2011,,,18,20,away,-24,MIN,214,160,64,76,10,34,Loss,77,172,4,1,1,ARI,44,291,332,4
0.3,0.444444444,28.98333333,10/9/2011,,,20,18,home,24,ARI,160,214,35,59,34,10,Win,172,77,1,4,4,MIN,44,332,291,1
0.266666667,0.083333333,28.76666667,10/9/2011,,,22,21,away,11,NYG,279,395,70,76,36,25,Win,145,69,6,3,5,SEA,61,424,464,3
0.083333333,0.266666667,31.23333333,10/9/2011,,,21,22,home,-11,SEA,395,279,52,67,25,36,Loss,69,145,3,6,3,NYG,61,464,424,5
0.571428571,0.416666667,33.11666667,10/9/2011,,,26,15,away,4,IND,242,277,39,69,28,24,Win,194,78,2,0,0,KCC,52,436,355,0
0.416666667,0.571428571,26.88333333,10/9/2011,,,15,26,home,-4,KCC,277,242,40,54,24,28,Loss,78,194,0,2,0,IND,52,355,436,0
0.4375,0.285714286,28.96666667,10/9/2011,,,14,28,away,-45,SFO,186,205,96,61,3,48,Loss,86,213,3,0,1,TBB,51,272,418,3
0.285714286,0.4375,31.03333333,10/9/2011,,,28,14,home,45,TBB,205,186,30,58,48,3,Win,213,86,0,3,3,SFO,51,418,272,1
0.5,0.222222222,40.13333333,10/9/2011,,,25,13,away,5,DEN,212,113,0,77,29,24,Win,206,162,5,0,1,LAC,53,418,275,2
0.222222222,0.5,19.86666667,10/9/2011,,,13,25,home,-5,LAC,113,212,53,46,24,29,Loss,162,206,0,5,2,DEN,53,275,418,1
0.272727273,0.5,26.08333333,10/9/2011,,,14,26,away,-9,NEP,158,294,89,53,21,30,Loss,97,152,2,4,1,NYJ,51,255,446,0
0.5,0.272727273,33.91666667,10/9/2011,,,26,14,home,9,NYJ,294,158,50,72,30,21,Win,152,97,4,2,0,NEP,51,446,255,1
0.6,0.454545455,33.18333333,10/9/2011,,,19,18,away,11,ATL,369,156,55,63,25,14,Win,57,95,4,1,2,GBP,39,426,251,1
0.454545455,0.6,26.81666667,10/9/2011,,,18,19,home,-11,GBP,156,369,44,55,14,25,Loss,95,57,1,4,1,ATL,39,251,426,2
0.307692308,0.454545455,39.05,10/10/2011,,,23,16,away,-11,DET,237,214,104,66,13,24,Loss,122,181,3,1,1,CHI,37,359,395,0
0.454545455,0.307692308,20.95,10/10/2011,,,16,23,home,11,CHI,214,237,94,47,24,13,Win,181,122,1,3,0,DET,37,395,359,1
0.230769231,0.307692308,30.68333333,10/16/2011,,,22,20,away,-21,GBP,306,309,45,72,3,24,Loss,118,90,3,1,1,LAR,27,424,399,1
0.307692308,0.230769231,29.31666667,10/16/2011,,,20,22,home,21,LAR,309,306,16,61,24,3,Win,90,118,1,3,1,GBP,27,399,424,1
0.454545455,0.454545455,29.21666667,10/16/2011,,,17,24,away,-3,NYG,219,292,75,56,24,27,Loss,155,122,3,0,0,BUF,51,374,414,2
0.454545455,0.454545455,30.78333333,10/16/2011,,,24,17,home,3,BUF,292,219,79,65,27,24,Win,122,155,0,3,2,NYG,51,414,374,0
0.5,0.428571429,26.4,10/16/2011,,,18,17,away,-10,CIN,179,264,11,58,17,27,Loss,94,94,1,0,0,IND,44,273,358,3
0.428571429,0.5,33.6,10/16/2011,,,17,18,home,10,IND,264,179,111,63,27,17,Win,94,94,0,1,3,CIN,44,358,273,0
0.666666667,0.636363636,29.43333333,10/16/2011,,,24,24,away,-14,ATL,229,159,85,62,17,31,Loss,139,166,1,1,0,CAR,48,368,325,3
0.636363636,0.666666667,30.56666667,10/16/2011,,,24,24,home,14,CAR,159,229,57,58,31,17,Win,166,139,1,1,3,ATL,48,325,368,0
0.142857143,0.133333333,29.65,10/16/2011,,,14,21,away,6,DET,111,244,120,63,25,19,Win,203,66,2,5,0,SFO,44,314,310,2
0.133333333,0.142857143,30.35,10/16/2011,,,21,14,home,-6,SFO,244,111,54,73,19,25,Loss,66,203,5,2,2,DET,44,310,314,0
0.375,0.1,38.13333333,10/16/2011,,,22,17,away,7,WAS,230,245,60,72,20,13,Win,192,42,2,2,4,PHI,33,422,287,2
0.1,0.375,21.86666667,10/16/2011,,,17,22,home,-7,PHI,245,230,75,53,13,20,Loss,42,192,2,2,2,WAS,33,287,422,4
0.266666667,0.466666667,28.78333333,10/16/2011,,,16,15,away,-4,PIT,76,185,22,61,13,17,Loss,133,185,5,3,0,JAX,30,209,370,0
0.466666667,0.266666667,31.21666667,10/16/2011,,,15,16,home,4,JAX,185,76,65,58,17,13,Win,185,133,3,5,0,PIT,30,370,209,0
0.5,0.5,25.31666667,10/16/2011,,,18,18,away,-7,OAK,203,178,34,68,17,24,Loss,65,151,2,2,1,CLE,41,268,329,1
0.5,0.5,34.68333333,10/16/2011,,,18,18,home,7,CLE,178,203,35,66,24,17,Win,151,65,2,2,1,OAK,41,329,268,1
0.375,0.272727273,27.8,10/16/2011,,,18,24,away,-15,BAL,200,289,15,66,14,29,Loss,93,113,4,2,2,HOU,43,293,402,0
0.272727273,0.375,32.2,10/16/2011,,,24,18,home,15,HOU,289,200,25,65,29,14,Win,113,93,2,4,0,BAL,43,402,293,2
0.416666667,0.285714286,28.55,10/16/2011,,,20,21,away,-6,TBB,383,303,53,65,20,26,Loss,70,117,0,0,0,NOS,46,453,420,4
0.285714286,0.416666667,31.45,10/16/2011,,,21,20,home,6,NOS,303,383,64,66,26,20,Win,117,70,0,0,4,TBB,46,420,453,0
0.333333333,0.615384615,32.81666667,10/16/2011,,,21,25,away,-4,NEP,300,270,77,67,16,20,Loss,77,101,2,3,4,DAL,36,377,371,2
0.615384615,0.333333333,27.18333333,10/16/2011,,,25,21,home,4,DAL,270,300,35,69,20,16,Win,101,77,3,2,2,NEP,36,371,377,4
0.4,0.363636364,29.33333333,10/16/2011,,,15,22,away,-29,CHI,233,258,40,64,10,39,Loss,53,119,5,1,1,MIN,49,286,377,0
0.363636364,0.4,30.66666667,10/16/2011,,,22,15,home,29,MIN,258,233,15,60,39,10,Win,119,53,1,5,0,CHI,49,377,286,1
0.153846154,0.4,29.65,10/17/2011,,,17,13,away,-18,NYJ,190,192,10,63,6,24,Loss,118,104,4,2,1,MIA,30,308,296,3
0.4,0.153846154,30.35,10/17/2011,,,13,17,home,18,MIA,192,190,49,56,24,6,Win,104,118,2,4,3,NYJ,30,296,308,1
0.538461538,0.2,37.96666667,10/23/2011,,,29,11,away,34,TEN,296,95,68,70,41,7,Win,222,53,0,2,2,HOU,48,518,148,0
0.2,0.538461538,22.03333333,10/23/2011,,,11,29,home,-34,HOU,95,296,76,48,7,41,Loss,53,222,2,0,0,TEN,48,148,518,2
0.307692308,0.285714286,33.2,10/23/2011,,,19,16,away,6,TBB,218,250,54,67,24,18,Win,177,30,2,1,4,CHI,42,395,280,2
0.285714286,0.307692308,26.8,10/23/2011,,,16,19,home,-6,CHI,250,218,69,64,18,24,Loss,30,177,1,2,2,TBB,42,280,395,4
0.166666667,0.5,17.06666667,10/23/2011,,,9,20,away,-3,CLE,69,159,68,50,3,6,Loss,68,139,4,4,1,SEA,9,137,298,2
0.5,0.166666667,42.93333333,10/23/2011,,,20,9,home,3,SEA,159,69,48,84,6,3,Win,139,68,4,4,2,CLE,9,298,137,1
0.5,0.615384615,27.23333333,10/23/2011,,,16,25,away,-6,NYJ,172,156,95,58,21,27,Loss,96,162,1,2,2,LAC,48,268,318,2
0.615384615,0.5,32.76666667,10/23/2011,,,25,16,home,6,LAC,156,172,60,66,27,21,Win,162,96,2,1,2,NYJ,48,318,268,2
0.416666667,0.416666667,24.5,10/23/2011,,,22,20,away,-13,CAR,261,232,26,63,20,33,Loss,92,175,3,4,0,WAS,53,353,407,3
0.416666667,0.416666667,35.5,10/23/2011,,,20,22,home,13,WAS,232,261,105,64,33,20,Win,175,92,4,3,3,CAR,53,407,353,0
0.411764706,0.083333333,34.95,10/23/2011,,,22,13,away,7,DET,199,159,80,69,23,16,Win,129,104,3,3,1,ATL,39,328,263,2
0.083333333,0.411764706,25.05,10/23/2011,,,13,22,home,-7,ATL,159,199,84,55,16,23,Loss,104,129,3,3,2,DET,39,263,328,1
0.25,0.214285714,34.28333333,10/23/2011,,,18,15,away,3,MIA,131,173,30,73,3,0,Win,177,94,6,4,1,DEN,3,308,267,1
0.214285714,0.25,33.31666667,10/23/2011,,,15,18,home,-3,DEN,173,131,20,68,0,3,Loss,94,177,4,6,1,MIA,3,267,308,1
0.5,0.375,35.78333333,10/23/2011,,,26,23,away,12,ARI,354,257,69,69,32,20,Win,91,73,2,2,1,PIT,52,445,330,0
0.375,0.5,24.21666667,10/23/2011,,,23,26,home,-12,PIT,257,354,74,55,20,32,Loss,73,91,2,2,0,ARI,52,330,445,1
0.466666667,0.307692308,33.61666667,10/23/2011,,,22,18,away,28,OAK,161,167,98,69,28,0,Win,139,155,0,1,6,KCC,28,300,322,2
0.307692308,0.466666667,26.38333333,10/23/2011,,,18,22,home,-28,KCC,167,161,120,63,0,28,Loss,155,139,1,0,2,OAK,28,322,300,6
0.25,0.5625,32.1,10/23/2011,,,25,22,away,6,MIN,307,217,44,60,33,27,Win,114,218,4,2,2,GBP,60,421,435,1
0.5625,0.25,27.9,10/23/2011,,,22,25,home,-6,GBP,217,307,91,65,27,33,Loss,218,114,2,4,1,MIN,60,435,421,2
0.384615385,0.375,26.06666667,10/23/2011,,,13,24,away,-27,DAL,195,151,16,55,7,34,Loss,70,294,1,2,1,LAR,41,265,445,2
0.375,0.384615385,33.93333333,10/23/2011,,,24,13,home,27,LAR,151,195,30,60,34,7,Win,294,70,2,1,2,DAL,41,445,265,1
0.363636364,0.75,21.68333333,10/23/2011,,,11,36,away,-55,NOS,97,321,49,46,7,62,Loss,155,236,1,2,0,IND,69,252,557,3
0.75,0.363636364,38.31666667,10/23/2011,,,36,11,home,55,IND,321,97,10,75,62,7,Win,236,155,2,1,3,NOS,69,557,252,0
0.166666667,0.125,23.75,10/24/2011,,,11,13,away,-5,JAX,112,73,85,53,7,12,Loss,34,132,3,4,1,BAL,19,146,205,2
0.125,0.166666667,36.25,10/24/2011,,,13,11,home,5,BAL,73,112,90,66,12,7,Win,132,34,4,3,2,JAX,19,205,146,1
0.181818182,0.363636364,30.3,10/30/2011,,,17,30,away,-3,BAL,98,298,92,57,27,30,Loss,109,107,6,3,2,ARI,57,207,405,1
0.363636364,0.181818182,29.7,10/30/2011,,,30,17,home,3,ARI,298,98,99,80,30,27,Win,107,109,3,6,1,BAL,57,405,207,2
0.470588235,0.3125,28.61666667,10/30/2011,,,19,21,away,-10,LAR,227,140,32,70,21,31,Loss,56,183,6,4,1,NOS,52,283,323,2
0.3125,0.470588235,31.38333333,10/30/2011,,,21,19,home,10,NOS,140,227,64,72,31,21,Win,183,56,4,6,2,LAR,52,323,283,1
0.5,0.5,32.08333333,10/30/2011,,,22,21,away,3,CAR,229,265,43,65,24,21,Win,132,140,4,3,2,MIN,45,361,405,1
0.5,0.5,27.91666667,10/30/2011,,,21,22,home,-3,MIN,265,229,60,65,21,24,Loss,140,132,3,4,1,CAR,45,405,361,2
0.352941176,0.411764706,28.53333333,10/30/2011,,,22,17,away,-17,TEN,241,215,66,77,10,27,Loss,158,96,2,1,0,IND,37,399,311,2
0.411764706,0.352941176,31.46666667,10/30/2011,,,17,22,home,17,IND,215,241,40,65,27,10,Win,96,158,1,2,2,TEN,37,311,399,0
0.384615385,0.5,27.56666667,10/30/2011,,,18,21,away,-3,NYG,101,344,30,53,17,20,Loss,145,58,5,1,0,MIA,37,246,402,1
0.5,0.384615385,32.43333333,10/30/2011,,,21,18,home,3,MIA,344,101,46,69,20,17,Win,58,145,1,5,1,NYG,37,402,246,0
0.357142857,0.588235294,24.68333333,10/30/2011,,,13,20,away,-10,HOU,90,202,39,58,14,24,Loss,84,156,1,2,2,JAX,38,174,358,2
0.588235294,0.357142857,35.31666667,10/30/2011,,,20,13,home,10,JAX,202,90,60,71,24,14,Win,156,84,2,1,2,HOU,38,358,174,2
0.333333333,0.142857143,29.56666667,10/30/2011,,,21,19,away,35,DEN,263,117,45,62,45,10,Win,113,195,2,7,3,DET,55,376,312,0
0.142857143,0.333333333,30.43333333,10/30/2011,,,19,21,home,-35,DET,117,263,55,76,10,45,Loss,195,113,7,2,0,DEN,55,312,376,3
0.285714286,0.5,25.15,10/30/2011,,,10,17,away,-23,BUF,152,252,59,54,0,23,Loss,26,138,10,2,2,WAS,23,178,390,2
0.5,0.285714286,34.85,10/30/2011,,,17,10,home,23,WAS,252,152,35,62,23,0,Win,138,26,2,10,2,BUF,23,390,178,2
0.428571429,0.333333333,31.45,10/30/2011,,,18,20,away,22,SEA,160,350,65,57,34,12,Win,92,61,1,4,2,CIN,46,252,411,2
0.333333333,0.428571429,28.55,10/30/2011,,,20,18,home,-22,CIN,350,160,80,71,12,34,Loss,61,92,4,1,2,SEA,46,411,252,2
0.428571429,0.4,27.13333333,10/30/2011,,,18,19,away,-10,SFO,224,174,39,61,10,20,Loss,66,174,4,1,0,CLE,30,290,348,2
0.4,0.428571429,32.86666667,10/30/2011,,,19,18,home,10,CLE,174,224,40,64,20,10,Win,174,66,1,4,2,SFO,30,348,290,0
0.3,0.625,20.63333333,10/30/2011,,,19,29,away,-8,PIT,170,329,37,50,17,25,Loss,43,98,3,5,1,NEP,42,213,427,0
0.625,0.3,39.36666667,10/30/2011,,,29,19,home,8,NEP,329,170,50,78,25,17,Win,98,43,5,3,0,PIT,42,427,213,1
0.3,0.583333333,17.85,10/30/2011,,,12,31,away,-27,PHI,182,256,20,49,7,34,Loss,85,239,4,4,0,DAL,41,267,495,1
0.583333333,0.3,42.15,10/30/2011,,,31,12,home,27,DAL,256,182,33,70,34,7,Win,239,85,4,4,1,PHI,41,495,267,0
0.357142857,0.5,37.48333333,10/31/2011,,,22,19,away,-3,KCC,345,247,105,71,0,3,Loss,102,94,3,3,4,LAC,3,447,341,4
0.5,0.357142857,32.25,10/31/2011,,,19,22,home,3,LAC,247,345,53,67,3,0,Win,94,102,3,3,4,KCC,3,341,447,4
0.2,0.428571429,30.55,11/6/2011,,,18,18,away,-10,DAL,219,279,88,61,13,23,Loss,162,163,1,0,1,SEA,36,381,442,3
0.428571429,0.2,29.45,11/6/2011,,,18,18,home,10,SEA,279,219,82,60,23,13,Win,163,162,0,1,3,DAL,36,442,381,1
0.428571429,0.285714286,37.76666667,11/6/2011,,,21,10,away,24,IND,269,103,10,66,31,7,Win,163,83,1,2,2,ATL,38,432,186,1
0.285714286,0.428571429,22.23333333,11/6/2011,,,10,21,home,-24,ATL,103,269,32,56,7,31,Loss,83,163,2,1,1,IND,38,186,432,2
0.545454545,0.272727273,37.86666667,11/6/2011,,,24,14,away,16,BUF,222,191,60,68,27,11,Win,126,96,1,0,3,NYJ,38,348,287,2
0.272727273,0.545454545,22.13333333,11/6/2011,,,14,24,home,-16,NYJ,191,222,84,53,11,27,Loss,96,126,0,1,2,BUF,38,287,348,3
0.333333333,0.642857143,24.75,11/6/2011,,,10,21,away,-18,HOU,128,119,35,47,12,30,Loss,44,261,4,0,1,CLE,42,172,380,2
0.642857143,0.333333333,35.25,11/6/2011,,,21,10,home,18,CLE,119,128,15,63,30,12,Win,261,44,0,4,2,HOU,42,380,172,1
0.25,0.416666667,32.31666667,11/6/2011,,,15,17,away,8,WAS,188,251,55,58,19,11,Win,138,52,2,2,3,SFO,30,326,303,1
0.416666667,0.25,27.68333333,11/6/2011,,,17,15,home,-8,SFO,251,188,35,63,11,19,Loss,52,138,2,2,1,WAS,30,303,326,3
0.166666667,0.5,29.93333333,11/6/2011,,,18,25,away,-11,NOS,281,258,80,58,16,27,Loss,84,195,1,0,1,TBB,43,365,453,0
0.5,0.166666667,30.06666667,11/6/2011,,,25,18,home,11,TBB,258,281,63,64,27,16,Win,195,84,0,1,0,NOS,43,453,365,1
0.3,0.4,25.35,11/6/2011,,,17,20,away,28,KCC,244,227,49,47,31,3,Win,107,116,0,5,0,MIA,34,351,343,0
0.4,0.3,34.65,11/6/2011,,,20,17,home,-28,MIA,227,244,70,78,3,31,Loss,116,107,5,0,0,KCC,34,343,351,0
0.5,0.357142857,32.91666667,11/6/2011,,,20,19,away,7,TEN,210,250,87,70,24,17,Win,109,78,1,2,1,CIN,41,319,328,0
0.357142857,0.5,27.08333333,11/6/2011,,,19,20,home,-7,CIN,250,210,100,63,17,24,Loss,78,109,2,1,0,TEN,41,328,319,1
0.25,0.333333333,31.85,11/6/2011,,,20,21,away,14,OAK,113,316,93,62,38,24,Win,299,100,1,2,3,DEN,62,412,416,0
0.333333333,0.25,28.15,11/6/2011,,,21,20,home,-14,DEN,316,113,130,63,24,38,Loss,100,299,2,1,0,OAK,62,416,412,3
0.285714286,0.333333333,30.28333333,11/6/2011,,,23,23,away,4,NEP,250,332,50,68,24,20,Win,111,106,0,2,4,NYG,44,361,438,2
0.333333333,0.285714286,29.71666667,11/6/2011,,,23,23,home,-4,NYG,332,250,81,75,20,24,Loss,106,111,2,0,2,NEP,44,438,361,4
0.214285714,0.2,36.96666667,11/6/2011,,,23,16,away,-6,ARI,233,192,71,75,0,6,Loss,150,70,4,3,0,LAR,6,383,262,1
0.2,0.214285714,24.98333333,11/6/2011,,,16,23,home,6,LAR,192,233,45,55,6,0,Win,70,150,3,4,1,ARI,6,262,383,0
0.6,0.454545455,29.75,11/6/2011,,,21,28,away,7,LAC,232,375,33,56,45,38,Win,136,85,4,2,3,GBP,83,368,460,0
0.454545455,0.6,30.25,11/6/2011,,,28,21,home,-7,GBP,375,232,64,69,38,45,Loss,85,136,2,4,0,LAC,83,460,368,3
0.666666667,0.583333333,33.98333333,11/6/2011,,,23,20,away,3,PIT,289,322,20,77,23,20,Win,67,70,3,1,2,BAL,43,356,392,1
0.583333333,0.666666667,26.01666667,11/6/2011,,,20,23,home,-3,BAL,322,289,69,58,20,23,Loss,70,67,1,3,1,PIT,43,392,356,2
0.5,0.571428571,33.45,11/7/2011,,,22,20,away,6,PHI,208,211,53,66,30,24,Win,164,119,0,1,2,CHI,54,372,330,2
0.571428571,0.5,26.55,11/7/2011,,,20,22,home,-6,CHI,211,208,44,63,24,30,Loss,119,164,1,0,2,PHI,54,330,372,2
0.4,0.3125,32.61666667,11/10/2011,,,20,20,away,7,LAC,298,239,45,63,24,17,Win,191,75,1,6,2,OAK,41,489,314,2
0.3125,0.4,27.38333333,11/10/2011,,,20,20,home,-7,OAK,239,298,31,68,17,24,Loss,75,191,6,1,2,LAC,41,314,489,2
0.307692308,0.3125,30.05,11/13/2011,,,18,30,away,3,ATL,322,343,79,59,3,0,Win,41,138,0,1,1,NOS,3,363,481,0
0.3125,0.307692308,36.53333333,11/13/2011,,,30,18,home,-3,NOS,343,322,85,85,0,3,Loss,138,41,1,0,0,ATL,3,481,363,1
0.3,0.230769231,35.1,11/13/2011,,,21,12,away,28,TBB,235,141,54,60,37,9,Win,185,90,1,4,4,HOU,46,420,231,0
0.230769231,0.3,24.9,11/13/2011,,,12,21,home,-28,HOU,141,235,49,57,9,37,Loss,90,185,4,1,0,TBB,46,231,420,4
0.333333333,0.357142857,27.55,11/13/2011,,,17,16,away,1,CLE,148,209,55,58,13,12,Win,133,126,1,2,1,LAR,25,281,335,2
0.357142857,0.333333333,32.45,11/13/2011,,,16,17,home,-1,LAR,209,148,60,59,12,13,Loss,126,133,2,1,2,CLE,25,335,281,1
0.416666667,0.363636364,33.88333333,11/13/2011,,,24,14,away,7,CIN,223,170,31,68,24,17,Win,105,109,5,0,2,PIT,41,328,279,1
0.363636364,0.416666667,26.11666667,11/13/2011,,,14,24,home,-7,PIT,170,223,35,56,17,24,Loss,109,105,0,5,1,CIN,41,279,328,2
0.384615385,0.571428571,26.45,11/13/2011,,,16,20,away,-11,MIA,185,200,51,51,9,20,Loss,61,103,3,2,2,WAS,29,246,303,2
0.571428571,0.384615385,33.55,11/13/2011,,,20,16,home,11,WAS,200,185,55,64,20,9,Win,103,61,2,3,2,MIA,29,303,246,2
0.230769231,0.214285714,32.6,11/13/2011,,,22,16,away,27,CAR,211,166,92,63,30,3,Win,172,113,1,5,2,TEN,33,383,279,1
0.214285714,0.230769231,27.4,11/13/2011,,,16,22,home,-27,TEN,166,211,99,64,3,30,Loss,113,172,5,1,1,CAR,33,279,383,2
0.375,0.2,31.7,11/13/2011,,,23,15,away,4,PHI,282,123,66,73,21,17,Win,88,166,4,2,2,ARI,38,370,289,2
0.2,0.375,28.3,11/13/2011,,,15,23,home,-4,ARI,123,282,97,60,17,21,Loss,166,88,2,4,2,PHI,38,289,370,2
0.357142857,0.181818182,33.63333333,11/13/2011,,,16,17,away,7,KCC,69,124,65,63,17,10,Win,244,134,0,4,0,DEN,27,313,258,0
0.181818182,0.357142857,26.36666667,11/13/2011,,,17,16,home,-7,DEN,124,69,40,62,10,17,Loss,134,244,4,0,0,KCC,27,258,313,0
0.4,0.266666667,35.35,11/13/2011,,,18,13,away,14,IND,110,128,55,64,17,3,Win,141,84,2,5,3,JAX,20,251,212,1
0.266666667,0.4,24.65,11/13/2011,,,13,18,home,-14,JAX,128,110,40,57,3,17,Loss,84,141,5,2,1,IND,20,212,251,3
0.285714286,0.666666667,25.46666667,11/13/2011,,,20,24,away,-37,DAL,136,270,12,49,7,44,Loss,135,163,1,0,0,BUF,51,271,433,4
0.666666667,0.285714286,34.53333333,11/13/2011,,,24,20,home,37,BUF,270,136,74,61,44,7,Win,163,135,0,1,4,DAL,51,433,271,0
0.416666667,0.3125,24.98333333,11/13/2011,,,25,16,away,-5,SEA,248,208,34,66,17,22,Loss,75,119,1,1,0,BAL,39,323,327,3
0.3125,0.416666667,35.01666667,11/13/2011,,,16,25,home,5,BAL,208,248,100,70,22,17,Win,119,75,1,1,3,SEA,39,327,323,0
0.235294118,0.230769231,30.9,11/13/2011,,,22,12,away,-24,CHI,313,107,53,84,13,37,Loss,80,109,2,2,1,DET,50,393,216,6
0.230769231,0.235294118,29.1,11/13/2011,,,12,22,home,24,DET,107,313,37,57,37,13,Win,109,80,2,2,6,CHI,50,216,393,1
0.5,0.272727273,34.6,11/13/2011,,,21,16,away,-7,SFO,302,228,45,70,20,27,Loss,93,77,1,2,1,NYG,47,395,305,2
0.272727273,0.5,25.4,11/13/2011,,,16,21,home,7,NYG,228,302,35,52,27,20,Win,77,93,2,1,2,SFO,47,305,395,1
0.307692308,0.384615385,30.11666667,11/13/2011,,,21,22,away,21,NYJ,329,268,80,67,37,16,Win,60,110,0,5,3,NEP,53,389,378,0
0.384615385,0.307692308,29.88333333,11/13/2011,,,22,21,home,-21,NEP,268,329,56,69,16,37,Loss,110,60,5,0,0,NYJ,53,378,389,3
0.357142857,0.538461538,26.7,11/14/2011,,,14,23,away,-38,GBP,162,266,80,59,7,45,Loss,104,90,3,3,1,MIN,52,266,356,1
0.538461538,0.357142857,33.3,11/14/2011,,,23,14,home,38,MIN,266,162,5,66,45,7,Win,90,104,3,3,1,GBP,52,356,266,1
0.214285714,0.230769231,32.2,11/17/2011,,,22,11,away,-4,DEN,235,104,15,71,13,17,Loss,83,125,3,1,1,NYJ,30,318,229,2
0.230769231,0.214285714,27.8,11/17/2011,,,11,22,home,4,NYJ,104,235,51,56,17,13,Win,125,83,1,3,2,DEN,30,229,318,1
0,0.416666667,28.9,11/20/2011,,,14,16,away,-27,MIA,204,147,27,65,8,35,Loss,41,95,2,1,0,BUF,43,245,242,2
0.416666667,0,31.1,11/20/2011,,,16,14,home,27,BUF,147,204,50,56,35,8,Win,95,41,1,2,2,MIA,43,242,245,0
0.333333333,0.357142857,32.88333333,11/20/2011,,,23,13,away,-7,BAL,364,268,43,78,24,31,Loss,119,105,2,1,1,CIN,55,483,373,3
0.357142857,0.333333333,27.11666667,11/20/2011,,,13,23,home,7,CIN,268,364,69,56,31,24,Win,105,119,1,2,3,BAL,55,373,483,1
0.466666667,0.4,30.88333333,11/20/2011,,,23,20,away,-4,CLE,195,186,81,71,10,14,Loss,108,148,1,2,1,JAX,24,303,334,0
0.4,0.466666667,29.11666667,11/20/2011,,,20,23,home,4,JAX,186,195,70,54,14,10,Win,148,108,2,1,0,CLE,24,334,303,1
0.470588235,0.4,36.01666667,11/20/2011,,,20,18,away,3,WAS,264,279,48,73,3,0,Win,89,60,4,3,2,DAL,3,353,339,0
0.4,0.470588235,33.33333333,11/20/2011,,,18,20,home,-3,DAL,279,264,59,65,0,3,Loss,60,89,3,4,0,WAS,3,339,353,2
0.454545455,0.583333333,31.35,11/20/2011,,,22,24,away,-9,GBP,334,287,55,60,26,35,Loss,121,91,2,2,1,TBB,61,455,378,2
0.583333333,0.454545455,28.65,11/20/2011,,,24,22,home,9,TBB,287,334,37,59,35,26,Win,91,121,2,2,2,GBP,61,378,455,1
0.3,0.545454545,26.88333333,11/20/2011,,,24,29,away,-14,DET,272,326,70,65,35,49,Loss,137,169,1,2,3,CAR,84,409,495,4
0.545454545,0.3,33.11666667,11/20/2011,,,29,24,home,14,CAR,326,272,56,67,49,35,Win,169,137,2,1,4,DET,84,495,409,3
0.357142857,0.4,35.73333333,11/20/2011,,,22,20,away,6,MIN,139,187,117,68,27,21,Win,162,124,4,5,5,OAK,48,301,311,1
0.4,0.357142857,24.26666667,11/20/2011,,,20,22,home,-6,OAK,187,139,50,62,21,27,Loss,124,162,5,4,1,MIN,48,311,301,5
0.111111111,0.380952381,15.73333333,11/20/2011,,,11,25,away,-16,SFO,149,267,75,48,7,23,Loss,80,164,2,0,1,ARI,30,229,431,5
0.380952381,0.111111111,44.26666667,11/20/2011,,,25,11,home,16,ARI,267,149,87,87,23,7,Win,164,80,0,2,5,SFO,30,431,229,1
0.411764706,0.333333333,35,11/20/2011,,,16,13,away,17,LAR,163,143,100,68,24,7,Win,126,42,4,5,3,SEA,31,289,185,2
0.333333333,0.411764706,25,11/20/2011,,,13,16,home,-17,SEA,143,163,50,62,7,24,Loss,42,126,5,4,2,LAR,31,185,289,3
0.571428571,0.333333333,23.01666667,11/20/2011,,,17,25,away,-6,ATL,257,316,86,59,17,23,Loss,41,116,1,0,1,TEN,40,298,432,1
0.333333333,0.571428571,36.98333333,11/20/2011,,,25,17,home,6,TEN,316,257,55,68,23,17,Win,116,41,0,1,1,ATL,40,432,298,1
0.454545455,0.571428571,26.83333333,11/20/2011,,,15,23,away,-11,CHI,280,286,20,48,20,31,Loss,52,92,0,0,1,LAC,51,332,378,3
0.571428571,0.454545455,33.16666667,11/20/2011,,,23,15,home,11,LAC,286,280,61,64,31,20,Win,92,52,0,0,3,CHI,51,378,332,1
0.529411765,0.357142857,36.3,11/20/2011,,,17,12,away,7,NYG,255,249,30,70,17,10,Win,136,29,1,3,2,PHI,27,391,278,3
0.357142857,0.529411765,23.7,11/20/2011,,,12,17,home,-7,PHI,249,255,39,55,10,17,Loss,29,136,3,1,3,NYG,27,278,391,2
0.428571429,0.307692308,31.5,11/21/2011,,,16,20,away,-31,NEP,209,223,34,67,3,34,Loss,125,157,3,3,1,KCC,37,334,380,3
0.307692308,0.428571429,28.5,11/21/2011,,,20,16,home,31,KCC,223,209,20,65,34,3,Win,157,125,3,3,3,NEP,37,380,334,1
0.2,0.5,29.2,11/24/2011,,,18,23,away,12,DET,296,273,54,53,27,15,Win,53,136,2,1,3,GBP,42,349,409,0
0.5,0.2,30.8,11/24/2011,,,23,18,home,-12,GBP,273,296,82,67,15,27,Loss,136,53,1,2,0,DET,42,409,349,3
0.25,0.222222222,31.46666667,11/24/2011,,,18,19,away,-1,DAL,263,218,55,61,19,20,Loss,89,85,4,1,2,MIA,39,352,303,1
0.222222222,0.25,28.53333333,11/24/2011,,,19,18,home,1,MIA,218,263,69,58,20,19,Win,85,89,1,4,1,DAL,39,303,352,2
0.166666667,0.466666667,28.86666667,11/24/2011,,,12,16,away,-10,BAL,96,161,97,54,6,16,Loss,74,92,9,0,0,SFO,22,170,253,1
0.466666667,0.166666667,31.13333333,11/24/2011,,,16,12,home,10,SFO,161,96,20,58,16,6,Win,92,74,0,9,1,BAL,22,253,170,0
0.5,0.111111111,36.28333333,11/27/2011,,,22,17,away,8,IND,176,218,92,65,27,19,Win,201,105,3,2,2,CAR,46,377,323,1
0.111111111,0.5,23.71666667,11/27/2011,,,17,22,home,-8,CAR,218,176,15,54,19,27,Loss,105,201,2,3,1,IND,46,323,377,2
0.2,0.411764706,26.61666667,11/27/2011,,,15,18,away,-6,TEN,186,150,30,60,17,23,Loss,122,202,2,2,4,TBB,40,308,352,5
0.411764706,0.2,33.38333333,11/27/2011,,,18,15,home,6,TBB,150,186,50,71,23,17,Win,202,122,2,2,5,TEN,40,352,308,4
0.133333333,0.263157895,28.35,11/27/2011,,,9,14,away,7,JAX,127,150,80,59,20,13,Win,88,105,0,7,1,HOU,33,215,255,1
0.263157895,0.133333333,31.65,11/27/2011,,,14,9,home,-7,HOU,150,127,30,71,13,20,Loss,105,88,7,0,1,JAX,33,255,215,1
0.333333333,0.230769231,33.98333333,11/27/2011,,,16,12,away,3,LAR,106,186,30,64,23,20,Win,268,86,3,2,2,ARI,43,374,272,3
0.230769231,0.333333333,26.01666667,11/27/2011,,,12,16,home,-3,ARI,186,106,49,56,20,23,Loss,86,268,2,3,3,LAR,43,272,374,2
0.4,0.454545455,36.18333333,11/27/2011,,,21,20,away,-4,NYJ,250,180,85,70,24,28,Loss,86,138,3,0,2,BUF,52,336,318,0
0.454545455,0.4,23.81666667,11/27/2011,,,20,21,home,4,BUF,180,250,40,58,28,24,Win,138,86,0,3,0,NYJ,52,318,336,2
0.4,0.428571429,28.43333333,11/27/2011,,,17,18,away,-3,CIN,140,257,15,66,20,23,Loss,134,132,2,2,1,CLE,43,274,389,1
0.428571429,0.4,31.56666667,11/27/2011,,,18,17,home,3,CLE,257,140,35,65,23,20,Win,132,134,2,2,1,CIN,43,389,274,1
0.307692308,0.5,25.35,11/27/2011,,,12,22,away,-10,ATL,162,246,49,53,14,24,Loss,64,89,4,2,1,MIN,38,226,335,0
0.5,0.307692308,34.65,11/27/2011,,,22,12,home,10,MIN,246,162,30,65,24,14,Win,89,64,2,4,0,ATL,38,335,226,1
0.3,0.375,33.33333333,11/27/2011,,,22,15,away,6,SEA,306,126,115,65,23,17,Win,110,124,1,2,1,WAS,40,416,250,2
0.375,0.3,26.66666667,11/27/2011,,,15,22,home,-6,WAS,126,306,91,62,17,23,Loss,124,110,2,1,2,SEA,40,250,416,1
0.428571429,0.2,29.96666667,11/27/2011,,,18,17,away,-5,OAK,229,268,61,67,20,25,Loss,172,73,4,4,1,CHI,45,401,341,3
0.2,0.428571429,30.03333333,11/27/2011,,,17,18,home,5,CHI,268,229,44,68,25,20,Win,73,172,4,4,3,OAK,45,341,401,1
0.545454545,0.307692308,32.71666667,11/27/2011,,,29,23,away,18,PHI,353,393,20,71,38,20,Win,104,73,1,2,1,NEP,58,457,466,0
0.307692308,0.545454545,27.28333333,11/27/2011,,,23,29,home,-18,NEP,393,353,60,67,20,38,Loss,73,104,2,1,0,PHI,58,466,457,1
0.3125,0.352941176,37.13333333,11/27/2011,,,18,20,away,3,LAC,141,159,63,70,3,0,Win,208,185,1,3,0,DEN,3,349,344,0
0.352941176,0.3125,37.38333333,11/27/2011,,,20,18,home,-3,DEN,159,141,30,75,0,3,Loss,185,208,3,1,0,LAC,3,344,349,0
0.272727273,0.4,33.5,11/27/2011,,,18,15,away,4,KCC,182,162,50,60,13,9,Win,108,90,1,1,4,PIT,22,290,252,2
0.4,0.272727273,26.5,11/27/2011,,,15,18,home,-4,PIT,162,182,20,63,9,13,Loss,90,108,1,1,2,KCC,22,252,290,4
0.454545455,0.555555556,31.46666667,11/28/2011,,,29,31,away,-25,NOS,392,372,32,70,24,49,Loss,73,205,1,0,0,NYG,73,465,577,2
0.555555556,0.454545455,28.53333333,11/28/2011,,,31,29,home,25,NYG,372,392,104,69,49,24,Win,205,73,0,1,2,NOS,73,577,465,0
0.25,0.416666667,29.66666667,12/1/2011,,,20,15,away,-17,SEA,198,173,28,56,14,31,Loss,132,174,2,3,0,PHI,45,330,347,4
0.416666667,0.25,30.33333333,12/1/2011,,,15,20,home,17,PHI,173,198,30,52,31,14,Win,174,132,3,2,4,SEA,45,347,330,0
0.307692308,0.3125,32.2,12/4/2011,,,16,17,away,15,WAS,165,204,40,62,34,19,Win,101,100,0,2,3,NYJ,53,266,304,1
0.3125,0.307692308,27.8,12/4/2011,,,17,16,home,-15,NYJ,204,165,50,71,19,34,Loss,100,101,2,0,1,WAS,53,304,266,3
0.428571429,0.5,24.93333333,12/4/2011,,,18,20,away,-7,HOU,267,175,43,65,10,17,Loss,70,162,0,3,1,ATL,27,337,337,2
0.5,0.428571429,35.06666667,12/4/2011,,,20,18,home,7,ATL,175,267,35,72,17,10,Win,162,70,3,0,2,HOU,27,337,337,1
0.35,0,32.7,12/4/2011,,,13,11,away,7,CHI,139,88,60,70,10,3,Win,113,93,2,7,3,KCC,13,252,181,1
0,0.35,27.3,12/4/2011,,,11,13,home,-7,KCC,88,139,35,55,3,10,Loss,93,113,7,2,1,CHI,13,181,252,3
0.181818182,0.4375,28.23333333,12/4/2011,,,18,18,away,6,BUF,130,282,20,57,23,17,Win,187,104,1,1,2,TEN,40,317,386,0
0.4375,0.181818182,31.76666667,12/4/2011,,,18,18,home,-6,TEN,282,130,15,70,17,23,Loss,104,187,1,1,0,BUF,40,386,317,2
0.181818182,0.2,27.26666667,12/4/2011,,,13,22,away,-28,PIT,128,159,109,55,7,35,Loss,104,136,3,3,0,CIN,42,232,295,2
0.2,0.181818182,32.73333333,12/4/2011,,,22,13,home,28,CIN,159,128,29,59,35,7,Win,136,104,3,3,2,PIT,42,295,232,0
0.545454545,0.384615385,32.68333333,12/4/2011,,,26,15,away,19,TBB,222,207,20,63,38,19,Win,163,78,2,2,1,CAR,57,385,285,0
0.384615385,0.545454545,27.31666667,12/4/2011,,,15,26,home,-19,CAR,207,222,73,56,19,38,Loss,78,163,2,2,0,TBB,57,285,385,1
0.181818182,0.571428571,21.66666667,12/4/2011,,,18,23,away,-20,MIA,258,153,91,57,14,34,Loss,46,209,2,1,0,OAK,48,304,362,1
0.571428571,0.181818182,38.33333333,12/4/2011,,,23,18,home,20,OAK,153,258,79,70,34,14,Win,209,46,1,2,1,MIA,48,362,304,0
0.272727273,0.4,22.15,12/4/2011,,,13,27,away,3,MIN,186,360,73,49,35,32,Win,150,129,2,3,3,DEN,67,336,489,2
0.4,0.272727273,37.85,12/4/2011,,,27,13,home,-3,DEN,360,186,54,81,32,35,Loss,129,150,3,2,2,MIN,67,489,336,3
0.666666667,0.545454545,35.65,12/4/2011,,,26,24,away,-7,NEP,338,289,29,70,24,31,Loss,99,73,2,1,0,IND,55,437,362,2
0.545454545,0.666666667,24.35,12/4/2011,,,24,26,home,7,IND,289,338,20,63,31,24,Win,73,99,1,2,2,NEP,55,362,437,0
0.473684211,0.214285714,37.56666667,12/4/2011,,,24,13,away,14,CLE,158,174,18,79,24,10,Win,290,59,1,3,1,BAL,34,448,233,1
0.214285714,0.473684211,22.43333333,12/4/2011,,,13,24,home,-14,BAL,174,158,37,56,10,24,Loss,59,290,3,1,1,CLE,34,233,448,1
0.583333333,0.454545455,33.05,12/4/2011,,,29,24,away,3,NYG,360,347,30,77,38,35,Win,89,100,2,1,2,GBP,73,449,447,1
0.454545455,0.583333333,26.95,12/4/2011,,,24,29,home,-3,GBP,347,360,55,61,35,38,Loss,100,89,1,2,1,NYG,73,447,449,2
0.333333333,0.307692308,33.7,12/4/2011,,,20,16,away,-6,ARI,261,224,49,67,0,6,Loss,75,103,5,5,0,DAL,6,336,327,0
0.307692308,0.333333333,29.58333333,12/4/2011,,,16,20,home,6,DAL,224,261,41,55,6,0,Win,103,75,5,5,0,ARI,6,327,336,0
0.230769231,0.285714286,23.91666667,12/4/2011,,,10,18,away,-26,SFO,126,245,35,49,0,26,Loss,31,144,4,4,0,LAR,26,157,389,2
0.285714286,0.230769231,36.08333333,12/4/2011,,,18,10,home,26,LAR,245,126,72,63,26,0,Win,144,31,4,4,2,SFO,26,389,157,0
0.181818182,0.5,35.1,12/4/2011,,,25,21,away,-14,NOS,379,338,107,69,17,31,Loss,87,100,3,2,0,DET,48,466,438,1
0.5,0.181818182,24.9,12/4/2011,,,21,25,home,14,DET,338,379,30,61,31,17,Win,100,87,2,3,1,NOS,48,438,466,0
0.4,0.5625,28.28333333,12/5/2011,,,19,17,away,24,JAX,294,177,55,54,38,14,Win,139,129,0,2,1,LAC,52,433,306,0
0.5625,0.4,31.71666667,12/5/2011,,,17,19,home,-24,LAC,177,294,26,66,14,38,Loss,129,139,2,0,0,JAX,52,306,433,1
0.4375,0.25,32.3,12/8/2011,,,19,20,away,-11,PIT,206,269,54,69,3,14,Loss,98,147,3,2,3,CLE,17,304,416,2
0.25,0.4375,27.7,12/8/2011,,,20,19,home,11,CLE,269,206,97,53,14,3,Win,147,98,2,3,2,PIT,17,416,304,3
0.470588235,0.384615385,30.71666667,12/11/2011,,,18,19,away,8,CAR,308,259,50,69,31,23,Win,86,157,3,2,2,ATL,54,394,416,0
0.384615385,0.470588235,29.28333333,12/11/2011,,,19,18,home,-8,ATL,259,308,50,64,23,31,Loss,157,86,2,3,0,CAR,54,416,394,2
0.272727273,0.333333333,27.18333333,12/11/2011,,,15,21,away,-27,JAX,170,209,97,59,14,41,Loss,110,116,3,1,2,TBB,55,280,325,7
0.333333333,0.272727273,32.81666667,12/11/2011,,,21,15,home,27,TBB,209,170,80,67,41,14,Win,116,110,1,3,7,JAX,55,325,280,2
0.5625,0.384615385,31.73333333,12/11/2011,,,25,16,away,1,CIN,268,184,50,77,20,19,Win,144,101,5,1,2,HOU,39,412,285,4
0.384615385,0.5625,28.26666667,12/11/2011,,,16,25,home,-1,HOU,184,268,27,58,19,20,Loss,101,144,1,5,4,CIN,39,285,412,2
0.571428571,0.5,28.76666667,12/11/2011,,,29,13,away,-6,DET,156,208,37,83,28,34,Loss,269,72,4,5,0,MIN,62,425,280,6
0.5,0.571428571,31.23333333,12/11/2011,,,13,29,home,6,MIN,208,156,76,55,34,28,Win,72,269,5,4,6,DET,62,280,425,0
0.454545455,0.5,23.85,12/11/2011,,,22,25,away,7,WAS,352,293,47,58,34,27,Win,79,170,1,2,2,NEP,61,431,463,1
0.5,0.454545455,36.15,12/11/2011,,,25,22,home,-7,NEP,293,352,73,69,27,34,Loss,170,79,2,1,1,WAS,61,463,431,2
0.166666667,0.333333333,22.3,12/11/2011,,,13,24,away,-27,NYJ,156,155,128,58,10,37,Loss,65,159,5,3,1,KCC,47,221,314,1
0.333333333,0.166666667,37.7,12/11/2011,,,24,13,home,27,KCC,155,156,22,66,37,10,Win,159,65,3,5,1,NYJ,47,314,221,1
0.578947368,0.1,37.55,12/11/2011,,,24,17,away,5,TEN,323,314,95,75,22,17,Win,114,59,2,2,0,NOS,39,437,373,0
0.1,0.578947368,22.45,12/11/2011,,,17,24,home,-5,NOS,314,323,54,55,17,22,Loss,59,114,2,2,0,TEN,39,373,437,0
0.142857143,0.538461538,23.86666667,12/11/2011,,,12,24,away,-14,BAL,117,212,15,57,10,24,Loss,50,146,4,2,2,IND,34,167,358,1
0.538461538,0.142857143,36.13333333,12/11/2011,,,24,12,home,14,IND,212,117,40,70,24,10,Win,146,50,2,4,1,BAL,34,358,167,2
0.266666667,0.2,31.35,12/11/2011,,,18,11,away,16,MIA,188,95,69,66,26,10,Win,51,109,4,9,3,PHI,36,239,204,2
0.2,0.266666667,28.65,12/11/2011,,,11,18,home,-16,PHI,95,188,81,64,10,26,Loss,109,51,9,4,2,MIA,36,204,239,3
0.133333333,0.294117647,31.78333333,12/11/2011,,,12,20,away,-3,DEN,86,221,69,61,0,3,Loss,159,124,4,5,2,CHI,3,245,345,1
0.294117647,0.133333333,34.65,12/11/2011,,,20,12,home,3,CHI,221,86,28,79,3,0,Win,124,159,5,4,1,DEN,3,345,245,2
0.176470588,0.214285714,30.93333333,12/11/2011,,,12,12,away,-2,ARI,143,270,35,63,19,21,Loss,90,55,5,2,3,SFO,40,233,325,0
0.214285714,0.176470588,29.06666667,12/11/2011,,,12,12,home,2,SFO,270,143,45,54,21,19,Win,55,90,2,5,0,ARI,40,325,233,3
0.384615385,0.272727273,31.33333333,12/11/2011,,,23,22,away,-30,GBP,240,255,89,73,16,46,Loss,117,136,1,4,1,OAK,62,357,391,5
0.272727273,0.384615385,28.66666667,12/11/2011,,,22,23,home,30,OAK,255,240,35,60,46,16,Win,136,117,4,1,5,GBP,62,391,357,1
0.363636364,0.571428571,24.45,12/11/2011,,,17,23,away,-27,LAC,185,216,5,58,10,37,Loss,96,150,1,2,1,BUF,47,281,366,3
0.571428571,0.363636364,35.55,12/11/2011,,,23,17,home,27,BUF,216,185,50,67,37,10,Win,150,96,2,1,3,LAC,47,366,281,1
0.428571429,0.5,34.31666667,12/11/2011,,,28,23,away,3,DAL,400,305,55,78,37,34,Win,110,139,0,3,1,NYG,71,510,444,1
0.5,0.428571429,25.68333333,12/11/2011,,,23,28,home,-3,NYG,305,400,51,58,34,37,Loss,139,110,3,0,1,DAL,71,444,510,1
0.214285714,0.5,28.51666667,12/12/2011,,,19,21,away,-17,SEA,167,214,30,63,13,30,Loss,114,145,3,2,1,LAR,43,281,359,1
0.5,0.214285714,31.48333333,12/12/2011,,,21,19,home,17,LAR,214,167,61,68,30,13,Win,145,114,2,3,1,SEA,43,359,281,1
0.3,0.4,21.48333333,12/15/2011,,,12,20,away,-27,ATL,91,276,40,46,14,41,Loss,116,97,5,1,0,JAX,55,207,373,4
0.4,0.3,38.51666667,12/15/2011,,,20,12,home,27,JAX,276,91,31,68,41,14,Win,97,116,1,5,4,ATL,55,373,207,0
0.538461538,0.416666667,37.98333333,12/17/2011,,,28,7,away,16,TBB,239,132,15,69,31,15,Win,160,58,2,3,1,DAL,46,399,190,1
0.416666667,0.538461538,22.01666667,12/17/2011,,,7,28,home,-16,DAL,132,239,46,43,15,31,Loss,58,160,3,2,1,TBB,46,190,399,1
0.375,0.3,31.61666667,12/18/2011,,,18,13,away,24,CHI,226,89,36,65,38,14,Win,60,132,1,4,5,SEA,52,286,221,1
0.3,0.375,28.38333333,12/18/2011,,,13,18,home,-24,SEA,89,226,45,60,14,38,Loss,132,60,4,1,1,CHI,52,221,286,5
0.727272727,0.285714286,38.81666667,12/18/2011,,,36,12,away,22,MIN,412,102,65,79,42,20,Win,161,105,0,4,1,NOS,62,573,207,2
0.285714286,0.727272727,21.18333333,12/18/2011,,,12,36,home,-22,NOS,102,412,84,54,20,42,Loss,105,161,4,0,2,MIN,62,207,573,1
0.533333333,0.333333333,35,12/18/2011,,,19,22,away,13,NYG,177,233,48,65,23,10,Win,123,91,1,3,3,WAS,33,300,324,2
0.333333333,0.533333333,25,12/18/2011,,,22,19,home,-13,WAS,233,177,75,61,10,23,Loss,91,123,3,1,2,NYG,33,324,300,3
0.230769231,0,28.81666667,12/18/2011,,,17,21,away,7,BUF,194,291,62,60,30,23,Win,254,113,2,3,3,MIA,53,448,404,3
0,0.230769231,31.18333333,12/18/2011,,,21,17,home,-7,MIA,291,194,92,69,23,30,Loss,113,254,3,2,3,BUF,53,404,448,3
0.428571429,0.333333333,23.81666667,12/18/2011,,,16,23,away,-5,KCC,213,299,37,57,14,19,Loss,102,139,4,0,0,GBP,33,315,438,0
0.333333333,0.428571429,36.18333333,12/18/2011,,,23,16,home,5,GBP,299,213,55,70,19,14,Win,139,102,0,4,0,KCC,33,438,315,0
0.375,0.25,31.95,12/18/2011,,,21,10,away,-14,IND,322,82,70,76,13,27,Loss,66,205,1,0,1,TEN,40,388,287,3
0.25,0.375,28.05,12/18/2011,,,10,21,home,14,TEN,82,322,25,51,27,13,Win,205,66,0,1,3,IND,40,287,388,1
0.642857143,0.222222222,32.56666667,12/18/2011,,,20,18,away,15,HOU,150,208,40,60,28,13,Win,166,150,2,2,3,CAR,41,316,358,0
0.222222222,0.642857143,27.43333333,12/18/2011,,,18,20,home,-15,CAR,208,150,60,57,13,28,Loss,150,166,2,2,0,HOU,41,358,316,3
0.272727273,0.153846154,30.05,12/18/2011,,,19,18,away,7,LAR,173,210,101,61,20,13,Win,110,95,1,3,0,CIN,33,283,305,1
0.153846154,0.272727273,29.95,12/18/2011,,,18,19,home,-7,CIN,210,173,109,63,13,20,Loss,95,110,3,1,1,LAR,33,305,283,0
0.470588235,0.111111111,28.45,12/18/2011,,,25,26,away,1,OAK,375,345,72,73,28,27,Win,57,132,2,3,1,DET,55,432,477,1
0.111111111,0.470588235,31.55,12/18/2011,,,26,25,home,-1,DET,345,375,86,65,27,28,Loss,132,57,3,2,1,OAK,55,477,432,1
0.357142857,0.5,31.36666667,12/18/2011,,,16,24,away,-3,ARI,213,289,74,62,0,3,Loss,120,74,2,4,1,CLE,3,333,363,1
0.5,0.357142857,32.7,12/18/2011,,,24,16,home,3,CLE,289,213,13,74,3,0,Win,74,120,4,2,1,ARI,3,363,333,1
0.230769231,0.5,29.95,12/18/2011,,,13,20,away,-26,PHI,147,260,93,60,19,45,Loss,94,160,4,3,4,NYJ,64,241,420,4
0.5,0.230769231,30.05,12/18/2011,,,20,13,home,26,NYJ,260,147,62,58,45,19,Win,160,94,3,4,4,PHI,64,420,241,4
0.416666667,0.4,33.68333333,12/18/2011,,,26,23,away,18,DEN,310,141,30,72,41,23,Win,141,252,2,4,3,NEP,64,451,393,0
0.4,0.416666667,26.31666667,12/18/2011,,,23,26,home,-18,NEP,141,310,39,58,23,41,Loss,252,141,4,2,0,DEN,64,393,451,3
0.583333333,0.6,25.8,12/18/2011,,,19,23,away,-20,LAC,201,270,25,56,14,34,Loss,89,145,7,0,0,BAL,48,290,415,2
0.6,0.583333333,34.2,12/18/2011,,,23,19,home,20,BAL,270,201,35,60,34,14,Win,145,89,0,7,2,LAC,48,415,290,0
0.571428571,0.307692308,31.43333333,12/19/2011,,,20,17,away,-17,SFO,305,187,72,66,3,20,Loss,84,100,3,0,0,PIT,23,389,287,4
0.307692308,0.571428571,28.56666667,12/19/2011,,,17,20,home,17,PIT,187,305,49,61,20,3,Win,100,84,0,3,4,SFO,23,287,389,0
0.1,0.411764706,27.08333333,12/22/2011,,,14,24,away,-3,IND,112,225,84,51,16,19,Loss,171,95,4,3,1,HOU,35,283,320,1
0.411764706,0.1,32.91666667,12/22/2011,,,24,14,home,3,HOU,225,112,35,76,19,16,Win,95,171,3,4,1,IND,35,320,283,1
0.363636364,0.3,29.56666667,12/24/2011,,,20,23,away,7,WAS,148,256,40,58,33,26,Win,241,141,2,3,2,MIN,59,389,397,0
0.3,0.363636364,30.43333333,12/24/2011,,,23,20,home,-7,MIN,256,148,64,68,26,33,Loss,141,241,3,2,0,WAS,59,397,389,2
0.285714286,0.357142857,28.35,12/24/2011,,,17,21,away,-7,CIN,257,136,87,67,16,23,Loss,59,165,5,2,2,ARI,39,316,301,3
0.357142857,0.285714286,31.65,12/24/2011,,,21,17,home,7,ARI,136,257,47,67,23,16,Win,165,59,2,5,3,CIN,39,301,316,2
0.454545455,0,32.95,12/24/2011,,,23,20,away,-32,CAR,258,163,64,60,16,48,Loss,59,270,3,1,0,TBB,64,317,433,4
0,0.454545455,27.05,12/24/2011,,,20,23,home,32,TBB,163,258,77,49,48,16,Win,270,59,1,3,4,CAR,64,433,317,0
0.266666667,0.19047619,23.9,12/24/2011,,,11,22,away,15,NYJ,217,226,45,55,29,14,Win,115,105,2,5,3,NYG,43,332,331,1
0.19047619,0.266666667,36.1,12/24/2011,,,22,11,home,-15,NYG,226,217,95,89,14,29,Loss,105,115,5,2,1,NYJ,43,331,332,3
0.153846154,0.166666667,30.51666667,12/24/2011,,,18,14,away,-26,BUF,152,191,58,68,14,40,Loss,133,160,4,1,0,DEN,54,285,351,4
0.166666667,0.153846154,29.48333333,12/24/2011,,,14,18,home,26,DEN,191,152,69,56,40,14,Win,160,133,1,4,4,BUF,54,351,285,0
0.277777778,0.25,29.01666667,12/24/2011,,,18,20,away,-6,TEN,187,342,28,71,17,23,Loss,113,65,1,1,3,JAX,40,300,407,1
0.25,0.277777778,30.98333333,12/24/2011,,,20,18,home,6,JAX,342,187,0,66,23,17,Win,65,113,1,1,1,TEN,40,407,300,3
0.375,0.142857143,30.75,12/24/2011,,,15,17,away,-27,PIT,68,208,21,63,0,27,Loss,164,169,3,0,1,LAR,27,232,377,0
0.142857143,0.375,29.25,12/24/2011,,,17,15,home,27,LAR,208,68,50,50,27,0,Win,169,164,0,3,0,PIT,27,377,232,1
0.384615385,0.470588235,29.06666667,12/24/2011,,,20,26,away,-3,NEP,253,281,39,65,24,27,Loss,121,119,5,4,0,MIA,51,374,400,2
0.470588235,0.384615385,30.93333333,12/24/2011,,,26,20,home,3,MIA,281,253,50,81,27,24,Win,119,121,4,5,2,NEP,51,400,374,0
0.384615385,0.411764706,27.7,12/24/2011,,,18,15,away,-6,BAL,139,122,95,60,14,20,Loss,117,162,2,1,1,CLE,34,256,284,1
0.411764706,0.384615385,32.3,12/24/2011,,,15,18,home,6,CLE,122,139,51,62,20,14,Win,162,117,1,2,1,BAL,34,284,256,1
0.272727273,0.25,29.56666667,12/24/2011,,,13,26,away,3,KCC,237,300,92,51,3,0,Win,71,135,0,0,2,OAK,3,308,435,2
0.25,0.272727273,32.65,12/24/2011,,,26,13,home,-3,OAK,300,237,88,66,0,3,Loss,135,71,0,0,2,KCC,3,435,308,2
0.4,0.692307692,27.65,12/24/2011,,,20,24,away,-28,DET,299,353,10,70,10,38,Loss,68,87,0,3,0,LAC,48,367,440,2
0.692307692,0.4,32.35,12/24/2011,,,24,20,home,28,LAC,353,299,8,62,38,10,Win,87,68,3,0,2,DET,48,440,367,0
0.384615385,0.352941176,27.61666667,12/24/2011,,,20,16,away,13,DAL,281,157,47,60,20,7,Win,105,81,2,3,0,PHI,27,386,238,1
0.352941176,0.384615385,32.38333333,12/24/2011,,,16,20,home,-13,PHI,157,281,47,66,7,20,Loss,81,105,3,2,1,DAL,27,238,386,0
0.214285714,0.384615385,32.9,12/24/2011,,,21,14,away,2,SEA,171,141,77,68,19,17,Win,178,124,2,4,1,SFO,36,349,265,0
0.384615385,0.214285714,27.1,12/24/2011,,,14,21,home,-2,SFO,141,171,51,58,17,19,Loss,124,178,4,2,0,SEA,36,265,349,1
0.5,0.555555556,35.8,12/25/2011,,,24,19,away,-14,GBP,242,282,28,70,21,35,Loss,199,81,0,1,0,CHI,56,441,363,2
0.555555556,0.5,24.2,12/25/2011,,,19,24,home,14,CHI,282,242,0,51,35,21,Win,81,199,1,0,2,GBP,56,363,441,0
0.470588235,0.769230769,33.31666667,12/26/2011,,,23,26,away,-29,NOS,434,299,57,75,16,45,Loss,35,164,0,1,2,ATL,61,469,463,1
0.769230769,0.470588235,26.68333333,12/26/2011,,,26,23,home,29,ATL,299,434,46,63,45,16,Win,164,35,1,0,1,NOS,61,463,469,2
0.363636364,0.533333333,28.88333333,1/1/2012,,,20,14,away,-2,MIA,245,128,40,62,17,19,Loss,129,82,2,1,2,NYJ,36,374,210,3
0.533333333,0.363636364,31.11666667,1/1/2012,,,14,20,home,2,NYJ,128,245,35,59,19,17,Win,82,129,1,2,3,MIA,36,210,374,2
0.363636364,0.5,28.33333333,1/1/2012,,,32,27,away,-4,GBP,502,469,101,76,41,45,Loss,73,81,2,3,2,DET,86,575,550,4
0.5,0.363636364,31.66666667,1/1/2012,,,27,32,home,4,DET,469,502,78,71,45,41,Win,81,73,3,2,4,GBP,86,550,575,2
0,0.666666667,25.43333333,1/1/2012,,,21,33,away,-28,NOS,137,409,5,51,17,45,Loss,164,208,2,0,1,CAR,62,301,617,2
0.666666667,0,34.56666667,1/1/2012,,,33,21,home,28,CAR,409,137,60,73,45,17,Win,208,164,0,2,2,NOS,62,617,301,1
0.428571429,0.357142857,25.36666667,1/1/2012,,,17,22,away,1,HOU,275,235,47,60,23,22,Win,86,152,3,3,1,TEN,45,361,387,1
0.357142857,0.428571429,34.63333333,1/1/2012,,,22,17,home,-1,TEN,235,275,55,65,22,23,Loss,152,86,3,3,1,HOU,45,387,361,1
0.384615385,0.2,28.76666667,1/1/2012,,,10,16,away,4,MIN,117,222,20,57,17,13,Win,92,79,7,2,3,CHI,30,209,301,3
0.2,0.384615385,31.23333333,1/1/2012,,,16,10,home,-4,CHI,222,117,38,71,13,17,Loss,79,92,2,7,3,MIN,30,301,209,3
0.375,0.454545455,30.68333333,1/1/2012,,,21,24,away,-24,PHI,247,315,71,71,10,34,Loss,130,75,1,2,2,WAS,44,377,390,1
0.454545455,0.375,29.31666667,1/1/2012,,,24,21,home,24,WAS,315,247,75,60,34,10,Win,75,130,2,1,1,PHI,44,390,377,2
0.375,0.333333333,35.13333333,1/1/2012,,,21,18,away,7,LAR,205,200,80,71,34,27,Win,116,111,3,3,2,SFO,61,321,311,0
0.333333333,0.375,24.86666667,1/1/2012,,,18,21,home,-7,SFO,200,205,50,62,27,34,Loss,111,116,3,3,0,LAR,61,311,321,2
0.142857143,0.5,30.36666667,1/1/2012,,,26,28,away,-28,NEP,296,342,45,68,21,49,Loss,106,138,2,4,1,BUF,70,402,480,4
0.5,0.142857143,29.63333333,1/1/2012,,,28,26,home,28,BUF,342,296,77,69,49,21,Win,138,106,4,2,4,NEP,70,480,402,1
0.428571429,0.384615385,29.2,1/1/2012,,,19,15,away,-6,JAX,242,71,40,65,13,19,Loss,56,190,3,3,1,IND,32,298,261,3
0.384615385,0.428571429,30.8,1/1/2012,,,15,19,home,6,IND,71,242,10,57,19,13,Win,190,56,3,3,3,JAX,32,261,298,1
0.5,0.545454545,29.86666667,1/1/2012,,,18,22,away,-21,ATL,259,177,20,61,24,45,Loss,35,251,2,0,2,TBB,69,294,428,4
0.545454545,0.5,30.13333333,1/1/2012,,,22,18,home,21,TBB,177,259,20,59,45,24,Win,251,35,0,2,4,ATL,69,428,294,2
0.384615385,0.470588235,29.43333333,1/1/2012,,,15,19,away,8,CIN,126,231,59,52,24,16,Win,221,105,1,1,1,BAL,40,347,336,0
0.470588235,0.384615385,30.56666667,1/1/2012,,,19,15,home,-8,BAL,231,126,35,69,16,24,Loss,105,221,1,1,0,CIN,40,336,347,1
0.5,0.285714286,39.18333333,1/1/2012,,,22,14,away,4,CLE,199,168,37,78,13,9,Win,161,72,2,2,1,PIT,22,360,240,2
0.285714286,0.5,20.81666667,1/1/2012,,,14,22,home,-4,PIT,168,199,40,58,9,13,Loss,72,161,2,2,2,CLE,22,240,360,1
0.333333333,0.277777778,27.03333333,1/1/2012,,,14,16,away,4,DEN,175,50,36,60,7,3,Win,106,216,1,2,2,KCC,10,281,266,1
0.277777778,0.333333333,32.96666667,1/1/2012,,,16,14,home,-4,KCC,50,175,49,71,3,7,Loss,216,106,2,1,1,DEN,10,266,281,2
0.1875,0.411764706,33.7,1/1/2012,,,19,20,away,-3,ARI,191,257,55,73,0,3,Loss,178,131,4,2,2,SEA,3,369,388,1
0.411764706,0.1875,35.31666667,1/1/2012,,,20,19,home,3,SEA,257,191,76,73,3,0,Win,131,178,2,4,1,ARI,3,388,369,2
0.7,0.615384615,30.45,1/1/2012,,,25,28,away,12,OAK,310,417,68,57,38,26,Win,153,103,0,0,1,LAC,64,463,520,1
0.615384615,0.7,29.55,1/1/2012,,,28,25,home,-12,LAC,417,310,64,67,26,38,Loss,103,153,0,0,1,OAK,64,520,463,1
0.333333333,0.466666667,25.45,1/1/2012,,,19,20,away,-17,NYG,251,331,43,59,14,31,Loss,49,106,6,2,0,DAL,45,300,437,2
0.466666667,0.333333333,34.55,1/1/2012,,,20,19,home,17,DAL,331,251,28,66,31,14,Win,106,49,2,6,2,NYG,45,437,300,0
0.461538462,0.5,30.28333333,1/7/2012,,,21,19,away,-21,HOU,224,152,25,65,10,31,Loss,76,188,4,2,0,CIN,41,300,340,3
0.5,0.461538462,29.71666667,1/7/2012,,,19,21,home,21,CIN,152,224,87,57,31,10,Win,188,76,2,4,3,HOU,41,340,300,0
0.7,0.636363636,22.4,1/7/2012,,,22,34,away,-17,NOS,380,459,64,53,28,45,Loss,32,167,0,2,2,DET,73,412,626,2
0.636363636,0.7,37.6,1/7/2012,,,34,22,home,17,DET,459,380,18,81,45,28,Win,167,32,2,0,2,NOS,73,626,412,2
0.285714286,0.533333333,25.43333333,1/8/2012,,,14,19,away,-22,NYG,183,270,15,64,2,24,Loss,64,172,2,1,0,ATL,26,247,442,0
0.533333333,0.285714286,34.56666667,1/8/2012,,,19,14,home,22,ATL,270,183,73,64,24,2,Win,172,64,1,2,0,NYG,26,442,247,0
0.4375,0.3,31.1,1/8/2012,,,21,18,away,-6,DEN,244,316,61,68,0,6,Loss,156,131,5,0,1,PIT,6,400,447,1
0.3,0.4375,29.08333333,1/8/2012,,,18,21,home,6,PIT,316,244,30,55,6,0,Win,131,156,0,5,1,DEN,6,447,400,1
0.357142857,0.266666667,31.33333333,1/14/2012,,,26,17,away,-4,SFO,435,264,0,80,32,36,Loss,37,143,3,4,1,NOS,68,472,407,5
0.266666667,0.357142857,28.66666667,1/14/2012,,,17,26,home,4,NOS,264,435,33,68,36,32,Win,143,37,4,3,5,SFO,68,407,472,1
0.388888889,0.5,33.38333333,1/14/2012,,,15,31,away,-35,NEP,108,363,55,71,10,45,Loss,144,146,5,0,2,DEN,55,252,509,1
0.5,0.388888889,26.61666667,1/14/2012,,,31,15,home,35,DEN,363,108,20,64,45,10,Win,146,144,0,5,1,NEP,55,509,252,2
0.333333333,0.25,28.66666667,1/15/2012,,,16,11,away,-7,BAL,184,140,20,63,13,20,Loss,131,87,0,5,0,HOU,33,315,227,4
0.25,0.333333333,31.33333333,1/15/2012,,,11,16,home,7,HOU,140,184,0,63,20,13,Win,87,131,5,0,4,BAL,33,227,315,0
0.5,0.5,29.58333333,1/15/2012,,,19,25,away,17,GBP,325,241,30,61,37,20,Win,95,147,1,4,4,NYG,57,420,388,1
0.5,0.5,30.41666667,1/15/2012,,,25,19,home,-17,NYG,241,325,20,73,20,37,Loss,147,95,4,1,1,GBP,57,388,420,4
0.529411765,0.454545455,33.55,1/22/2012,,,19,25,away,-3,NEP,282,234,33,70,20,23,Loss,116,96,3,1,3,BAL,43,398,330,1
0.454545455,0.529411765,26.45,1/22/2012,,,25,19,home,3,BAL,234,282,5,68,23,20,Win,96,116,1,3,1,NEP,43,330,398,3
0.333333333,0.076923077,39.6,1/22/2012,,,20,15,away,3,SFO,267,178,60,90,3,0,Win,85,150,6,3,2,NYG,3,352,328,0
0.076923077,0.333333333,28.3,1/22/2012,,,15,20,home,-3,NYG,178,267,50,57,0,3,Loss,150,85,3,6,0,SFO,3,328,352,2
0.454545455,0.5,37.08333333,2/5/2012,,,26,21,away,4,NEP,282,266,24,71,21,17,Win,114,83,3,2,1,NYG,38,396,349,0
0.5,0.454545455,22.91666667,2/5/2012,,,21,26,home,-4,NYG,266,282,28,62,17,21,Loss,83,114,2,3,0,NEP,38,349,396,1
0.4,0.333333333,34.11666667,9/5/2012,,,18,15,away,7,NYG,290,187,86,57,24,17,Win,143,82,2,3,1,DAL,41,433,269,1
0.333333333,0.4,25.88333333,9/5/2012,,,15,18,home,-7,DAL,187,290,33,54,17,24,Loss,82,143,3,2,1,NYG,41,269,433,1
0.266666667,0.181818182,39.16666667,9/9/2012,,,22,24,away,8,NOS,306,326,127,71,40,32,Win,153,32,2,2,3,WAS,72,459,358,0
0.181818182,0.266666667,20.83333333,9/9/2012,,,24,22,home,-8,WAS,326,306,107,64,32,40,Loss,32,153,2,2,0,NOS,72,358,459,3
0.333333333,0.444444444,30.1,9/9/2012,,,14,28,away,-4,DET,173,346,65,55,23,27,Loss,77,83,4,1,3,LAR,50,250,429,0
0.444444444,0.333333333,29.9,9/9/2012,,,28,14,home,4,LAR,346,173,27,67,27,23,Win,83,77,1,4,0,DET,50,429,250,3
0.5,0.357142857,31.01666667,9/9/2012,,,25,16,away,21,TEN,228,264,20,67,34,13,Win,162,20,1,2,2,NEP,47,390,284,0
0.357142857,0.5,28.98333333,9/9/2012,,,16,25,home,-21,NEP,264,228,30,61,13,34,Loss,20,162,2,1,0,TEN,47,284,390,2
0.2,0.411764706,25.26666667,9/9/2012,,,15,19,away,-20,HOU,199,254,78,58,10,30,Loss,76,83,2,2,0,MIA,40,275,337,4
0.411764706,0.2,34.73333333,9/9/2012,,,19,15,home,20,MIA,254,199,35,68,30,10,Win,83,76,2,2,4,HOU,40,337,275,0
0.666666667,0.714285714,28.7,9/9/2012,,,20,21,away,-20,NYJ,195,266,34,58,28,48,Loss,195,118,0,0,1,BUF,76,390,384,4
0.714285714,0.666666667,31.3,9/9/2012,,,21,20,home,20,BUF,266,195,34,63,48,28,Win,118,195,0,0,4,NYJ,76,384,390,1
0.5,0.6875,28.08333333,9/9/2012,,,21,22,away,16,KCC,292,241,12,55,40,24,Win,84,152,1,3,3,ATL,64,376,393,0
0.6875,0.5,31.91666667,9/9/2012,,,22,21,home,-16,ATL,241,292,25,69,24,40,Loss,152,84,3,1,0,KCC,64,393,376,3
0.5,0.2,37.81666667,9/9/2012,,,22,20,away,-3,MIN,242,266,25,75,0,3,Loss,113,123,2,2,1,JAX,3,355,389,1
0.2,0.5,27.08333333,9/9/2012,,,20,22,home,3,JAX,266,242,47,58,3,0,Win,123,113,2,2,1,MIN,3,389,355,1
0.421052632,0.153846154,35.96666667,9/9/2012,,,25,12,away,1,CLE,306,111,110,88,17,16,Win,150,99,2,2,4,PHI,33,456,210,5
0.153846154,0.421052632,24.03333333,9/9/2012,,,12,25,home,-1,PHI,111,306,35,59,16,17,Loss,99,150,2,2,5,CLE,33,210,456,4
0.2,0.333333333,24.53333333,9/9/2012,,,22,26,away,-20,CHI,293,314,19,63,21,41,Loss,63,114,3,2,1,IND,62,356,428,5
0.333333333,0.2,35.46666667,9/9/2012,,,26,22,home,20,IND,314,293,48,70,41,21,Win,114,63,2,3,5,CHI,62,428,356,1
0.2,0.357142857,22.55,9/9/2012,,,16,18,away,-6,TBB,291,128,65,49,10,16,Loss,10,130,3,2,0,CAR,26,301,258,2
0.357142857,0.2,37.45,9/9/2012,,,18,16,home,6,CAR,128,291,35,62,16,10,Win,130,10,2,3,2,TBB,26,258,301,0
0.3125,0.3,33.56666667,9/9/2012,,,18,18,away,-4,ARI,139,210,90,70,16,20,Loss,115,43,3,1,2,SEA,36,254,253,2
0.3,0.3125,26.43333333,9/9/2012,,,18,18,home,4,SEA,210,139,102,57,20,16,Win,43,115,1,3,2,ARI,36,253,254,2
0.222222222,0.461538462,33,9/9/2012,,,22,21,away,8,GBP,191,279,66,62,30,22,Win,186,45,4,3,1,SFO,52,377,324,0
0.461538462,0.222222222,27,9/9/2012,,,21,22,home,-8,SFO,279,191,77,61,22,30,Loss,45,186,3,4,0,GBP,52,324,377,1
0.578947368,0.555555556,35.08333333,9/9/2012,,,19,20,away,-12,DEN,209,240,52,71,19,31,Loss,75,94,5,2,1,PIT,50,284,334,1
0.555555556,0.578947368,24.91666667,9/9/2012,,,20,19,home,12,PIT,240,209,49,55,31,19,Win,94,75,2,5,1,DEN,50,334,284,1
0.266666667,0.333333333,32.43333333,9/10/2012,,,20,26,away,-31,BAL,193,308,41,69,13,44,Loss,129,122,4,3,0,CIN,57,322,430,2
0.333333333,0.266666667,27.56666667,9/10/2012,,,26,20,home,31,CIN,308,193,50,58,44,13,Win,122,129,3,4,2,BAL,57,430,322,0
0.384615385,0.333333333,30.56666667,9/10/2012,,,15,21,away,8,OAK,226,276,78,54,22,14,Win,32,45,1,3,1,LAC,36,258,321,0
0.333333333,0.384615385,29.43333333,9/10/2012,,,21,15,home,-8,LAC,276,226,35,69,14,22,Loss,45,32,3,1,0,OAK,36,321,258,1
0.333333333,0.285714286,27.81666667,9/13/2012,,,11,19,away,-13,GBP,74,215,65,57,10,23,Loss,94,106,7,5,2,CHI,33,168,321,4
0.285714286,0.333333333,32.18333333,9/13/2012,,,19,11,home,13,CHI,215,74,54,66,23,10,Win,106,94,5,7,4,GBP,33,321,168,2
0.466666667,0.333333333,27.11666667,9/16/2012,,,21,21,away,-7,CIN,309,295,103,62,27,34,Loss,130,80,2,6,1,CLE,61,439,375,1
0.333333333,0.466666667,32.88333333,9/16/2012,,,21,21,home,7,CLE,295,309,54,62,34,27,Win,80,130,6,2,1,CIN,61,375,439,1
0.357142857,0.416666667,30.65,9/16/2012,,,25,15,away,-18,BUF,272,178,33,71,17,35,Loss,150,201,5,0,0,KCC,52,422,379,3
0.416666667,0.357142857,29.35,9/16/2012,,,15,25,home,18,KCC,178,272,50,55,35,17,Win,201,150,0,5,3,BUF,52,379,422,0
0.285714286,0.466666667,25.65,9/16/2012,,,17,26,away,-1,PHI,214,357,45,65,23,24,Loss,111,129,2,2,4,BAL,47,325,486,2
0.466666667,0.285714286,34.35,9/16/2012,,,26,17,home,1,BAL,357,214,58,75,24,23,Win,129,111,2,2,2,PHI,47,486,325,4
0.466666667,0.4375,30.36666667,9/16/2012,,,19,17,away,-3,IND,232,194,105,65,20,23,Loss,95,84,4,2,0,MIN,43,327,278,1
0.4375,0.466666667,29.63333333,9/16/2012,,,17,19,home,3,MIN,194,232,51,63,23,20,Win,84,95,2,4,1,IND,43,278,327,0
0.285714286,0.333333333,28.31666667,9/16/2012,,,16,25,away,2,NEP,140,297,39,61,20,18,Win,102,90,2,4,1,ARI,38,242,387,2
0.333333333,0.285714286,31.68333333,9/16/2012,,,25,16,home,-2,ARI,297,140,60,78,18,20,Loss,90,102,4,2,2,NEP,38,387,242,1
0.538461538,0.5,30.4,9/16/2012,,,27,23,away,-8,CAR,323,244,23,77,27,35,Loss,163,219,1,1,1,NOS,62,486,463,2
0.5,0.538461538,29.6,9/16/2012,,,23,27,home,8,NOS,244,323,34,62,35,27,Win,219,163,1,1,2,CAR,62,463,486,1
0.470588235,0,43.28333333,9/16/2012,,,28,9,away,20,JAX,195,52,64,83,27,7,Win,216,65,0,3,1,HOU,34,411,117,0
0,0.470588235,16.71666667,9/16/2012,,,9,28,home,-20,HOU,52,195,71,38,7,27,Loss,65,216,3,0,0,JAX,34,117,411,1
0.2,0.384615385,26.51666667,9/16/2012,,,14,31,away,-7,NYG,228,510,33,52,34,41,Loss,79,94,2,0,3,TBB,75,307,604,2
0.384615385,0.2,33.48333333,9/16/2012,,,31,14,home,7,TBB,510,228,53,76,41,34,Win,94,79,0,2,2,NYG,75,604,307,3
0.083333333,0.529411765,25.31666667,9/16/2012,,,18,24,away,-22,MIA,373,189,42,62,13,35,Loss,23,263,0,1,0,OAK,48,396,452,1
0.529411765,0.083333333,34.68333333,9/16/2012,,,24,18,home,22,OAK,189,373,21,74,35,13,Win,263,23,1,0,1,MIA,48,452,396,0
0.307692308,0.583333333,28.6,9/16/2012,,,18,23,away,-3,LAR,197,301,96,59,28,31,Loss,176,151,1,2,3,WAS,59,373,452,1
0.583333333,0.307692308,31.4,9/16/2012,,,23,18,home,3,WAS,301,197,60,64,31,28,Win,151,176,2,1,1,LAR,59,452,373,3
0.538461538,0.357142857,25.35,9/16/2012,,,17,20,away,-20,SEA,247,133,47,57,7,27,Loss,49,182,1,2,0,DAL,34,296,315,2
0.357142857,0.538461538,34.65,9/16/2012,,,20,17,home,20,DAL,133,247,35,63,27,7,Win,182,49,2,1,2,SEA,34,315,296,0
0.111111111,0.588235294,16.35,9/16/2012,,,9,27,away,-28,LAC,174,268,59,40,10,38,Loss,38,148,0,4,1,TEN,48,212,416,1
0.588235294,0.111111111,43.65,9/16/2012,,,27,9,home,28,TEN,268,174,41,75,38,10,Win,148,38,4,0,1,LAC,48,416,212,1
0.333333333,0.533333333,23.4,9/16/2012,,,16,21,away,-17,PIT,129,265,63,51,10,27,Loss,90,66,2,3,0,NYJ,37,219,331,1
0.533333333,0.333333333,36.6,9/16/2012,,,21,16,home,17,NYJ,265,129,107,62,27,10,Win,66,90,3,2,1,PIT,37,331,219,0
0.4,0.363636364,30.43333333,9/16/2012,,,15,24,away,-8,SFO,214,201,67,60,19,27,Loss,82,148,2,3,1,DET,46,296,349,1
0.363636364,0.4,29.56666667,9/16/2012,,,24,15,home,8,DET,201,214,62,61,27,19,Win,148,82,3,2,1,SFO,46,349,296,1
0.333333333,0.384615385,27.33333333,9/17/2012,,,24,22,away,-6,ATL,218,208,96,67,21,27,Loss,118,67,3,1,0,DEN,48,336,275,4
0.384615385,0.333333333,32.66666667,9/17/2012,,,22,24,home,6,DEN,208,218,72,65,27,21,Win,67,118,1,3,4,ATL,48,275,336,0
0.5,0.444444444,36.16666667,9/20/2012,,,24,22,away,29,CAR,280,267,38,68,36,7,Win,125,60,2,2,5,NYG,43,405,327,0
0.444444444,0.5,23.83333333,9/20/2012,,,22,24,home,-29,NYG,267,280,22,55,7,36,Loss,60,125,2,2,0,CAR,43,327,405,5
0.388888889,0.384615385,42.53333333,9/23/2012,,,27,14,away,3,NOS,237,205,40,92,3,0,Win,273,83,3,4,1,KCC,3,510,288,3
0.384615385,0.388888889,26.01666667,9/23/2012,,,14,27,home,-3,KCC,205,237,45,59,0,3,Loss,83,273,4,3,3,NOS,3,288,510,1
0.333333333,0.25,27.5,9/23/2012,,,22,31,away,7,WAS,385,179,80,58,38,31,Win,93,202,2,5,1,CIN,69,478,381,2
0.25,0.333333333,32.5,9/23/2012,,,31,22,home,-7,CIN,179,385,60,74,31,38,Loss,202,93,5,2,2,WAS,69,381,478,1
0.25,0.416666667,40.6,9/23/2012,,,36,21,away,-3,TEN,442,378,91,92,0,3,Loss,141,59,1,0,2,DET,3,583,437,1
0.416666667,0.25,27.81666667,9/23/2012,,,21,36,home,3,DET,378,442,32,61,3,0,Win,59,141,0,1,1,TEN,3,437,583,2
0.4,0.5,26.53333333,9/23/2012,,,19,25,away,-11,MIN,191,198,60,58,13,24,Loss,89,146,3,0,2,SFO,37,280,344,3
0.5,0.4,33.46666667,9/23/2012,,,25,19,home,11,SFO,198,191,10,76,24,13,Win,146,89,0,3,3,MIN,37,344,280,2
0.307692308,0.526315789,27.6,9/23/2012,,,15,23,away,5,IND,148,313,67,54,22,17,Win,185,124,1,0,1,JAX,39,333,437,0
0.526315789,0.307692308,32.4,9/23/2012,,,23,15,home,-5,JAX,313,148,106,75,17,22,Loss,124,185,0,1,0,IND,39,437,333,1
0.230769231,0.285714286,26.06666667,9/23/2012,,,12,20,away,-17,CHI,101,171,40,58,6,23,Loss,59,103,6,2,1,LAR,29,160,274,2
0.285714286,0.230769231,33.93333333,9/23/2012,,,20,12,home,17,LAR,171,101,45,67,23,6,Win,103,59,2,6,2,CHI,29,274,160,1
0.285714286,0.272727273,32.93333333,9/23/2012,,,19,17,away,10,CLE,206,207,75,70,24,14,Win,138,33,1,4,2,BUF,38,344,240,1
0.272727273,0.285714286,27.06666667,9/23/2012,,,17,19,home,-10,BUF,207,206,57,60,14,24,Loss,33,138,4,1,1,CLE,38,240,344,2
0.2,0.3125,26.93333333,9/23/2012,,,12,14,away,-6,DAL,91,259,69,55,10,16,Loss,75,38,2,4,3,TBB,26,166,297,2
0.3125,0.2,33.06666667,9/23/2012,,,14,12,home,6,TBB,259,91,105,66,16,10,Win,38,75,4,2,2,DAL,26,297,166,3
0.352941176,0.526315789,35.38333333,9/23/2012,,,21,23,away,3,MIA,295,196,108,79,3,0,Win,93,185,2,0,2,NYJ,3,388,381,2
0.526315789,0.352941176,33.55,9/23/2012,,,23,21,home,-3,NYJ,196,295,65,79,0,3,Loss,185,93,0,2,2,MIA,3,381,388,2
0.615384615,0.454545455,36.23333333,9/23/2012,,,25,15,away,24,LAC,265,164,15,68,27,3,Win,119,116,2,1,4,ATL,30,384,280,1
0.454545455,0.615384615,23.76666667,9/23/2012,,,15,25,home,-24,ATL,164,265,17,56,3,27,Loss,116,119,1,2,1,LAC,30,280,384,4
0.357142857,0.4,25.45,9/23/2012,,,16,16,away,-21,ARI,194,193,65,63,6,27,Loss,113,99,5,3,0,PHI,33,307,292,3
0.4,0.357142857,34.55,9/23/2012,,,16,16,home,21,PHI,193,194,45,61,27,6,Win,99,113,3,5,3,ARI,33,292,307,0
0.571428571,0.583333333,36.25,9/23/2012,,,24,21,away,-3,OAK,379,202,81,70,31,34,Loss,54,119,1,1,1,PIT,65,433,321,2
0.583333333,0.571428571,23.75,9/23/2012,,,21,24,home,3,PIT,202,379,25,56,34,31,Win,119,54,1,1,2,OAK,65,321,433,1
0.5,0.352941176,31.66666667,9/23/2012,,,23,24,away,6,DEN,284,316,69,65,31,25,Win,152,59,1,3,1,HOU,56,436,375,2
0.352941176,0.5,28.33333333,9/23/2012,,,24,23,home,-6,HOU,316,284,75,76,25,31,Loss,59,152,3,1,2,DEN,56,375,436,1
0.466666667,0.5,31.05,9/23/2012,,,33,28,away,-1,BAL,319,382,83,77,30,31,Loss,77,121,2,0,1,NEP,61,396,503,0
0.5,0.466666667,28.95,9/23/2012,,,28,33,home,1,NEP,382,319,135,65,31,30,Win,121,77,0,2,0,BAL,61,503,396,1
0.466666667,0.181818182,33.65,9/24/2012,,,22,14,away,-2,SEA,184,111,127,68,12,14,Loss,84,127,8,1,0,GBP,26,268,238,0
0.181818182,0.466666667,26.35,9/24/2012,,,14,22,home,2,GBP,111,184,118,51,14,12,Win,127,84,1,8,0,SEA,26,238,268,0
0.2,0.333333333,26.95,9/27/2012,,,20,23,away,-7,BAL,314,337,66,70,16,23,Loss,43,101,1,4,1,CLE,39,357,438,2
0.333333333,0.2,33.05,9/27/2012,,,23,20,home,7,CLE,337,314,100,77,23,16,Win,101,43,4,1,2,BAL,39,438,357,1
0.333333333,0.428571429,27.56666667,9/30/2012,,,17,16,away,-24,HOU,167,202,73,60,14,38,Loss,158,95,4,0,0,TEN,52,325,297,3
0.428571429,0.333333333,32.43333333,9/30/2012,,,16,17,home,24,TEN,202,167,3,59,38,14,Win,95,158,0,4,3,HOU,52,297,325,0
0.363636364,0.533333333,30.78333333,9/30/2012,,,33,19,away,24,BUF,333,340,10,77,52,28,Win,247,98,1,3,6,NEP,80,580,438,2
0.533333333,0.363636364,29.21666667,9/30/2012,,,19,33,home,-24,NEP,340,333,17,69,28,52,Loss,98,247,3,1,2,BUF,80,438,580,6
0.333333333,0.153846154,36.93333333,9/30/2012,,,26,9,away,34,NYJ,134,100,67,68,34,0,Win,247,45,2,3,4,SFO,34,381,145,0
0.153846154,0.333333333,23.06666667,9/30/2012,,,9,26,home,-34,SFO,100,134,30,50,0,34,Loss,45,247,3,2,0,NYJ,34,145,381,4
0.222222222,0.384615385,29.86666667,9/30/2012,,,19,15,away,-6,LAR,140,211,55,61,13,19,Loss,179,75,2,2,1,SEA,32,319,286,3
0.384615385,0.222222222,30.13333333,9/30/2012,,,15,19,home,6,SEA,211,140,37,60,19,13,Win,75,179,2,2,3,LAR,32,286,319,1
0.363636364,0.384615385,30.1,9/30/2012,,,21,24,away,-2,ATL,205,305,64,63,28,30,Loss,199,121,3,7,1,CAR,58,404,426,1
0.384615385,0.363636364,29.9,9/30/2012,,,24,21,home,2,CAR,305,205,15,66,30,28,Win,121,199,7,3,1,ATL,58,426,404,1
0.25,0.375,29.3,9/30/2012,,,15,23,away,7,DET,100,286,87,56,20,13,Win,127,55,2,5,1,MIN,33,227,341,0
0.375,0.25,30.7,9/30/2012,,,23,15,home,-7,MIN,286,100,72,76,13,20,Loss,55,127,5,2,0,DET,33,341,227,1
0.25,0.4,33.86666667,9/30/2012,,,19,25,away,17,KCC,189,234,75,60,37,20,Win,104,115,3,2,6,LAC,57,293,349,1
0.4,0.25,26.13333333,9/30/2012,,,25,19,home,-17,LAC,234,189,80,66,20,37,Loss,115,104,2,3,1,KCC,57,349,293,6
0.083333333,0.625,22.58333333,9/30/2012,,,12,26,away,-31,DEN,181,338,41,53,6,37,Loss,56,165,3,0,1,OAK,43,237,503,0
0.625,0.083333333,37.41666667,9/30/2012,,,26,12,home,31,OAK,338,181,30,77,37,6,Win,165,56,0,3,0,DEN,43,503,237,1
0.375,0.25,35,9/30/2012,,,21,19,away,-3,ARI,394,269,40,74,0,3,Loss,86,28,4,8,2,MIA,3,480,297,4
0.25,0.375,31.51666667,9/30/2012,,,19,21,home,3,MIA,269,394,62,71,3,0,Win,28,86,8,4,4,ARI,3,297,480,2
0.181818182,0.181818182,31.31666667,9/30/2012,,,20,17,away,17,JAX,244,143,50,65,27,10,Win,138,69,0,6,2,CIN,37,382,212,2
0.181818182,0.181818182,28.68333333,9/30/2012,,,17,20,home,-17,CIN,143,244,37,58,10,27,Loss,69,138,6,0,2,JAX,37,212,382,2
0.181818182,0.25,32.31666667,9/30/2012,,,27,16,away,2,TBB,321,293,73,67,24,22,Win,153,80,1,1,1,WAS,46,474,373,0
0.25,0.181818182,27.68333333,9/30/2012,,,16,27,home,-2,WAS,293,321,107,58,22,24,Loss,80,153,1,1,0,TBB,46,373,474,1
0.529411765,0.5,30.46666667,9/30/2012,,,25,30,away,-1,GBP,429,319,72,75,27,28,Loss,45,102,2,0,2,NOS,55,474,421,0
0.5,0.529411765,29.53333333,9/30/2012,,,30,25,home,1,NOS,319,429,43,66,28,27,Win,102,45,0,2,0,GBP,55,421,474,2
0.2,0.333333333,26.65,9/30/2012,,,20,22,away,-2,PHI,309,231,55,61,17,19,Loss,57,191,0,2,0,NYG,36,366,422,1
0.333333333,0.2,33.35,9/30/2012,,,22,20,home,2,NYG,231,309,49,68,19,17,Win,191,57,2,0,1,PHI,36,422,366,0
0.583333333,0.333333333,30.83333333,10/1/2012,,,18,26,away,16,DAL,267,389,25,54,34,18,Win,93,41,2,1,5,CHI,52,360,430,1
0.333333333,0.583333333,29.16666667,10/1/2012,,,26,18,home,-16,CHI,389,267,10,68,18,34,Loss,41,93,1,2,1,DAL,52,430,360,5
0.368421053,0.285714286,34.36666667,10/4/2012,,,20,12,away,-14,LAR,237,131,35,76,3,17,Loss,45,111,9,1,1,ARI,20,282,242,1
0.285714286,0.368421053,25.63333333,10/4/2012,,,12,20,home,14,ARI,131,237,60,54,17,3,Win,111,45,1,9,1,LAR,20,242,282,1
0.307692308,0.142857143,28.81666667,10/7/2012,,,15,18,away,4,CIN,211,218,10,63,17,13,Win,68,80,2,3,3,MIA,30,279,298,2
0.142857143,0.307692308,31.18333333,10/7/2012,,,18,15,home,-4,MIA,218,211,46,65,13,17,Loss,80,68,3,2,2,CIN,30,298,279,3
0.25,0.545454545,24.6,10/7/2012,,,15,30,away,-14,NYG,291,259,91,54,27,41,Loss,84,243,0,0,2,CLE,68,375,502,3
0.545454545,0.25,35.4,10/7/2012,,,30,15,home,14,CLE,259,291,25,71,41,27,Win,243,84,0,0,3,NYG,68,502,375,2
0.307692308,0.4,24.73333333,10/7/2012,,,21,28,away,-3,IND,207,345,89,61,27,30,Loss,149,119,5,4,1,GBP,57,356,464,1
0.4,0.307692308,35.26666667,10/7/2012,,,28,21,home,3,GBP,345,207,100,89,30,27,Win,119,149,4,5,1,IND,57,464,356,1
0.4,0.428571429,26.48333333,10/7/2012,,,19,22,away,-2,PIT,168,220,35,56,14,16,Loss,78,123,3,0,0,PHI,30,246,343,2
0.428571429,0.4,33.51666667,10/7/2012,,,22,19,home,2,PHI,220,168,106,68,16,14,Win,123,78,0,3,2,PIT,30,343,246,0
0.529411765,0.111111111,37.01666667,10/7/2012,,,28,12,away,7,WAS,338,187,13,81,24,17,Win,83,129,1,3,2,ATL,41,421,316,2
0.111111111,0.529411765,22.98333333,10/7/2012,,,12,28,home,-7,ATL,187,338,20,48,17,24,Loss,129,83,3,1,2,WAS,41,316,421,2
0.272727273,0.461538462,25.83333333,10/7/2012,,,15,19,away,3,KCC,165,124,33,55,9,6,Win,133,214,4,0,4,BAL,15,298,338,2
0.461538462,0.272727273,34.16666667,10/7/2012,,,19,15,home,-3,BAL,124,165,60,68,6,9,Loss,214,133,0,4,2,KCC,15,338,298,4
0.588235294,0.384615385,36,10/7/2012,,,26,10,away,38,JAX,287,129,80,73,41,3,Win,214,60,1,3,3,CHI,44,501,189,1
0.384615385,0.588235294,24,10/7/2012,,,10,26,home,-38,CHI,129,287,49,53,3,41,Loss,60,214,3,1,1,JAX,44,189,501,3
0.5,0.181818182,35.61666667,10/7/2012,,,17,13,away,4,CAR,212,108,65,62,16,12,Win,98,82,2,4,2,SEA,28,310,190,3
0.181818182,0.5,24.38333333,10/7/2012,,,13,17,home,-4,SEA,108,212,25,52,12,16,Loss,82,98,4,2,3,CAR,28,190,310,2
0.470588235,0.272727273,26.9,10/7/2012,,,18,25,away,-23,MIN,215,258,75,69,7,30,Loss,52,175,2,1,2,TEN,37,267,433,2
0.272727273,0.470588235,33.1,10/7/2012,,,25,18,home,23,TEN,258,215,60,67,30,7,Win,175,52,1,2,2,MIN,37,433,267,2
0.2,0.636363636,23.76666667,10/7/2012,,,10,29,away,-42,SFO,115,310,30,46,3,45,Loss,89,311,1,0,1,BUF,48,204,621,2
0.636363636,0.2,36.23333333,10/7/2012,,,29,10,home,42,BUF,310,115,53,63,45,3,Win,311,89,0,1,2,SFO,48,621,204,1
0.538461538,0.647058824,24.18333333,10/7/2012,,,22,35,away,-10,NEP,324,193,21,66,21,31,Loss,70,251,2,4,1,DEN,52,394,444,3
0.647058824,0.538461538,35.81666667,10/7/2012,,,35,22,home,10,DEN,193,324,59,89,31,21,Win,251,70,4,2,3,NEP,52,444,394,1
0.333333333,0.5625,30.56666667,10/7/2012,,,27,21,away,-7,NOS,310,351,56,65,24,31,Loss,117,53,5,3,1,LAC,55,427,404,2
0.5625,0.333333333,29.43333333,10/7/2012,,,21,27,home,7,LAC,351,310,99,69,31,24,Win,53,117,3,5,2,NOS,55,404,427,1
0.4,0.285714286,35.26666667,10/8/2012,,,18,15,away,6,NYJ,209,217,50,63,23,17,Win,169,69,0,3,2,HOU,40,378,286,1
0.285714286,0.4,24.73333333,10/8/2012,,,15,18,home,-6,HOU,217,209,25,58,17,23,Loss,69,169,3,0,1,NYJ,40,286,378,2
0.466666667,0.5625,29.95,10/11/2012,,,19,21,away,-3,TEN,356,265,50,63,23,26,Loss,56,94,1,3,1,PIT,49,412,359,1
0.5625,0.466666667,30.05,10/11/2012,,,21,19,home,3,PIT,265,356,45,69,26,23,Win,94,56,3,1,1,TEN,49,359,412,1
0.357142857,0.411764706,30.05,10/14/2012,,,20,16,away,-10,CLE,362,218,50,68,24,34,Loss,76,110,2,2,1,CIN,58,438,328,4
0.411764706,0.357142857,29.95,10/14/2012,,,16,20,home,10,CIN,218,362,35,65,34,24,Win,110,76,2,2,4,CLE,58,328,438,1
0.272727273,0.5,26.33333333,10/14/2012,,,21,22,away,-26,NYJ,257,99,27,65,9,35,Loss,41,252,4,1,0,IND,44,298,351,4
0.5,0.272727273,33.66666667,10/14/2012,,,22,21,home,26,IND,99,257,110,64,35,9,Win,252,41,1,4,4,NYJ,44,351,298,0
0.352941176,0.444444444,33.18333333,10/14/2012,,,15,19,away,-28,TBB,180,318,55,68,10,38,Loss,80,145,0,1,2,KCC,48,260,463,2
0.444444444,0.352941176,26.81666667,10/14/2012,,,19,15,home,28,KCC,318,180,33,51,38,10,Win,145,80,1,0,2,TBB,48,463,260,2
0.384615385,0.222222222,36.43333333,10/14/2012,,,22,16,away,-3,ATL,325,241,110,68,20,23,Loss,149,45,3,1,3,OAK,43,474,286,3
0.222222222,0.384615385,23.56666667,10/14/2012,,,16,22,home,3,OAK,241,325,25,53,23,20,Win,45,149,1,3,3,ATL,43,286,474,3
0.533333333,0.6,40.05,10/14/2012,,,30,19,away,-2,BAL,254,230,82,79,29,31,Loss,227,86,1,1,0,DAL,60,481,316,1
0.6,0.533333333,19.95,10/14/2012,,,19,30,home,2,DAL,230,254,76,49,31,29,Win,86,227,1,1,1,BAL,60,316,481,0
0.230769231,0.333333333,33.38333333,10/14/2012,,,22,12,away,-3,MIA,300,156,94,69,14,17,Loss,162,36,3,3,0,LAR,31,462,192,1
0.333333333,0.230769231,26.61666667,10/14/2012,,,12,22,home,3,LAR,156,300,40,49,17,14,Win,36,162,3,3,1,MIA,31,192,462,0
0.230769231,0.470588235,30.68333333,10/14/2012,,,25,24,away,3,PHI,311,286,132,73,3,0,Win,138,71,0,3,3,DET,3,449,357,1
0.470588235,0.230769231,33.31666667,10/14/2012,,,24,25,home,-3,DET,286,311,60,78,0,3,Loss,71,138,3,0,1,PHI,3,357,449,3
0.444444444,0.333333333,34,10/14/2012,,,26,17,away,-1,SEA,388,283,80,85,23,24,Loss,87,85,1,2,2,NEP,47,475,368,2
0.333333333,0.444444444,26,10/14/2012,,,17,26,home,1,NEP,283,388,35,55,24,23,Win,85,87,2,1,2,SEA,47,368,475,2
0.307692308,0.3125,31.36666667,10/14/2012,,,19,20,away,3,ARI,141,150,39,68,3,0,Win,165,182,2,5,2,BUF,3,306,332,2
0.3125,0.307692308,32.46666667,10/14/2012,,,20,19,home,-3,BUF,150,141,67,71,0,3,Loss,182,165,5,2,2,ARI,3,332,306,2
0.470588235,0.5,31.53333333,10/14/2012,,,27,20,away,-12,WAS,327,178,29,80,26,38,Loss,94,183,4,1,1,MIN,64,421,361,3
0.5,0.470588235,28.46666667,10/14/2012,,,20,27,home,12,MIN,178,327,66,55,38,26,Win,183,94,1,4,3,WAS,64,361,421,1
0.333333333,0.285714286,32.25,10/14/2012,,,19,14,away,23,SFO,193,234,20,65,26,3,Win,149,80,0,6,3,NYG,29,342,314,0
0.285714286,0.333333333,27.75,10/14/2012,,,14,19,home,-23,NYG,234,193,35,60,3,26,Loss,80,149,6,0,0,SFO,29,314,342,3
0.357142857,0.416666667,27.98333333,10/14/2012,,,25,23,away,18,HOU,328,231,51,70,42,24,Win,99,90,2,3,3,GBP,66,427,321,0
0.416666667,0.357142857,32.01666667,10/14/2012,,,23,25,home,-18,GBP,231,328,69,69,24,42,Loss,90,99,3,2,0,HOU,66,321,427,3
0.25,0.4,26.41666667,10/15/2012,,,18,23,away,11,LAC,309,217,81,52,35,24,Win,56,90,0,4,6,DEN,59,365,307,3
0.4,0.25,33.58333333,10/15/2012,,,23,18,home,-11,DEN,217,309,64,72,24,35,Loss,90,56,4,0,3,LAC,59,307,365,6
0.307692308,0.272727273,27.98333333,10/18/2012,,,13,18,away,-7,SFO,115,138,20,54,6,13,Loss,136,175,2,2,1,SEA,19,251,313,1
0.272727273,0.307692308,32.01666667,10/18/2012,,,18,13,home,7,SEA,138,115,40,57,13,6,Win,175,136,2,2,1,SFO,19,313,251,1
0.6,0.333333333,26.25,10/21/2012,,,23,26,away,7,TBB,377,411,55,63,35,28,Win,81,102,0,2,0,NOS,63,458,513,1
0.333333333,0.6,33.75,10/21/2012,,,26,23,home,-7,NOS,411,377,50,68,28,35,Loss,102,81,2,0,1,TBB,63,513,458,0
0.428571429,0.2,33.61666667,10/21/2012,,,18,18,away,5,CAR,227,216,43,65,19,14,Win,85,112,0,2,2,DAL,33,312,328,1
0.2,0.428571429,26.38333333,10/21/2012,,,18,18,home,-5,DAL,216,227,71,60,14,19,Loss,112,85,2,0,1,CAR,33,328,312,2
0.357142857,0.1,35.08333333,10/21/2012,,,21,12,away,-7,MIN,230,43,82,69,14,21,Loss,126,166,7,3,2,ARI,35,356,209,2
0.1,0.357142857,24.91666667,10/21/2012,,,12,21,home,7,ARI,43,230,35,47,21,14,Win,166,126,3,7,2,MIN,35,209,356,2
0.642857143,0.583333333,29.68333333,10/21/2012,,,21,22,away,1,BUF,193,216,25,62,35,34,Win,197,166,2,1,2,TEN,69,390,382,0
0.583333333,0.642857143,30.31666667,10/21/2012,,,22,21,home,-1,TEN,216,193,65,60,34,35,Loss,166,197,1,2,0,BUF,69,382,390,2
0.461538462,0.666666667,32.71666667,10/21/2012,,,24,22,away,-4,NYG,232,329,55,69,23,27,Loss,248,64,3,1,2,WAS,50,480,393,4
0.666666667,0.461538462,27.28333333,10/21/2012,,,22,24,home,4,WAS,329,232,30,60,27,23,Win,64,248,1,3,4,NYG,50,393,480,2
0.461538462,0.4,24.65,10/21/2012,,,19,21,away,-4,IND,264,173,75,58,13,17,Loss,55,148,0,3,1,CLE,30,319,321,0
0.4,0.461538462,35.35,10/21/2012,,,21,19,home,4,CLE,173,264,50,69,17,13,Win,148,55,3,0,0,IND,30,321,319,1
0.266666667,0.533333333,21.73333333,10/21/2012,,,12,27,away,-30,HOU,121,239,56,59,13,43,Loss,55,181,4,2,0,BAL,56,176,420,2
0.533333333,0.266666667,38.26666667,10/21/2012,,,27,12,home,30,BAL,239,121,60,76,43,13,Win,181,55,2,4,2,HOU,56,420,176,0
0.6,0.363636364,32.96666667,10/21/2012,,,22,19,away,10,LAR,332,246,30,66,30,20,Win,70,108,3,3,1,GBP,50,402,354,0
0.363636364,0.6,27.03333333,10/21/2012,,,19,22,home,-10,GBP,246,332,30,59,20,30,Loss,108,70,3,3,0,LAR,50,354,402,1
0.066666667,0.352941176,30.08333333,10/21/2012,,,10,20,away,-3,OAK,155,282,92,61,0,3,Loss,54,69,3,2,3,JAX,3,209,351,1
0.352941176,0.066666667,32.01666667,10/21/2012,,,20,10,home,3,JAX,282,155,58,74,3,0,Win,69,54,2,3,1,OAK,3,351,209,3
0.533333333,0.529411765,35.81666667,10/21/2012,,,26,26,away,-3,NEP,297,250,60,78,0,3,Loss,106,131,4,1,1,NYJ,3,403,381,2
0.529411765,0.533333333,31.71666667,10/21/2012,,,26,26,home,3,NYJ,250,297,40,74,3,0,Win,131,106,1,4,2,NEP,3,381,403,1
0.625,0.384615385,37.5,10/21/2012,,,22,11,away,7,CIN,264,105,50,70,24,17,Win,167,80,3,0,1,PIT,41,431,185,2
0.384615385,0.625,22.5,10/21/2012,,,11,22,home,-7,PIT,105,264,20,49,17,24,Loss,80,167,0,3,2,CIN,41,185,431,1
0.307692308,0.352941176,25.41666667,10/22/2012,,,21,19,away,-6,CHI,243,125,47,67,7,13,Loss,97,171,3,5,0,DET,20,340,296,4
0.352941176,0.307692308,34.58333333,10/22/2012,,,19,21,home,6,DET,125,243,49,69,13,7,Win,171,97,5,3,4,CHI,20,296,340,0
0.470588235,0.384615385,37.75,10/25/2012,,,23,16,away,19,MIN,257,229,49,78,36,17,Win,159,140,1,3,3,TBB,53,416,369,0
0.384615385,0.470588235,22.25,10/25/2012,,,16,23,home,-19,TBB,229,257,32,59,17,36,Loss,140,159,3,1,0,MIN,53,369,416,3
0.333333333,0.75,25.28333333,10/28/2012,,,21,26,away,-4,DET,236,331,10,54,24,28,Loss,133,84,0,2,1,SEA,52,369,415,2
0.75,0.333333333,34.71666667,10/28/2012,,,26,21,home,4,SEA,331,236,61,73,28,24,Win,84,133,2,0,2,DET,52,415,369,1
0.3125,0.384615385,30.8,10/28/2012,,,18,20,away,-9,GBP,279,172,77,71,15,24,Loss,62,66,2,2,1,JAX,39,341,238,1
0.384615385,0.3125,29.2,10/28/2012,,,20,18,home,9,JAX,172,279,33,64,24,15,Win,66,62,2,2,1,GBP,39,238,341,1
0.526315789,0.25,36.63333333,10/28/2012,,,21,18,away,-1,CHI,297,131,21,77,22,23,Loss,119,79,2,6,3,CAR,45,416,210,2
0.25,0.526315789,23.36666667,10/28/2012,,,18,21,home,1,CAR,131,297,40,53,23,22,Win,79,119,6,2,2,CHI,45,210,416,3
0.538461538,0.461538462,32.91666667,10/28/2012,,,24,20,away,13,PHI,246,178,40,68,30,17,Win,146,92,2,3,0,ATL,47,392,270,0
0.461538462,0.538461538,27.08333333,10/28/2012,,,20,24,home,-13,ATL,178,246,57,62,17,30,Loss,92,146,3,2,0,PHI,47,270,392,0
0.583333333,0.3,28.9,10/28/2012,,,29,17,away,38,LAR,321,219,42,66,45,7,Win,152,107,0,2,2,NEP,52,473,326,0
0.3,0.583333333,31.1,10/28/2012,,,17,29,home,-38,NEP,219,321,102,57,7,45,Loss,107,152,2,0,0,LAR,52,326,473,2
0.5,0.454545455,33.93333333,10/28/2012,,,30,20,away,6,TEN,286,227,45,74,6,0,Win,171,112,2,2,0,IND,6,457,339,1
0.454545455,0.5,30.88333333,10/28/2012,,,20,30,home,-6,IND,227,286,65,56,0,6,Loss,112,171,2,2,1,TEN,6,339,457,0
0.375,0.266666667,30.86666667,10/28/2012,,,17,15,away,-1,CLE,148,117,15,69,6,7,Loss,117,133,1,2,0,LAC,13,265,250,1
0.266666667,0.375,29.13333333,10/28/2012,,,15,17,home,1,LAC,117,148,35,62,7,6,Win,133,117,2,1,1,CLE,13,250,265,0
0.25,0.363636364,26.78333333,10/28/2012,,,17,25,away,-15,PIT,169,215,55,57,12,27,Loss,86,140,1,1,0,WAS,39,255,355,0
0.363636364,0.25,33.21666667,10/28/2012,,,25,17,home,15,WAS,215,169,20,61,27,12,Win,140,86,1,1,0,PIT,39,355,255,0
0.307692308,0.294117647,28.78333333,10/28/2012,,,14,22,away,21,NYJ,139,258,31,59,30,9,Win,97,105,2,4,2,MIA,39,236,363,1
0.294117647,0.307692308,31.21666667,10/28/2012,,,22,14,home,-21,MIA,258,139,45,79,9,30,Loss,105,97,4,2,1,NYJ,39,363,236,2
0.166666667,0.307692308,28.96666667,10/28/2012,,,15,17,away,10,KCC,209,197,20,62,26,16,Win,135,102,0,3,4,OAK,42,344,299,1
0.307692308,0.166666667,31.03333333,10/28/2012,,,17,15,home,-10,OAK,197,209,40,59,16,26,Loss,102,135,3,0,1,KCC,42,299,344,4
0.2,0.5,27.7,10/28/2012,,,11,28,away,5,DAL,190,415,45,58,29,24,Win,103,19,1,4,6,NYG,53,293,434,2
0.5,0.2,32.3,10/28/2012,,,28,11,home,-5,NYG,415,190,10,83,24,29,Loss,19,103,4,1,2,DAL,53,434,293,6
0.083333333,0.384615385,24.76666667,10/28/2012,,,14,29,away,-20,DEN,201,305,15,60,14,34,Loss,51,225,1,0,1,NOS,48,252,530,1
0.384615385,0.083333333,35.23333333,10/28/2012,,,29,14,home,20,NOS,305,201,34,71,34,14,Win,225,51,0,1,1,DEN,48,530,252,1
0.5,0.142857143,31.26666667,10/29/2012,,,15,16,away,21,ARI,204,258,80,52,24,3,Win,113,7,4,4,1,SFO,27,317,265,0
0.142857143,0.5,28.73333333,10/29/2012,,,16,15,home,-21,SFO,258,204,51,65,3,24,Loss,7,113,4,4,0,ARI,27,265,317,1
0.583333333,0.444444444,31.51666667,11/1/2012,,,21,18,away,-18,LAC,176,216,37,60,13,31,Loss,113,123,1,1,2,KCC,44,289,339,4
0.444444444,0.583333333,28.48333333,11/1/2012,,,18,21,home,18,KCC,216,176,54,47,31,13,Win,123,113,1,1,4,LAC,44,339,289,2
0.428571429,0.25,37.01666667,11/4/2012,,,21,12,away,31,TEN,205,180,37,65,51,20,Win,160,159,3,2,5,CHI,71,365,339,1
0.25,0.428571429,22.98333333,11/4/2012,,,12,21,home,-31,CHI,180,205,68,55,20,51,Loss,159,160,2,3,1,TEN,71,339,365,5
0.666666667,0.545454545,35.5,11/4/2012,,,26,19,away,17,JAX,285,215,42,68,31,14,Win,149,64,1,1,2,DET,45,434,279,0
0.545454545,0.666666667,24.5,11/4/2012,,,19,26,home,-17,DET,215,285,40,59,14,31,Loss,64,149,1,1,0,JAX,45,279,434,2
0.266666667,0.4,26.5,11/4/2012,,,16,20,away,-14,GBP,286,208,57,66,17,31,Loss,54,176,2,1,1,ARI,48,340,384,2
0.4,0.266666667,33.5,11/4/2012,,,20,16,home,14,ARI,208,286,5,70,31,17,Win,176,54,1,2,2,GBP,48,384,340,1
0.363636364,0.684210526,25.1,11/4/2012,,,20,27,away,-3,IND,281,419,79,58,20,23,Loss,84,97,2,1,0,MIA,43,365,516,0
0.684210526,0.363636364,34.9,11/4/2012,,,27,20,home,3,MIA,419,281,91,75,23,20,Win,97,84,1,2,0,IND,43,516,365,0
0.454545455,0.2,24.66666667,11/4/2012,,,18,24,away,8,WAS,201,186,60,50,21,13,Win,129,151,0,4,0,CAR,34,330,337,0
0.2,0.454545455,35.33333333,11/4/2012,,,24,18,home,-8,CAR,186,201,97,75,13,21,Loss,151,129,4,0,0,WAS,34,337,330,0
0.181818182,0.363636364,25.95,11/4/2012,,,17,21,away,-12,HOU,230,256,15,57,9,21,Loss,74,118,4,2,0,BUF,30,304,374,1
0.363636364,0.181818182,34.05,11/4/2012,,,21,17,home,12,BUF,256,230,42,61,21,9,Win,118,74,2,4,1,HOU,30,374,304,0
0.357142857,0.3125,31.53333333,11/4/2012,,,18,17,away,10,CLE,145,174,82,62,25,15,Win,137,116,1,1,2,BAL,40,282,290,0
0.3125,0.357142857,28.46666667,11/4/2012,,,17,18,home,-10,BAL,174,145,31,65,15,25,Loss,116,137,1,1,0,CLE,40,290,282,2
0.642857143,0.357142857,30.61666667,11/4/2012,,,20,22,away,8,CIN,291,275,29,61,31,23,Win,68,91,0,5,1,DEN,54,359,366,2
0.357142857,0.642857143,29.38333333,11/4/2012,,,22,20,home,-8,DEN,275,291,83,72,23,31,Loss,91,68,5,0,2,CIN,54,366,359,1
0.416666667,0.357142857,28.06666667,11/4/2012,,,23,25,away,10,OAK,237,402,116,63,42,32,Win,278,22,1,2,3,TBB,74,515,424,1
0.357142857,0.416666667,31.93333333,11/4/2012,,,25,23,home,-10,TBB,402,237,80,75,32,42,Loss,22,278,2,1,1,OAK,74,424,515,3
0.3,0.333333333,24,11/4/2012,,,16,28,away,-10,SEA,44,190,33,53,20,30,Loss,243,195,4,1,0,MIN,50,287,385,2
0.333333333,0.3,36,11/4/2012,,,28,16,home,10,MIN,190,44,49,71,30,20,Win,195,243,1,4,2,SEA,50,385,287,0
0.461538462,0.2,35.25,11/4/2012,,,22,13,away,4,NYG,191,114,119,69,24,20,Win,158,68,4,2,1,PIT,44,349,182,2
0.2,0.461538462,24.75,11/4/2012,,,13,22,home,-4,PIT,114,191,40,48,20,24,Loss,68,158,2,4,2,NYG,44,182,349,1
0.3,0.5,27.28333333,11/4/2012,,,18,21,away,-6,ATL,312,330,50,54,13,19,Loss,65,123,1,3,0,DAL,32,377,453,0
0.5,0.3,32.71666667,11/4/2012,,,21,18,home,6,DAL,330,312,15,63,19,13,Win,123,65,3,1,0,ATL,32,453,377,0
0.375,0.555555556,33.5,11/5/2012,,,24,20,away,-15,NOS,226,231,58,77,13,28,Loss,221,140,7,2,2,PHI,41,447,371,2
0.555555556,0.375,26.5,11/5/2012,,,20,24,home,15,PHI,231,226,35,54,28,13,Win,140,221,2,7,2,NOS,41,371,447,2
0.272727273,0.1,35.76666667,11/8/2012,,,24,20,away,17,JAX,221,300,40,65,27,10,Win,138,37,2,4,3,IND,37,359,337,2
0.1,0.272727273,24.23333333,11/8/2012,,,20,24,home,-17,IND,300,221,115,63,10,27,Loss,37,138,4,2,2,JAX,37,337,359,3
0.666666667,0.333333333,36.68333333,11/11/2012,,,23,12,away,-10,TBB,323,205,5,65,24,34,Loss,103,74,2,1,0,LAC,58,426,279,2
0.333333333,0.666666667,23.31666667,11/11/2012,,,12,23,home,10,LAC,205,323,5,43,34,24,Win,74,103,1,2,2,TBB,58,279,426,0
0.111111111,0.266666667,25.6,11/11/2012,,,23,18,away,-10,MIN,308,207,57,61,24,34,Loss,60,196,2,2,0,DET,58,368,403,2
0.266666667,0.111111111,34.4,11/11/2012,,,18,23,home,10,DET,207,308,47,68,34,24,Win,196,60,2,2,2,MIN,58,403,368,0
0.230769231,0,28.43333333,11/11/2012,,,18,19,away,22,CAR,295,198,60,61,36,14,Win,65,52,1,7,2,DEN,50,360,250,2
0,0.230769231,31.56666667,11/11/2012,,,19,18,home,-22,DEN,198,295,45,64,14,36,Loss,52,65,7,1,2,CAR,50,250,360,2
0.5,0.4,32.58333333,11/11/2012,,,25,21,away,-4,NOS,408,292,53,71,27,31,Loss,46,148,1,1,1,ATL,58,454,440,1
0.4,0.5,27.41666667,11/11/2012,,,21,25,home,4,ATL,292,408,35,62,31,27,Win,148,46,1,1,1,NOS,58,440,454,1
0.357142857,0.461538462,29.75,11/11/2012,,,21,15,away,-18,CIN,189,199,5,70,13,31,Loss,129,76,4,0,1,NYG,44,318,275,4
0.461538462,0.357142857,30.25,11/11/2012,,,15,21,home,18,NYG,199,189,40,58,31,13,Win,76,129,0,4,4,CIN,44,275,318,1
0.444444444,0.416666667,33.36666667,11/11/2012,,,19,22,away,-35,BAL,350,341,105,73,20,55,Loss,72,78,3,0,1,OAK,75,422,419,3
0.416666667,0.444444444,26.63333333,11/11/2012,,,22,19,home,35,OAK,341,350,41,62,55,20,Win,78,72,0,3,3,BAL,75,419,422,1
0.636363636,0.583333333,33.83333333,11/11/2012,,,35,27,away,-6,NEP,319,230,148,71,31,37,Loss,162,117,3,1,0,BUF,68,481,347,3
0.583333333,0.636363636,26.16666667,11/11/2012,,,27,35,home,6,BUF,230,319,73,68,37,31,Win,117,162,1,3,3,NEP,68,347,481,0
0.470588235,0.153846154,33.21666667,11/11/2012,,,17,13,away,34,MIA,116,201,39,60,37,3,Win,177,54,1,2,4,TEN,40,293,255,0
0.153846154,0.470588235,26.78333333,11/11/2012,,,13,17,home,-34,TEN,201,116,67,56,3,37,Loss,54,177,2,1,0,MIA,40,255,293,4
0.181818182,0.384615385,23.81666667,11/11/2012,,,11,20,away,-21,SEA,101,189,35,50,7,28,Loss,84,174,3,4,2,NYJ,35,185,363,3
0.384615385,0.181818182,36.18333333,11/11/2012,,,20,11,home,21,NYJ,189,101,45,67,28,7,Win,174,84,4,3,3,SEA,35,363,185,2
0.4375,0.181818182,40.75,11/11/2012,,,27,25,away,0,SFO,299,158,85,80,24,24,Tie,159,183,2,5,0,LAR,48,458,341,1
0.181818182,0.4375,34.25,11/11/2012,,,25,27,home,0,LAR,158,299,66,64,24,24,Tie,183,159,5,2,1,SFO,48,341,458,0
0.384615385,0.1,27.96666667,11/11/2012,,,14,23,away,15,PHI,193,278,75,54,38,23,Win,101,91,3,2,2,DAL,61,294,369,0
0.1,0.384615385,32.03333333,11/11/2012,,,23,14,home,-15,DAL,278,193,50,66,23,38,Loss,91,101,2,3,0,PHI,61,369,294,2
0.214285714,0.153846154,31.13333333,11/11/2012,,,13,8,away,7,CHI,88,134,35,62,13,6,Win,127,115,1,0,4,HOU,19,215,249,2
0.153846154,0.214285714,28.86666667,11/11/2012,,,8,13,home,-7,HOU,134,88,49,56,6,13,Loss,115,127,0,1,2,CHI,19,249,215,4
0.153846154,0.375,29.3,11/12/2012,,,14,14,away,-3,PIT,148,154,76,63,0,3,Loss,142,95,2,1,1,KCC,3,290,249,1
0.375,0.153846154,31.61666667,11/12/2012,,,14,14,home,3,KCC,154,148,19,62,3,0,Win,95,142,1,2,1,PIT,3,249,290,1
0.3,0.166666667,24.95,11/15/2012,,,16,18,away,-5,BUF,124,161,69,55,14,19,Loss,60,120,3,3,0,MIA,33,184,281,3
0.166666667,0.3,35.05,11/15/2012,,,18,16,home,5,MIA,161,124,100,61,19,14,Win,120,60,3,3,3,BUF,33,281,184,0
0.466666667,0.3125,33.05,11/18/2012,,,17,15,away,14,LAR,165,167,20,65,27,13,Win,124,114,3,1,3,NYJ,40,289,281,0
0.3125,0.466666667,26.95,11/18/2012,,,15,17,home,-14,NYJ,167,165,30,65,13,27,Loss,114,124,1,3,0,LAR,40,281,289,3
0.4,0.285714286,30.71666667,11/18/2012,,,19,30,away,-3,DAL,192,257,129,70,0,3,Loss,119,63,2,7,1,CLE,3,311,320,1
0.285714286,0.4,38.16666667,11/18/2012,,,30,19,home,3,CLE,257,192,92,78,3,0,Win,63,119,7,2,1,DAL,3,320,311,1
0.388888889,0.529411765,32.5,11/18/2012,,,25,18,away,6,CAR,236,234,50,77,6,0,Win,167,97,1,2,1,TBB,6,403,331,3
0.529411765,0.388888889,31.83333333,11/18/2012,,,18,25,home,-6,TBB,234,236,91,65,0,6,Loss,97,167,2,1,3,CAR,6,331,403,1
0.125,0.4375,27.31666667,11/18/2012,,,7,20,away,-4,ATL,41,296,43,56,19,23,Loss,137,58,3,1,6,ARI,42,178,354,1
0.4375,0.125,32.68333333,11/18/2012,,,20,7,home,4,ARI,296,41,35,71,23,19,Win,58,137,1,3,1,ATL,42,354,178,6
0.285714286,0.090909091,35.36666667,11/18/2012,,,22,16,away,22,KCC,220,171,54,69,28,6,Win,189,113,2,4,1,CIN,34,409,284,0
0.090909091,0.285714286,24.63333333,11/18/2012,,,16,22,home,-22,CIN,171,220,30,60,6,28,Loss,113,189,4,2,0,KCC,34,284,409,1
0.461538462,0.4,30.3,11/18/2012,,,16,19,away,4,DET,219,252,80,59,24,20,Win,95,110,3,5,4,GBP,44,314,362,1
0.4,0.461538462,29.7,11/18/2012,,,19,16,home,-4,GBP,252,219,50,68,20,24,Loss,110,95,5,3,1,DET,44,362,314,4
0.285714286,0.363636364,31.31666667,11/18/2012,,,17,39,away,-6,HOU,372,504,54,66,3,9,Loss,86,149,2,2,3,JAX,12,458,653,1
0.363636364,0.285714286,41.66666667,11/18/2012,,,39,17,home,6,JAX,504,372,20,92,9,3,Win,149,86,2,2,1,HOU,12,653,458,3
0.368421053,0.454545455,31.4,11/18/2012,,,16,15,away,-25,WAS,177,192,70,71,6,31,Loss,80,169,4,2,0,PHI,37,257,361,3
0.454545455,0.368421053,28.6,11/18/2012,,,15,16,home,25,PHI,192,177,80,51,31,6,Win,169,80,2,4,3,WAS,37,361,257,0
0.545454545,0.333333333,28.6,11/18/2012,,,19,24,away,21,OAK,229,284,109,56,38,17,Win,151,120,0,3,2,NOS,55,380,404,0
0.333333333,0.545454545,31.4,11/18/2012,,,24,19,home,-21,NOS,284,229,40,69,17,38,Loss,120,151,3,0,0,OAK,55,404,380,2
0.571428571,0.666666667,32.91666667,11/18/2012,,,28,25,away,-35,NEP,329,331,5,75,24,59,Loss,119,115,1,0,0,IND,83,448,446,4
0.666666667,0.571428571,27.08333333,11/18/2012,,,25,28,home,35,IND,331,329,70,60,59,24,Win,115,119,0,1,4,NEP,83,446,448,0
0.1875,0.375,31.3,11/18/2012,,,13,21,away,-7,DEN,224,253,65,67,23,30,Loss,53,133,4,3,2,LAC,53,277,386,3
0.375,0.1875,28.7,11/18/2012,,,21,13,home,7,LAC,253,224,30,70,30,23,Win,133,53,3,4,3,DEN,53,386,277,2
0.214285714,0.294117647,27.15,11/18/2012,,,12,17,away,3,PIT,153,175,68,57,13,10,Win,47,134,2,3,3,BAL,23,200,309,0
0.294117647,0.214285714,32.85,11/18/2012,,,17,12,home,-3,BAL,175,153,43,69,10,13,Loss,134,47,3,2,0,PIT,23,309,200,3
0.25,0.333333333,29.91666667,11/19/2012,,,12,18,away,-25,SFO,58,232,55,56,7,32,Loss,85,121,6,2,0,CHI,39,143,353,2
0.333333333,0.25,30.08333333,11/19/2012,,,18,12,home,25,CHI,232,58,50,54,32,7,Win,121,85,2,6,2,SFO,39,353,143,0
0.4,0.5,35.63333333,11/22/2012,,,26,29,away,3,DET,296,419,66,78,3,0,Win,205,106,2,3,1,HOU,3,501,525,1
0.5,0.4,37.01666667,11/22/2012,,,29,26,home,-3,HOU,419,296,70,87,0,3,Loss,106,205,3,2,1,DET,3,525,501,1
0.5,0.470588235,31.7,11/22/2012,,,22,22,away,7,DAL,288,423,41,62,38,31,Win,149,35,3,2,3,WAS,69,437,458,1
0.470588235,0.5,28.3,11/22/2012,,,22,22,home,-7,WAS,423,288,45,75,31,38,Loss,35,149,2,3,1,DAL,69,458,437,3
0.733333333,0.3,29.56666667,11/22/2012,,,25,25,away,30,NYJ,323,286,37,66,49,19,Win,152,119,0,2,5,NEP,68,475,405,1
0.3,0.733333333,30.43333333,11/22/2012,,,25,25,home,-30,NEP,286,323,35,67,19,49,Loss,119,152,2,0,1,NYJ,68,405,475,5
0.111111111,0.1875,26.5,11/25/2012,,,13,14,away,-6,CLE,193,130,68,55,14,20,Loss,49,108,1,4,1,PIT,34,242,238,8
0.1875,0.111111111,33.5,11/25/2012,,,14,13,home,6,PIT,130,193,90,64,20,14,Win,108,49,4,1,8,CLE,34,238,242,1
0.5,0.214285714,28.28333333,11/25/2012,,,21,13,away,8,KCC,273,116,35,63,17,9,Win,95,148,2,2,1,DEN,26,368,264,1
0.214285714,0.5,31.71666667,11/25/2012,,,13,21,home,-8,DEN,116,273,50,59,9,17,Loss,148,95,2,2,1,KCC,26,264,368,1
0.25,0.529411765,29.23333333,11/25/2012,,,14,18,away,-24,CIN,119,194,25,61,10,34,Loss,99,221,4,2,0,OAK,44,218,415,2
0.529411765,0.25,30.76666667,11/25/2012,,,18,14,home,24,OAK,194,119,25,66,34,10,Win,221,99,2,4,2,CIN,44,415,218,0
0.5,0.444444444,31.98333333,11/25/2012,,,16,23,away,-3,MIA,216,246,59,56,21,24,Loss,96,189,2,1,1,SEA,45,312,435,0
0.444444444,0.5,28.01666667,11/25/2012,,,23,16,home,3,SEA,246,216,15,55,24,21,Win,189,96,1,2,0,MIA,45,435,312,1
0.4,0.5,30.61666667,11/25/2012,,,20,19,away,-5,JAX,250,221,42,70,19,24,Loss,110,100,1,7,1,TEN,43,360,321,2
0.5,0.4,29.38333333,11/25/2012,,,19,20,home,5,TEN,221,250,30,60,24,19,Win,100,110,7,1,2,JAX,43,321,360,1
0.615384615,0.4,29.36666667,11/25/2012,,,20,16,away,1,TBB,345,276,15,57,24,23,Win,79,50,1,2,0,ATL,47,424,326,2
0.4,0.615384615,30.63333333,11/25/2012,,,16,20,home,-1,ATL,276,345,24,54,23,24,Loss,50,79,2,1,2,TBB,47,326,424,0
0.307692308,0.5,28.36666667,11/25/2012,,,16,22,away,-7,IND,169,225,46,58,13,20,Loss,135,87,2,4,2,BUF,33,304,312,1
0.5,0.307692308,31.63333333,11/25/2012,,,22,16,home,7,BUF,225,169,37,70,20,13,Win,87,135,4,2,1,IND,33,312,304,2
0.375,0.578947368,22.5,11/25/2012,,,15,23,away,-18,CHI,144,183,44,65,10,28,Loss,114,113,2,1,2,MIN,38,258,296,3
0.578947368,0.375,37.5,11/25/2012,,,23,15,home,18,MIN,183,144,55,71,28,10,Win,113,114,1,2,3,CHI,38,296,258,2
0.5,0.2,39.03333333,11/25/2012,,,25,16,away,3,LAC,316,189,60,91,3,0,Win,127,91,5,6,0,BAL,3,443,280,0
0.2,0.5,34.85,11/25/2012,,,16,25,home,-3,BAL,189,316,37,65,0,3,Loss,91,127,6,5,0,LAC,3,280,443,0
0.272727273,0.307692308,28.15,11/25/2012,,,15,24,away,14,ARI,194,301,84,54,31,17,Win,173,74,2,2,4,LAR,48,367,375,1
0.307692308,0.272727273,31.85,11/25/2012,,,24,15,home,-14,LAR,301,194,56,77,17,31,Loss,74,173,2,2,1,ARI,48,375,367,4
0.461538462,0.272727273,30.1,11/25/2012,,,18,19,away,10,NOS,231,231,68,56,31,21,Win,144,59,0,5,2,SFO,52,375,290,2
0.272727273,0.461538462,29.9,11/25/2012,,,19,18,home,-10,SFO,231,231,53,67,21,31,Loss,59,144,5,0,2,NOS,52,290,375,2
0.416666667,0.5,28.78333333,11/25/2012,,,16,23,away,-28,NYG,201,243,49,58,10,38,Loss,116,147,5,1,0,GBP,48,317,390,2
0.5,0.416666667,31.21666667,11/25/2012,,,23,16,home,28,GBP,243,201,24,62,38,10,Win,147,116,1,5,2,NYG,48,390,317,0
0.5,0.25,35.2,11/26/2012,,,24,18,away,8,PHI,289,107,101,65,30,22,Win,109,204,2,1,3,CAR,52,398,311,0
0.25,0.5,24.8,11/26/2012,,,18,24,home,-8,CAR,107,289,30,48,22,30,Loss,204,109,1,2,0,PHI,52,311,398,3
0.5,0.090909091,33.73333333,11/29/2012,,,24,15,away,-10,ATL,335,159,30,74,13,23,Loss,101,124,1,1,1,NOS,36,436,283,5
0.090909091,0.5,26.26666667,11/29/2012,,,15,24,home,10,NOS,159,335,25,57,23,13,Win,124,101,1,1,5,ATL,36,283,436,1
0.1,0.416666667,24.85,12/2/2012,,,21,20,away,-16,BUF,186,112,74,63,18,34,Loss,50,232,3,0,2,JAX,52,236,344,2
0.416666667,0.1,35.15,12/2/2012,,,20,21,home,16,JAX,112,186,100,63,34,18,Win,232,50,0,3,2,BUF,52,344,236,2
0.266666667,0.352941176,22.36666667,12/2/2012,,,23,21,away,2,DET,372,313,36,74,35,33,Win,87,138,2,0,1,IND,68,459,451,3
0.352941176,0.266666667,37.63333333,12/2/2012,,,21,23,home,-2,IND,313,372,61,75,33,35,Loss,138,87,0,2,3,DET,68,451,459,1
0.6,0.428571429,22.78333333,12/2/2012,,,19,23,away,-6,KCC,220,197,45,51,21,27,Loss,165,158,2,1,0,CAR,48,385,355,0
0.428571429,0.6,37.21666667,12/2/2012,,,23,19,home,6,CAR,197,220,5,67,27,21,Win,158,165,1,2,0,KCC,48,355,385,0
0,0.357142857,21.86666667,12/2/2012,,,5,20,away,-1,NYJ,56,112,30,54,6,7,Loss,81,177,2,3,4,ARI,13,137,289,1
0.357142857,0,38.13333333,12/2/2012,,,20,5,home,1,ARI,112,56,20,74,7,6,Win,177,81,3,2,1,NYJ,13,289,137,4
0.421052632,0.1875,38.9,12/2/2012,,,18,16,away,-3,LAR,191,208,97,71,0,3,Loss,148,85,3,2,0,SFO,3,339,293,1
0.1875,0.421052632,35.66666667,12/2/2012,,,16,18,home,3,SFO,208,191,65,68,3,0,Win,85,148,2,3,1,LAR,3,293,339,0
0.235294118,0.266666667,33.8,12/2/2012,,,16,17,away,14,TEN,207,265,97,70,24,10,Win,124,89,0,6,6,HOU,34,331,354,0
0.266666667,0.235294118,26.2,12/2/2012,,,17,16,home,-14,HOU,265,207,35,68,10,24,Loss,89,124,6,0,0,TEN,34,354,331,6
0.5,0.5625,21.5,12/2/2012,,,16,22,away,-9,GBP,119,283,48,53,14,23,Loss,240,152,0,2,1,MIN,37,359,435,2
0.5625,0.5,38.5,12/2/2012,,,22,16,home,9,MIN,283,119,78,73,23,14,Win,152,240,2,0,2,GBP,37,435,359,1
0.466666667,0.230769231,33.4,12/2/2012,,,25,15,away,7,MIA,213,176,50,76,23,16,Win,108,101,4,3,1,NEP,39,321,277,1
0.230769231,0.466666667,26.6,12/2/2012,,,15,25,home,-7,NEP,176,213,77,59,16,23,Loss,101,108,3,4,1,MIA,39,277,321,1
0.533333333,0.5,34.58333333,12/2/2012,,,25,22,away,6,CHI,283,233,55,71,6,0,Win,176,132,2,0,0,SEA,6,459,365,1
0.5,0.533333333,32.86666667,12/2/2012,,,22,25,home,-6,SEA,233,283,45,59,0,6,Loss,132,176,0,2,1,CHI,6,365,459,0
0.25,0.363636364,26.55,12/2/2012,,,18,25,away,-8,DEN,235,242,80,61,23,31,Loss,71,91,1,0,1,TBB,54,306,333,1
0.363636364,0.25,33.45,12/2/2012,,,25,18,home,8,TBB,242,235,75,67,31,23,Win,91,71,0,1,1,DEN,54,333,306,1
0.5,0.333333333,33.3,12/2/2012,,,21,20,away,7,LAC,211,251,55,71,20,13,Win,128,46,1,4,2,CIN,33,339,297,3
0.333333333,0.5,26.7,12/2/2012,,,20,21,home,-7,CIN,251,211,55,63,13,20,Loss,46,128,4,1,3,LAC,33,297,339,2
0.272727273,0.5625,32.5,12/2/2012,,,23,25,away,3,OAK,353,344,25,67,20,17,Win,122,85,1,1,1,CLE,37,475,429,2
0.5625,0.272727273,27.5,12/2/2012,,,25,23,home,-3,CLE,344,353,65,72,17,20,Loss,85,122,1,1,2,OAK,37,429,475,1
0.384615385,0.272727273,34.35,12/2/2012,,,19,19,away,3,BAL,270,177,50,65,23,20,Win,96,111,2,3,2,PIT,43,366,288,3
0.272727273,0.384615385,25.65,12/2/2012,,,19,19,home,-3,PIT,177,270,70,58,20,23,Loss,111,96,3,2,3,BAL,43,288,366,2
0.6,0.642857143,26.7,12/2/2012,,,23,22,away,-5,DAL,240,294,5,61,33,38,Loss,183,123,1,2,0,PHI,71,423,417,1
0.642857143,0.6,33.3,12/2/2012,,,22,23,home,5,PHI,294,240,60,62,38,33,Win,123,183,2,1,1,DAL,71,417,423,0
0.6,0.5,33.21666667,12/3/2012,,,21,20,away,-1,WAS,273,163,73,63,16,17,Loss,117,207,1,0,1,NYG,33,390,370,0
0.5,0.6,26.78333333,12/3/2012,,,20,21,home,1,NYG,163,273,56,52,17,16,Win,207,117,0,1,0,WAS,33,370,390,1
0.5,0.25,37.31666667,12/6/2012,,,30,14,away,13,OAK,288,263,25,78,26,13,Win,140,61,3,1,2,DEN,39,428,324,1
0.25,0.5,22.68333333,12/6/2012,,,14,30,home,-13,DEN,263,288,94,47,13,26,Loss,61,140,1,3,1,OAK,39,324,428,2
0.411764706,0.428571429,31.7,12/9/2012,,,22,17,away,-7,MIN,320,77,80,73,14,21,Loss,118,171,2,1,1,CHI,35,438,248,2
0.428571429,0.411764706,28.3,12/9/2012,,,17,22,home,7,CHI,77,320,54,56,21,14,Win,171,118,1,2,2,MIN,35,248,438,1
0.307692308,0.125,30.51666667,12/9/2012,,,17,16,away,7,JAX,104,168,15,62,17,10,Win,166,123,1,3,2,NYJ,27,270,291,2
0.125,0.307692308,29.48333333,12/9/2012,,,16,17,home,-7,NYJ,168,104,54,70,10,17,Loss,123,166,3,1,2,JAX,27,291,270,2
0.363636364,0.333333333,28.61666667,12/9/2012,,,17,20,away,-4,IND,259,171,70,60,23,27,Loss,97,98,1,4,2,TEN,50,356,269,2
0.333333333,0.363636364,31.38333333,12/9/2012,,,20,17,home,4,TEN,171,259,43,68,27,23,Win,98,97,4,1,2,IND,50,269,356,2
0.578947368,0.363636364,30.18333333,12/9/2012,,,20,19,away,1,CIN,239,190,49,70,20,19,Win,49,146,3,5,1,DAL,39,288,336,1
0.363636364,0.578947368,29.81666667,12/9/2012,,,19,20,home,-1,DAL,190,239,70,58,19,20,Loss,146,49,5,3,1,CIN,39,336,288,1
0.545454545,0.384615385,36.76666667,12/9/2012,,,19,18,away,10,PIT,200,271,51,79,34,24,Win,94,69,1,2,2,LAC,58,294,340,0
0.384615385,0.545454545,23.23333333,12/9/2012,,,18,19,home,-10,LAC,271,200,52,61,24,34,Loss,69,94,2,1,0,PIT,58,340,294,2
0.411764706,0.25,29.4,12/9/2012,,,17,17,away,3,BUF,207,220,17,67,15,12,Win,78,61,1,5,2,LAR,27,285,281,1
0.25,0.411764706,30.6,12/9/2012,,,17,17,home,-3,LAR,220,207,15,58,12,15,Loss,61,78,5,1,1,BUF,27,281,285,2
0.090909091,0.333333333,26.51666667,12/9/2012,,,12,20,away,-23,CLE,130,198,35,52,7,30,Loss,180,154,5,3,0,KCC,37,310,352,1
0.333333333,0.090909091,33.48333333,12/9/2012,,,20,12,home,23,KCC,198,130,55,68,30,7,Win,154,180,3,5,1,CLE,37,352,310,0
0.388888889,0.375,29.85,12/9/2012,,,23,18,away,2,TBB,338,178,13,73,23,21,Win,29,136,6,2,0,PHI,44,367,314,1
0.375,0.388888889,30.15,12/9/2012,,,18,23,home,-2,PHI,178,338,64,68,21,23,Loss,136,29,2,6,1,TBB,44,314,367,0
0.5,0.363636364,29.36666667,12/9/2012,,,18,22,away,-3,WAS,173,244,56,58,0,3,Loss,186,179,2,3,1,BAL,3,359,423,2
0.363636364,0.5,34.01666667,12/9/2012,,,22,18,home,3,BAL,244,173,70,66,3,0,Win,179,186,3,2,2,WAS,3,423,359,1
0.25,0.6,24.21666667,12/9/2012,,,25,23,away,-10,CAR,327,280,15,62,20,30,Loss,35,195,2,1,0,ATL,50,362,475,1
0.6,0.25,35.78333333,12/9/2012,,,23,25,home,10,ATL,280,327,10,68,30,20,Win,195,35,1,2,1,CAR,50,475,362,0
0.384615385,0.2,29.46666667,12/9/2012,,,17,20,away,-14,SFO,133,166,43,57,13,27,Loss,94,155,2,4,0,MIA,40,227,321,1
0.2,0.384615385,30.53333333,12/9/2012,,,20,17,home,14,MIA,166,133,45,55,27,13,Win,155,94,4,2,1,SFO,40,321,227,0
0.384615385,0.454545455,30.3,12/9/2012,,,22,24,away,-25,NYG,345,259,81,68,27,52,Loss,142,135,1,0,2,NOS,79,487,394,4
0.454545455,0.384615385,29.7,12/9/2012,,,24,22,home,25,NOS,259,345,55,62,52,27,Win,135,142,0,1,4,NYG,79,394,487,2
0.285714286,0.272727273,25.55,12/9/2012,,,10,22,away,-58,SEA,111,209,79,58,0,58,Loss,43,284,3,1,1,ARI,58,154,493,8
0.272727273,0.285714286,34.45,12/9/2012,,,22,10,home,58,ARI,209,111,97,65,58,0,Win,284,43,1,3,8,SEA,58,493,154,1
0.647058824,0.454545455,37.23333333,12/9/2012,,,27,15,away,-7,GBP,251,148,55,78,20,27,Loss,135,140,1,3,1,DET,47,386,288,2
0.454545455,0.647058824,22.76666667,12/9/2012,,,15,27,home,7,DET,148,251,50,52,27,20,Win,140,135,3,1,2,GBP,47,288,386,1
0.285714286,0.5,29.18333333,12/10/2012,,,19,27,away,-28,NEP,223,289,70,65,14,42,Loss,100,130,2,1,1,HOU,56,323,419,1
0.5,0.285714286,30.81666667,12/10/2012,,,27,19,home,28,HOU,289,223,56,70,42,14,Win,130,100,1,2,1,NEP,56,419,323,1
0.388888889,0.25,37.66666667,12/13/2012,,,18,10,away,21,PHI,92,177,94,74,34,13,Win,157,42,6,1,5,CIN,47,249,219,2
0.25,0.388888889,22.33333333,12/13/2012,,,10,18,home,-21,CIN,177,92,76,53,13,34,Loss,42,157,1,6,2,PHI,47,219,249,5
0.3125,0.083333333,38.56666667,12/16/2012,,,21,12,away,17,BAL,187,222,51,75,34,17,Win,163,56,2,3,2,DEN,51,350,278,0
0.083333333,0.3125,21.43333333,12/16/2012,,,12,21,home,-17,DEN,222,187,61,62,17,34,Loss,56,163,3,2,0,BAL,51,278,350,2
0.4,0.545454545,24.36666667,12/16/2012,,,13,26,away,-21,MIA,213,209,88,57,3,24,Loss,86,180,2,1,1,JAX,27,299,389,0
0.545454545,0.4,35.63333333,12/16/2012,,,26,13,home,21,JAX,209,213,41,66,24,3,Win,180,86,1,2,0,MIA,27,389,299,1
0.466666667,0.333333333,36.28333333,12/16/2012,,,25,13,away,17,CLE,308,233,45,74,38,21,Win,122,58,2,2,2,WAS,59,430,291,1
0.333333333,0.466666667,23.71666667,12/16/2012,,,13,25,home,-17,WAS,233,308,30,52,21,38,Loss,58,122,2,2,1,CLE,59,291,430,2
0.181818182,0.230769231,30.45,12/16/2012,,,18,29,away,14,LAR,109,345,49,59,36,22,Win,213,87,2,4,2,MIN,58,322,432,0
0.230769231,0.181818182,29.55,12/16/2012,,,29,18,home,-14,MIN,345,109,47,77,22,36,Loss,87,213,4,2,0,LAR,58,432,322,2
0.307692308,0.363636364,28.9,12/16/2012,,,20,24,away,-41,NOS,319,298,84,72,0,41,Loss,67,149,2,1,0,TBB,41,386,447,5
0.363636364,0.307692308,31.1,12/16/2012,,,24,20,home,41,TBB,298,319,55,65,41,0,Win,149,67,1,2,5,NOS,41,447,386,0
0.4,0.692307692,21.05,12/16/2012,,,10,22,away,-34,ATL,159,265,25,47,0,34,Loss,97,129,1,1,0,NYG,34,256,394,3
0.692307692,0.4,38.95,12/16/2012,,,22,10,home,34,NYG,265,159,30,67,34,0,Win,129,97,1,1,3,ATL,34,394,256,0
0.125,0.384615385,26.9,12/16/2012,,,19,23,away,-12,HOU,148,239,79,57,17,29,Loss,124,178,5,3,0,IND,46,272,417,1
0.384615385,0.125,33.1,12/16/2012,,,23,19,home,12,IND,239,148,69,66,29,17,Win,178,124,3,5,1,HOU,46,417,272,0
0.411764706,0,33.38333333,12/16/2012,,,20,12,away,8,CHI,278,107,104,71,21,13,Win,113,83,3,4,1,GBP,34,391,190,2
0,0.411764706,26.61666667,12/16/2012,,,12,20,home,-8,GBP,107,278,91,48,13,21,Loss,83,113,4,3,2,CHI,34,190,391,1
0.454545455,0.384615385,28.95,12/16/2012,,,22,21,away,33,BUF,196,215,32,57,50,17,Win,270,118,2,3,3,SEA,67,466,333,0
0.384615385,0.454545455,31.05,12/16/2012,,,21,22,home,-33,SEA,215,196,20,67,17,50,Loss,118,270,3,2,0,BUF,67,333,466,3
0.5,0.333333333,37.53333333,12/16/2012,,,29,12,away,24,LAC,217,94,48,74,31,7,Win,155,70,2,6,2,CAR,38,372,164,1
0.333333333,0.5,22.46666667,12/16/2012,,,12,29,home,-24,CAR,94,217,70,45,7,31,Loss,70,155,6,2,1,LAC,38,164,372,2
0.333333333,0.166666667,31.23333333,12/16/2012,,,18,12,away,-28,ARI,228,97,63,74,10,38,Loss,84,99,2,1,1,DET,48,312,196,4
0.166666667,0.333333333,28.76666667,12/16/2012,,,12,18,home,28,DET,97,228,50,51,38,10,Win,99,84,1,2,4,ARI,48,196,312,1
0.083333333,0.411764706,19.9,12/16/2012,,,7,21,away,-15,OAK,109,182,60,46,0,15,Loss,10,203,4,0,1,KCC,15,119,385,1
0.411764706,0.083333333,40.1,12/16/2012,,,21,7,home,15,KCC,182,109,62,75,15,0,Win,203,10,0,4,1,OAK,15,385,119,1
0.416666667,0.363636364,27,12/16/2012,,,20,23,away,-3,DAL,319,328,0,61,0,3,Loss,69,87,4,1,1,PIT,3,388,415,2
0.363636364,0.416666667,34.4,12/16/2012,,,23,20,home,3,PIT,328,319,61,64,3,0,Win,87,69,1,4,2,DAL,3,415,388,1
0.357142857,0.133333333,30.21666667,12/16/2012,,,19,32,away,7,NEP,208,425,88,65,41,34,Win,180,95,1,3,4,SFO,75,388,520,2
0.133333333,0.357142857,29.78333333,12/16/2012,,,32,19,home,-7,SFO,425,208,73,92,34,41,Loss,95,180,3,1,2,NEP,75,520,388,4
0.416666667,0.153846154,30.26666667,12/17/2012,,,20,12,away,-4,TEN,107,127,23,63,10,14,Loss,146,167,4,4,0,NYJ,24,253,294,5
0.153846154,0.416666667,29.73333333,12/17/2012,,,12,20,home,4,NYJ,127,107,111,56,14,10,Win,167,146,4,4,5,TEN,24,294,253,0
0.545454545,0.357142857,28.86666667,12/22/2012,,,19,25,away,13,DET,271,443,20,55,31,18,Win,73,79,1,0,3,ATL,49,344,522,0
0.357142857,0.545454545,31.13333333,12/22/2012,,,25,19,home,-13,ATL,443,271,20,78,18,31,Loss,79,73,0,1,0,DET,49,522,344,3
0.266666667,0.142857143,28.25,12/23/2012,,,16,15,away,3,PIT,253,185,55,63,13,10,Win,14,95,6,4,3,CIN,23,267,280,3
0.142857143,0.266666667,31.75,12/23/2012,,,15,16,home,-3,CIN,185,253,63,63,10,13,Loss,95,14,4,6,3,PIT,23,280,267,3
0.428571429,0.5,29.71666667,12/23/2012,,,17,18,away,-14,MIA,227,119,93,65,10,24,Loss,154,182,2,2,0,BUF,34,381,301,4
0.5,0.428571429,30.28333333,12/23/2012,,,18,17,home,14,BUF,119,227,25,62,24,10,Win,182,154,2,2,4,MIA,34,301,381,0
0.363636364,0.470588235,24.01666667,12/23/2012,,,14,23,away,15,TBB,196,349,64,54,28,13,Win,89,80,0,5,5,LAR,41,285,429,2
0.470588235,0.363636364,35.98333333,12/23/2012,,,23,14,home,-15,LAR,349,196,5,81,13,28,Loss,80,89,5,0,2,TBB,41,429,285,5
0.266666667,0.4,29.08333333,12/23/2012,,,12,16,away,-11,CAR,142,159,70,59,6,17,Loss,47,112,1,2,2,OAK,23,189,271,1
0.4,0.266666667,30.91666667,12/23/2012,,,16,12,home,11,OAK,159,142,97,59,17,6,Win,112,47,2,1,1,CAR,23,271,189,2
0.5,0.333333333,29.38333333,12/23/2012,,,18,25,away,7,PHI,185,321,24,53,27,20,Win,128,90,1,5,2,WAS,47,313,411,1
0.333333333,0.5,30.61666667,12/23/2012,,,25,18,home,-7,WAS,321,185,25,75,20,27,Loss,90,128,5,1,1,PHI,47,411,313,2
0.266666667,0.181818182,25.6,12/23/2012,,,10,28,away,-48,GBP,101,343,35,59,7,55,Loss,79,117,7,1,0,TEN,62,180,460,2
0.181818182,0.266666667,34.4,12/23/2012,,,28,10,home,48,TEN,343,101,10,76,55,7,Win,117,79,1,7,2,GBP,62,460,180,0
0.578947368,0.2,41.98333333,12/23/2012,,,33,18,away,3,DAL,446,406,42,91,3,0,Win,116,40,0,2,1,NOS,3,562,446,0
0.2,0.578947368,22.46666667,12/23/2012,,,18,33,home,-3,NOS,406,446,32,56,0,3,Loss,40,116,2,0,0,DAL,3,446,562,1
0.375,0.2,27.66666667,12/23/2012,,,16,22,away,7,KCC,198,155,48,65,20,13,Win,90,352,3,1,3,IND,33,288,507,0
0.2,0.375,32.33333333,12/23/2012,,,22,16,home,-7,IND,155,198,75,67,13,20,Loss,352,90,1,3,0,KCC,33,507,288,3
0.333333333,0.266666667,27.41666667,12/23/2012,,,23,22,away,7,JAX,246,343,39,71,23,16,Win,103,93,3,1,3,NEP,39,349,436,2
0.266666667,0.333333333,32.58333333,12/23/2012,,,22,23,home,-7,NEP,343,246,47,75,16,23,Loss,93,103,1,3,2,JAX,39,436,349,3
0.5,0.090909091,34.76666667,12/23/2012,,,22,11,away,17,HOU,171,153,52,73,23,6,Win,174,34,1,4,2,MIN,29,345,187,1
0.090909091,0.5,25.23333333,12/23/2012,,,11,22,home,-17,MIN,153,171,60,53,6,23,Loss,34,174,4,1,1,HOU,29,187,345,2
0.166666667,0.181818182,30.15,12/23/2012,,,15,18,away,10,NYJ,136,156,53,56,27,17,Win,87,69,4,11,2,LAC,44,223,225,0
0.181818182,0.166666667,29.85,12/23/2012,,,18,15,home,-10,LAC,156,136,40,59,17,27,Loss,69,87,11,4,0,NYJ,44,225,223,2
0.25,0.6,26.33333333,12/23/2012,,,20,29,away,-22,DEN,142,339,69,60,12,34,Loss,91,118,6,0,1,CLE,46,233,457,1
0.6,0.25,33.66666667,12/23/2012,,,29,20,home,22,CLE,339,142,84,75,34,12,Win,118,91,0,6,1,DEN,46,457,233,1
0.2,0.611111111,20.65,12/23/2012,,,11,25,away,-19,BAL,119,309,52,45,14,33,Loss,67,224,3,0,0,NYG,47,186,533,0
0.611111111,0.2,39.35,12/23/2012,,,25,11,home,19,NYG,309,119,92,81,33,14,Win,224,67,0,3,0,BAL,47,533,186,0
0.230769231,0.2,28.08333333,12/23/2012,,,15,15,away,15,ARI,145,219,12,60,28,13,Win,152,29,1,4,3,CHI,41,297,248,1
0.2,0.230769231,31.91666667,12/23/2012,,,15,15,home,-15,CHI,219,145,25,72,13,28,Loss,29,152,4,1,1,ARI,41,248,297,3
0.272727273,0.846153846,24.85,12/23/2012,,,17,22,away,-29,SEA,231,170,58,56,13,42,Loss,82,176,1,1,1,SFO,55,313,346,2
0.846153846,0.272727273,35.15,12/23/2012,,,22,17,home,29,SFO,170,231,45,62,42,13,Win,176,82,1,1,2,SEA,55,346,313,1
0.454545455,0.6,28.85,12/30/2012,,,19,19,away,-12,IND,250,184,64,60,16,28,Loss,102,81,4,1,0,HOU,44,352,265,2
0.6,0.454545455,31.15,12/30/2012,,,19,19,home,12,HOU,184,250,24,62,28,16,Win,81,102,1,4,2,IND,44,265,352,0
0.4375,0.214285714,32.08333333,12/30/2012,,,18,15,away,5,ATL,222,213,15,65,22,17,Win,144,65,0,2,0,TBB,39,366,278,1
0.214285714,0.4375,27.91666667,12/30/2012,,,15,18,home,-5,TBB,213,222,15,62,17,22,Loss,65,144,2,0,1,ATL,39,278,366,0
0.3,0.384615385,29.65,12/30/2012,,,18,17,away,-14,PIT,182,121,79,62,10,24,Loss,138,91,4,2,0,CLE,34,320,212,4
0.384615385,0.3,30.35,12/30/2012,,,17,18,home,14,CLE,121,182,58,53,24,10,Win,91,138,2,4,4,PIT,34,212,320,0
0.277777778,0.230769231,35.65,12/30/2012,,,23,9,away,-6,CIN,146,142,102,83,17,23,Loss,206,47,4,2,0,BAL,40,352,189,1
0.230769231,0.277777778,24.35,12/30/2012,,,9,23,home,6,BAL,142,146,40,49,23,17,Win,47,206,2,4,1,CIN,40,189,352,0
0.266666667,0.5,34.15,12/30/2012,,,19,20,away,2,DET,245,255,35,68,26,24,Win,144,72,2,1,4,CHI,50,389,327,0
0.5,0.266666667,25.85,12/30/2012,,,20,19,home,-2,CHI,255,245,29,63,24,26,Loss,72,144,1,2,0,DET,50,327,389,4
0.411764706,0.466666667,32.33333333,12/30/2012,,,19,16,away,-19,BUF,199,225,45,72,9,28,Loss,133,109,1,0,1,NYJ,37,332,334,2
0.466666667,0.411764706,27.66666667,12/30/2012,,,16,19,home,19,NYJ,225,199,24,57,28,9,Win,109,133,0,1,2,BUF,37,334,332,1
0.285714286,0.625,28.45,12/30/2012,,,18,32,away,-35,NYG,207,212,52,65,7,42,Loss,110,185,1,1,0,PHI,49,317,397,1
0.625,0.285714286,31.55,12/30/2012,,,32,18,home,35,PHI,212,207,5,58,42,7,Win,185,110,1,1,1,NYG,49,397,317,0
0.4375,0.428571429,32.35,12/30/2012,,,21,12,away,-18,TEN,253,142,35,71,20,38,Loss,122,79,7,2,0,JAX,58,375,221,3
0.428571429,0.4375,27.65,12/30/2012,,,12,21,home,18,JAX,142,253,43,51,38,20,Win,79,122,2,7,3,TEN,58,221,375,0
0.625,0.333333333,33.91666667,12/30/2012,,,28,22,away,6,NOS,257,378,36,74,44,38,Win,273,63,1,2,1,CAR,82,530,441,1
0.333333333,0.625,26.08333333,12/30/2012,,,22,28,home,-6,CAR,378,257,55,63,38,44,Loss,63,273,2,1,1,NOS,82,441,530,1
0.461538462,0.5,28.08333333,12/30/2012,,,24,25,away,-3,MIN,333,227,43,61,34,37,Loss,72,217,5,1,0,GBP,71,405,444,1
0.5,0.461538462,31.91666667,12/30/2012,,,25,24,home,3,GBP,227,333,98,66,37,34,Win,217,72,1,5,1,MIN,71,444,405,0
0.384615385,0.5,24.36666667,12/30/2012,,,16,28,away,-28,NEP,209,276,23,57,0,28,Loss,47,167,7,1,0,MIA,28,256,443,2
0.5,0.384615385,35.63333333,12/30/2012,,,28,16,home,28,MIA,276,209,48,75,28,0,Win,167,47,1,7,2,NEP,28,443,256,0
0.181818182,0.416666667,27.18333333,12/30/2012,,,20,17,away,-7,SEA,252,209,98,61,13,20,Loss,79,153,0,6,0,LAR,33,331,362,1
0.416666667,0.181818182,32.81666667,12/30/2012,,,17,20,home,7,LAR,209,252,80,55,20,13,Win,153,79,6,0,1,SEA,33,362,331,0
0.25,0.285714286,23.95,12/30/2012,,,11,20,away,-14,SFO,207,278,34,53,13,27,Loss,55,129,2,1,0,ARI,40,262,407,2
0.285714286,0.25,36.05,12/30/2012,,,20,11,home,14,ARI,278,207,25,67,27,13,Win,129,55,1,2,2,SFO,40,407,262,0
0.533333333,0.181818182,28.3,12/30/2012,,,17,14,away,-3,LAC,150,140,67,57,21,24,Loss,115,70,0,2,0,OAK,45,265,210,1
0.181818182,0.533333333,31.7,12/30/2012,,,14,17,home,3,OAK,140,150,60,50,24,21,Win,70,115,2,0,1,LAC,45,210,265,0
0.285714286,0.583333333,22.5,12/30/2012,,,8,32,away,-35,DEN,26,316,32,48,3,38,Loss,93,172,4,0,1,KCC,41,119,488,0
0.583333333,0.285714286,37.5,12/30/2012,,,32,8,home,35,KCC,316,26,30,76,38,3,Win,172,93,0,4,0,DEN,41,488,119,1
0.538461538,0.454545455,26.56666667,12/30/2012,,,20,24,away,-10,WAS,196,87,6,61,18,28,Loss,100,274,2,1,0,DAL,46,296,361,3
0.454545455,0.538461538,33.43333333,12/30/2012,,,24,20,home,10,DAL,87,196,20,61,28,18,Win,274,100,1,2,3,WAS,46,361,296,0
0,0.470588235,21.18333333,1/5/2013,,,12,24,away,-6,HOU,118,262,51,48,13,19,Loss,80,158,2,0,1,CIN,32,198,420,1
0.470588235,0,38.81666667,1/5/2013,,,24,12,home,6,CIN,262,118,55,77,19,13,Win,158,80,0,2,1,HOU,32,420,198,1
0.357142857,0.214285714,27.03333333,1/5/2013,,,17,20,away,-14,GBP,157,250,30,62,10,24,Loss,167,76,3,3,0,MIN,34,324,326,3
0.214285714,0.357142857,32.96666667,1/5/2013,,,20,17,home,14,MIN,250,157,10,67,24,10,Win,76,167,3,3,3,GBP,34,326,324,0
0.45,0.4,37.53333333,1/6/2013,,,25,18,away,-15,BAL,267,269,37,87,9,24,Loss,152,170,3,1,2,IND,33,419,439,2
0.4,0.45,22.46666667,1/6/2013,,,18,25,home,15,IND,269,267,70,56,24,9,Win,170,152,1,3,2,BAL,33,439,419,2
0.384615385,0.454545455,34.33333333,1/6/2013,,,22,15,away,10,WAS,156,99,30,68,24,14,Win,224,104,5,2,2,SEA,38,380,203,1
0.454545455,0.384615385,25.66666667,1/6/2013,,,15,22,home,-10,SEA,99,156,15,54,14,24,Loss,104,224,2,5,1,WAS,38,203,380,2
0.411764706,0.4375,36.6,1/12/2013,,,21,30,away,0,DEN,324,273,56,74,0,0,Tie,155,125,1,3,3,BAL,0,479,398,1
0.4375,0.411764706,40.1,1/12/2013,,,30,21,home,0,BAL,273,324,87,87,0,0,Tie,125,155,3,1,1,DEN,0,398,479,3
0.416666667,0.615384615,21.98333333,1/12/2013,,,20,29,away,-14,SFO,248,256,26,56,31,45,Loss,104,323,1,1,1,GBP,76,352,579,2
0.615384615,0.416666667,38.01666667,1/12/2013,,,29,20,home,14,GBP,256,248,86,75,45,31,Win,323,104,1,1,2,SFO,76,579,352,1
0.375,0.545454545,28.78333333,1/13/2013,,,28,24,away,-2,ATL,368,250,35,66,28,30,Loss,123,167,2,0,2,SEA,58,491,417,2
0.545454545,0.375,31.21666667,1/13/2013,,,24,28,home,2,SEA,250,368,11,61,30,28,Win,167,123,0,2,2,ATL,58,417,491,2
0.266666667,0.461538462,31.4,1/13/2013,,,25,24,away,-13,NEP,334,335,20,75,28,41,Loss,91,122,1,1,0,HOU,69,425,457,1
0.461538462,0.266666667,28.6,1/13/2013,,,24,25,home,13,HOU,335,334,56,65,41,28,Win,122,91,1,1,1,NEP,69,457,425,0
0.333333333,0.555555556,27.93333333,1/20/2013,,,21,27,away,4,ATL,224,396,24,51,28,24,Win,149,81,1,1,2,SFO,52,373,477,1
0.555555556,0.333333333,32.06666667,1/20/2013,,,27,21,home,-4,SFO,396,224,30,66,24,28,Loss,81,149,1,1,1,ATL,52,477,373,2
0.416666667,0.466666667,31.1,1/20/2013,,,25,28,away,15,NEP,235,320,60,71,28,13,Win,121,108,2,0,3,BAL,41,356,428,0
0.466666667,0.416666667,28.9,1/20/2013,,,28,25,home,-15,BAL,320,235,40,82,13,28,Loss,108,121,0,2,0,NEP,41,428,356,3
0.5625,0.222222222,32.38333333,2/3/2013,,,21,23,away,3,SFO,274,286,20,70,34,31,Win,93,182,2,3,2,BAL,65,367,468,1
0.222222222,0.5625,27.61666667,2/3/2013,,,23,21,home,-3,BAL,286,274,33,60,31,34,Loss,182,93,3,2,1,SFO,65,468,367,2
0.363636364,0.533333333,33.8,9/5/2013,2013,1,24,24,away,-22,DEN,335,445,53,87,27,49,Loss,58,65,4,3,2,BAL,76,393,510,2
0.533333333,0.363636364,26.2,9/5/2013,2013,1,24,24,home,22,BAL,445,335,61,68,49,27,Win,65,58,3,4,2,DEN,76,510,393,2
0.4,0.307692308,34.01666667,9/8/2013,2013,1,17,14,away,7,PIT,117,163,60,63,16,9,Win,112,31,1,5,2,TEN,25,229,194,0
0.307692308,0.4,25.98333333,9/8/2013,2013,1,14,17,home,-7,TEN,163,117,47,53,9,16,Loss,31,112,5,1,0,PIT,25,194,229,2
0.5,0.071428571,32.78333333,9/8/2013,2013,1,18,20,away,13,CLE,255,244,77,65,23,10,Win,20,47,4,6,3,MIA,33,275,291,1
0.071428571,0.5,27.21666667,9/8/2013,2013,1,20,18,home,-13,MIA,244,255,57,72,10,23,Loss,47,20,6,4,1,CLE,33,291,275,3
0.55,0.307692308,37.71666667,9/8/2013,2013,1,26,15,away,2,BUF,273,150,36,89,23,21,Win,158,136,3,0,2,NEP,44,431,286,3
0.307692308,0.55,22.28333333,9/8/2013,2013,1,15,26,home,-2,NEP,150,273,75,61,21,23,Loss,136,158,0,3,3,BUF,44,286,431,2
0.636363636,0.428571429,28.5,9/8/2013,2013,1,18,17,away,-3,CHI,277,242,84,55,21,24,Loss,63,81,1,0,1,CIN,45,340,323,3
0.428571429,0.636363636,31.5,9/8/2013,2013,1,17,18,home,3,CIN,242,277,59,61,24,21,Win,81,63,0,1,3,CHI,45,323,340,1
0.461538462,0.454545455,30.23333333,9/8/2013,2013,1,18,17,away,5,CAR,300,119,99,61,12,7,Win,70,134,2,1,2,SEA,19,370,253,1
0.454545455,0.461538462,29.76666667,9/8/2013,2013,1,17,18,home,-5,SEA,119,300,46,50,7,12,Loss,134,70,1,2,1,CAR,19,253,370,2
0.333333333,0.263157895,31.5,9/8/2013,2013,1,17,12,away,26,JAX,171,107,20,62,28,2,Win,121,71,1,6,2,KCC,30,292,178,0
0.263157895,0.333333333,28.5,9/8/2013,2013,1,12,17,home,-26,KCC,107,171,30,70,2,28,Loss,71,121,6,1,0,JAX,30,178,292,2
0.375,0.388888889,27.63333333,9/8/2013,2013,1,12,22,away,-1,NYJ,185,214,102,59,17,18,Loss,65,90,3,5,2,TBB,35,250,304,2
0.388888889,0.375,32.36666667,9/8/2013,2013,1,22,12,home,1,TBB,214,185,45,73,18,17,Win,90,65,5,3,2,NYJ,35,304,250,2
0.538461538,0.6,32.78333333,9/8/2013,2013,1,20,18,away,-4,IND,201,147,51,63,17,21,Loss,171,127,1,4,0,OAK,38,372,274,2
0.6,0.538461538,27.21666667,9/8/2013,2013,1,18,20,home,4,OAK,147,201,31,53,21,17,Win,127,171,4,1,2,IND,38,274,372,0
0.272727273,0.461538462,24.81666667,9/8/2013,2013,1,18,18,away,-6,NOS,279,341,19,55,17,23,Loss,88,78,3,2,1,ATL,40,367,419,2
0.461538462,0.272727273,35.18333333,9/8/2013,2013,1,18,18,home,6,ATL,341,279,57,66,23,17,Win,78,88,2,3,2,NOS,40,419,367,1
0.2,0.384615385,23.68333333,9/8/2013,2013,1,16,28,away,-10,DET,225,357,52,53,24,34,Loss,105,112,3,0,2,MIN,58,330,469,4
0.384615385,0.2,36.31666667,9/8/2013,2013,1,28,16,home,10,MIN,357,225,88,77,34,24,Win,112,105,0,3,4,DET,58,469,330,2
0.5,0.363636364,31.41666667,9/8/2013,2013,1,25,20,away,-3,LAR,304,299,68,70,24,27,Loss,86,67,4,0,2,ARI,51,390,366,2
0.363636364,0.5,28.58333333,9/8/2013,2013,1,20,25,home,3,ARI,299,304,59,62,27,24,Win,67,86,0,4,2,LAR,51,366,390,2
0.4,0.5,21.41666667,9/8/2013,2013,1,23,23,away,-6,SFO,322,404,44,58,28,34,Loss,63,90,2,2,0,GBP,62,385,494,2
0.5,0.4,38.58333333,9/8/2013,2013,1,23,23,home,6,GBP,404,322,85,75,34,28,Win,90,63,2,2,2,SFO,62,494,385,0
0.545454545,0.333333333,22.83333333,9/8/2013,2013,1,21,22,away,-5,DAL,428,244,52,59,31,36,Loss,50,87,3,2,1,NYG,67,478,331,6
0.333333333,0.545454545,37.16666667,9/8/2013,2013,1,22,21,home,5,NYG,244,428,40,74,36,31,Win,87,50,2,3,6,DAL,67,331,478,1
0.466666667,0.2,32.65,9/9/2013,2013,1,26,25,away,6,WAS,180,308,65,77,33,27,Win,263,74,3,3,3,PHI,60,443,382,2
0.2,0.466666667,27.35,9/9/2013,2013,1,25,26,home,-6,PHI,308,180,75,70,27,33,Loss,74,263,3,3,2,WAS,60,382,443,3
0.461538462,0.5,36.51666667,9/9/2013,2013,1,26,14,away,3,LAC,329,183,73,75,31,28,Win,120,80,2,2,1,HOU,59,449,263,1
0.5,0.461538462,23.48333333,9/9/2013,2013,1,14,26,home,-3,HOU,183,329,55,51,28,31,Loss,80,120,2,2,1,LAC,59,263,449,1
0.333333333,0.222222222,34,9/12/2013,2013,2,15,9,away,-3,NEP,189,178,66,71,10,13,Loss,129,54,4,1,0,NYJ,23,318,232,4
0.222222222,0.333333333,26,9/12/2013,2013,2,9,15,home,3,NYJ,178,189,30,64,13,10,Win,54,129,1,4,4,NEP,23,232,318,0
0.272727273,0.307692308,31.78333333,9/15/2013,2013,2,20,19,away,-1,KCC,281,199,27,61,16,17,Loss,37,114,3,4,0,DAL,33,318,313,2
0.307692308,0.272727273,28.21666667,9/15/2013,2013,2,19,20,home,1,DAL,199,281,45,65,17,16,Win,114,37,4,3,2,KCC,33,313,318,0
0.4375,0.583333333,29.43333333,9/15/2013,2013,2,19,24,away,-1,CHI,227,284,25,64,30,31,Loss,123,127,1,1,4,MIN,61,350,411,3
0.583333333,0.4375,30.56666667,9/15/2013,2013,2,24,19,home,1,MIN,284,227,35,66,31,30,Win,127,123,1,1,3,CHI,61,411,350,4
0.4375,0.428571429,33.68333333,9/15/2013,2013,2,25,24,away,-1,BUF,183,287,30,76,23,24,Loss,125,149,6,1,2,CAR,47,308,436,1
0.428571429,0.4375,26.31666667,9/15/2013,2013,2,24,25,home,1,CAR,287,183,55,73,24,23,Win,149,125,1,6,1,BUF,47,436,308,2
0.266666667,0.5,29.41666667,9/15/2013,2013,2,13,19,away,-8,BAL,194,197,33,62,6,14,Loss,65,99,5,2,1,CLE,20,259,296,0
0.5,0.266666667,30.58333333,9/15/2013,2013,2,19,13,home,8,CLE,197,194,41,71,14,6,Win,99,65,2,5,0,BAL,20,296,259,1
0.272727273,0.4,27.51666667,9/15/2013,2013,2,18,28,away,-18,GBP,314,441,78,58,20,38,Loss,108,139,1,4,1,WAS,58,422,580,1
0.4,0.272727273,32.48333333,9/15/2013,2013,2,28,18,home,18,WAS,441,314,40,70,38,20,Win,139,108,4,1,1,GBP,58,580,422,1
0.666666667,0.454545455,40.28333333,9/15/2013,2013,2,33,22,away,3,PHI,413,411,32,79,33,30,Win,126,100,1,2,0,LAC,63,539,511,2
0.454545455,0.666666667,19.71666667,9/15/2013,2013,2,22,33,home,-3,LAC,411,413,77,58,30,33,Loss,100,126,2,1,2,PHI,63,511,539,0
0.25,0.352941176,31.23333333,9/15/2013,2013,2,14,25,away,-6,HOU,129,280,70,67,0,6,Loss,119,172,4,2,2,TEN,6,248,452,0
0.352941176,0.25,33.23333333,9/15/2013,2013,2,25,14,home,6,TEN,280,129,40,78,6,0,Win,172,119,2,4,0,HOU,6,452,248,2
0.411764706,0.538461538,29.71666667,9/15/2013,2013,2,24,19,away,-7,ATL,352,357,53,73,24,31,Loss,69,36,0,2,0,LAR,55,421,393,1
0.538461538,0.411764706,30.28333333,9/15/2013,2013,2,19,24,home,7,LAR,357,352,53,61,31,24,Win,36,69,2,0,1,ATL,55,393,421,0
0.428571429,0.466666667,29.43333333,9/15/2013,2013,2,21,23,away,4,IND,297,315,0,66,24,20,Win,101,133,5,3,1,MIA,44,398,448,1
0.466666667,0.428571429,30.56666667,9/15/2013,2013,2,23,21,home,-4,MIA,315,297,13,72,20,24,Loss,133,101,3,5,1,IND,44,448,398,1
0.357142857,0.384615385,32.6,9/15/2013,2013,2,21,14,away,2,TBB,296,113,35,70,16,14,Win,75,160,4,1,2,NOS,30,371,273,2
0.384615385,0.357142857,27.4,9/15/2013,2013,2,14,21,home,-2,NOS,113,296,118,56,14,16,Loss,160,75,1,4,2,TBB,30,273,371,2
0.272727273,0.090909091,28.68333333,9/15/2013,2013,2,16,24,away,-4,ARI,273,261,101,57,21,25,Loss,49,87,1,1,1,DET,46,322,348,1
0.090909091,0.272727273,31.31666667,9/15/2013,2013,2,24,16,home,4,DET,261,273,40,66,25,21,Win,87,49,1,1,1,ARI,46,348,322,1
0.533333333,0.090909091,28.03333333,9/15/2013,2013,2,23,28,away,18,NYG,307,353,132,72,41,23,Win,107,23,0,1,4,DEN,64,414,376,1
0.090909091,0.533333333,31.96666667,9/15/2013,2013,2,28,23,home,-18,DEN,353,307,16,69,23,41,Loss,23,107,1,0,1,NYG,64,376,414,4
0.411764706,0.285714286,28.2,9/15/2013,2013,2,15,16,away,-10,OAK,214,114,70,62,9,19,Loss,34,226,5,3,1,JAX,28,248,340,0
0.285714286,0.411764706,31.8,9/15/2013,2013,2,16,15,home,10,JAX,114,214,30,61,19,9,Win,226,34,3,5,0,OAK,28,340,248,1
0.25,0.3125,23.28333333,9/15/2013,2013,2,12,19,away,-26,SEA,107,118,121,51,3,29,Loss,100,172,3,4,1,SFO,32,207,290,5
0.3125,0.25,36.71666667,9/15/2013,2013,2,19,12,home,26,SFO,118,107,84,70,29,3,Win,172,100,4,3,5,SEA,32,290,207,1
0.25,0.411764706,24.43333333,9/16/2013,2013,2,14,22,away,-10,CIN,234,280,29,55,10,20,Loss,44,127,2,0,0,PIT,30,278,407,2
0.411764706,0.25,35.56666667,9/16/2013,2013,2,22,14,home,10,PIT,280,234,84,79,20,10,Win,127,44,0,2,2,CIN,30,407,278,0
0.315789474,0.3,39.11666667,9/19/2013,2013,3,19,21,away,10,PHI,248,167,65,78,26,16,Win,146,264,5,6,5,KCC,42,394,431,0
0.3,0.315789474,20.88333333,9/19/2013,2013,3,21,19,home,-10,KCC,167,248,45,63,16,26,Loss,264,146,6,5,0,PHI,42,431,394,5
0.307692308,0.363636364,31.85,9/22/2013,2013,3,27,19,away,-4,CIN,217,215,55,77,30,34,Loss,182,82,4,4,4,GBP,64,399,297,4
0.363636364,0.307692308,28.15,9/22/2013,2013,3,19,27,home,4,GBP,215,217,43,56,34,30,Win,82,182,4,4,4,CIN,64,297,399,4
0.307692308,0.461538462,28.8,9/22/2013,2013,3,24,27,away,7,WAS,378,300,71,66,27,20,Win,63,120,1,2,2,DET,47,441,420,1
0.461538462,0.307692308,31.2,9/22/2013,2013,3,27,24,home,-7,DET,300,378,45,74,20,27,Loss,120,63,2,1,1,WAS,47,420,441,2
0.357142857,0.4,26.98333333,9/22/2013,2013,3,18,21,away,-20,NEP,226,202,48,66,3,23,Loss,97,156,3,3,1,TBB,26,323,358,1
0.4,0.357142857,33.01666667,9/22/2013,2013,3,21,18,home,20,TBB,202,226,50,72,23,3,Win,156,97,3,3,1,NEP,26,358,323,1
0.25,0.571428571,23.21666667,9/22/2013,2013,3,10,27,away,-38,CAR,90,208,45,50,0,38,Loss,60,194,7,1,2,NYG,38,150,402,3
0.571428571,0.25,36.78333333,9/22/2013,2013,3,27,10,home,38,NYG,208,90,32,74,38,0,Win,194,60,1,7,3,CAR,38,402,150,2
0.25,0.5,30.6,9/22/2013,2013,3,18,16,away,-21,BAL,170,161,113,61,9,30,Loss,94,75,3,2,0,HOU,39,264,236,1
0.5,0.25,29.4,9/22/2013,2013,3,16,18,home,21,HOU,161,170,87,57,30,9,Win,75,94,2,3,1,BAL,39,236,264,0
0.4,0.470588235,28.86666667,9/22/2013,2013,3,23,21,away,4,MIN,306,195,47,75,31,27,Win,103,134,3,6,3,CLE,58,409,329,4
0.470588235,0.4,31.13333333,9/22/2013,2013,3,21,23,home,-4,CLE,195,306,35,79,27,31,Loss,134,103,6,3,4,MIN,58,329,409,3
0.384615385,0.538461538,24.48333333,9/22/2013,2013,3,16,27,away,-24,NOS,161,319,18,55,7,31,Loss,86,104,4,4,1,ARI,38,247,423,2
0.538461538,0.384615385,35.51666667,9/22/2013,2013,3,27,16,home,24,ARI,319,161,30,74,31,7,Win,104,86,4,4,2,NOS,38,423,247,1
0.076923077,0.454545455,26.53333333,9/22/2013,2013,3,17,21,away,-24,DAL,197,203,41,67,7,31,Loss,35,193,6,1,1,LAR,38,232,396,1
0.454545455,0.076923077,33.46666667,9/22/2013,2013,3,21,17,home,24,LAR,203,197,72,59,31,7,Win,193,35,1,6,1,DAL,38,396,232,1
0.333333333,0.428571429,28.36666667,9/22/2013,2013,3,19,23,away,-3,TEN,175,282,45,53,17,20,Loss,102,170,2,2,0,LAC,37,277,452,1
0.428571429,0.333333333,31.63333333,9/22/2013,2013,3,23,19,home,3,LAC,282,175,116,68,20,17,Win,170,102,2,2,1,TEN,37,452,277,0
0.454545455,0.583333333,37.15,9/22/2013,2013,3,24,16,away,-4,MIA,231,195,59,68,23,27,Loss,146,90,0,5,2,ATL,50,377,285,2
0.583333333,0.454545455,22.85,9/22/2013,2013,3,16,24,home,4,ATL,195,231,13,55,27,23,Win,90,146,5,0,2,MIA,50,285,377,2
0.285714286,0.4,27.41666667,9/22/2013,2013,3,17,28,away,-28,SEA,214,323,45,66,17,45,Loss,51,156,3,2,2,JAX,62,265,479,3
0.4,0.285714286,32.58333333,9/22/2013,2013,3,28,17,home,28,JAX,323,214,24,67,45,17,Win,156,51,2,3,3,SEA,62,479,265,2
0.416666667,0.25,36.41666667,9/22/2013,2013,3,23,14,away,20,SFO,152,139,10,67,27,7,Win,184,115,1,3,2,IND,34,336,254,0
0.25,0.416666667,23.58333333,9/22/2013,2013,3,14,23,home,-20,IND,139,152,48,53,7,27,Loss,115,184,3,1,0,SFO,34,254,336,2
0.222222222,0.357142857,25.78333333,9/22/2013,2013,3,18,20,away,-7,NYJ,208,331,87,75,20,27,Loss,120,182,8,0,2,BUF,47,328,513,0
0.357142857,0.222222222,34.21666667,9/22/2013,2013,3,20,18,home,7,BUF,331,208,168,70,27,20,Win,182,120,0,8,0,NYJ,47,513,328,2
0.333333333,0.272727273,31.6,9/22/2013,2013,3,15,21,away,17,PIT,151,379,25,60,40,23,Win,107,80,2,3,5,CHI,63,258,459,0
0.272727273,0.333333333,28.4,9/22/2013,2013,3,21,15,home,-17,CHI,379,151,59,65,23,40,Loss,80,107,3,2,0,PIT,63,459,258,5
0.416666667,0.555555556,24.6,9/23/2013,2013,3,13,31,away,-16,DEN,293,372,77,51,21,37,Loss,49,164,3,1,2,OAK,58,342,536,0
0.555555556,0.416666667,35.4,9/23/2013,2013,3,31,13,home,16,OAK,372,293,40,73,37,21,Win,164,49,1,3,0,DEN,58,536,342,2
0.4,0.176470588,31.75,9/26/2013,2013,4,19,14,away,24,LAR,151,170,85,65,35,11,Win,219,18,2,5,2,SFO,46,370,188,2
0.176470588,0.4,28.25,9/26/2013,2013,4,14,19,home,-24,SFO,170,151,82,65,11,35,Loss,18,219,5,2,2,LAR,46,188,370,2
0.1,0.388888889,25.91666667,9/29/2013,2013,4,17,20,away,3,TBB,240,173,90,59,13,10,Win,56,80,1,2,3,ARI,23,296,253,3
0.388888889,0.1,34.08333333,9/29/2013,2013,4,20,17,home,-3,ARI,173,240,73,76,10,13,Loss,80,56,2,1,3,TBB,23,253,296,3
0.1875,0.277777778,23.56666667,9/29/2013,2013,4,15,19,away,-3,BUF,321,147,59,63,20,23,Loss,24,203,4,2,3,BAL,43,345,350,5
0.277777778,0.1875,36.43333333,9/29/2013,2013,4,19,15,home,3,BAL,147,321,99,79,23,20,Win,203,24,2,4,5,BUF,43,350,345,3
0.285714286,0.5,28.85,9/29/2013,2013,4,16,18,away,-11,CLE,203,247,25,64,6,17,Loss,63,89,2,3,0,CIN,23,266,336,2
0.5,0.285714286,31.15,9/29/2013,2013,4,18,16,home,11,CIN,247,203,80,71,17,6,Win,89,63,3,2,2,CLE,23,336,266,0
0.214285714,0.352941176,31.8,9/29/2013,2013,4,15,29,away,3,HOU,91,325,62,58,3,0,Win,179,151,5,4,3,SEA,3,270,476,2
0.352941176,0.214285714,39.88333333,9/29/2013,2013,4,29,15,home,-3,SEA,325,91,86,88,0,3,Loss,151,179,4,5,2,HOU,3,476,270,3
0.076923077,0.2,28.18333333,9/29/2013,2013,4,18,23,away,-8,DET,286,228,30,66,32,40,Loss,131,159,3,1,3,CHI,72,417,387,4
0.2,0.076923077,31.81666667,9/29/2013,2013,4,23,18,home,8,CHI,228,286,25,66,40,32,Win,159,131,1,3,4,DET,72,387,417,3
0.461538462,0.181818182,36.63333333,9/29/2013,2013,4,26,14,away,34,JAX,280,165,58,70,37,3,Win,157,40,2,4,3,IND,40,437,205,1
0.181818182,0.461538462,23.36666667,9/29/2013,2013,4,14,26,home,-34,IND,165,280,65,54,3,37,Loss,40,157,4,2,1,JAX,40,205,437,3
0.071428571,0.5625,24.06666667,9/29/2013,2013,4,11,21,away,-24,KCC,200,288,65,61,7,31,Loss,98,102,3,1,3,NYG,38,298,390,3
0.5625,0.071428571,35.93333333,9/29/2013,2013,4,21,11,home,24,NYG,288,200,62,70,31,7,Win,102,98,1,3,3,KCC,38,390,298,3
0.533333333,0.363636364,36.45,9/29/2013,2013,4,29,16,away,-7,MIN,357,248,50,77,27,34,Loss,77,145,5,1,0,PIT,61,434,393,2
0.363636364,0.533333333,23.55,9/29/2013,2013,4,16,29,home,7,PIT,248,357,89,51,34,27,Win,145,77,1,5,2,MIN,61,393,434,0
0.307692308,0.555555556,29.36666667,9/29/2013,2013,4,16,17,away,-25,TEN,239,244,66,62,13,38,Loss,91,78,5,2,0,NYJ,51,330,322,4
0.555555556,0.307692308,30.63333333,9/29/2013,2013,4,17,16,home,25,NYJ,244,239,30,65,38,13,Win,78,91,2,5,4,TEN,51,322,330,0
0.5,0.625,26.63333333,9/29/2013,2013,4,21,35,away,-32,DEN,284,331,62,69,20,52,Loss,166,141,3,1,0,PHI,72,450,472,0
0.625,0.5,33.36666667,9/29/2013,2013,4,35,21,home,32,PHI,331,284,25,71,52,20,Win,141,166,1,3,0,DEN,72,472,450,0
0.3125,0.294117647,27.63333333,9/29/2013,2013,4,15,14,away,10,OAK,217,194,29,64,24,14,Win,122,104,1,7,3,WAS,38,339,298,1
0.294117647,0.3125,32.36666667,9/29/2013,2013,4,14,15,home,-10,WAS,194,217,25,65,14,24,Loss,104,122,7,1,1,OAK,38,298,339,3
0.333333333,0.416666667,25.95,9/29/2013,2013,4,21,27,away,-9,LAC,227,394,33,56,21,30,Loss,92,112,3,1,1,DAL,51,319,506,1
0.416666667,0.333333333,34.05,9/29/2013,2013,4,27,21,home,9,DAL,394,227,85,70,30,21,Win,112,92,1,3,1,LAC,51,506,319,1
0.538461538,0.428571429,30.65,9/29/2013,2013,4,21,26,away,7,ATL,316,399,93,62,30,23,Win,132,58,0,2,1,NEP,53,448,457,0
0.428571429,0.538461538,29.35,9/29/2013,2013,4,26,21,home,-7,NEP,399,316,55,71,23,30,Loss,58,132,2,0,0,ATL,53,457,448,1
0.333333333,0.461538462,26.18333333,9/30/2013,2013,4,19,23,away,-21,NOS,216,397,25,58,17,38,Loss,115,68,4,2,1,MIA,55,331,465,4
0.461538462,0.333333333,33.81666667,9/30/2013,2013,4,23,19,home,21,MIA,397,216,45,65,38,17,Win,68,115,2,4,4,NOS,55,465,331,1
0.3125,0.411764706,27.61666667,10/3/2013,2013,5,20,19,away,-13,CLE,188,199,56,75,24,37,Loss,155,91,4,5,0,BUF,61,343,290,1
0.411764706,0.3125,32.38333333,10/3/2013,2013,5,19,20,home,13,BUF,199,188,66,65,37,24,Win,91,155,5,4,1,CLE,61,290,343,0
0.25,0.421052632,24.68333333,10/6/2013,2013,5,16,22,away,-14,LAR,267,208,45,59,20,34,Loss,96,143,2,2,0,JAX,54,363,351,3
0.421052632,0.25,35.31666667,10/6/2013,2013,5,22,16,home,14,JAX,208,267,53,72,34,20,Win,143,96,2,2,3,LAR,54,351,363,0
0.083333333,0.4,25.73333333,10/6/2013,2013,5,15,21,away,-7,CIN,166,179,0,60,6,13,Loss,82,162,4,4,2,NEP,19,248,341,2
0.4,0.083333333,34.26666667,10/6/2013,2013,5,21,15,home,7,NEP,179,166,59,70,13,6,Win,162,82,4,4,2,CIN,19,341,248,2
0.083333333,0.285714286,31.28333333,10/6/2013,2013,5,20,19,away,9,TEN,233,234,61,67,26,17,Win,120,105,2,3,3,KCC,43,353,339,2
0.285714286,0.083333333,28.71666667,10/6/2013,2013,5,19,20,home,-9,KCC,234,233,35,66,17,26,Loss,105,120,3,2,2,TEN,43,339,353,3
0.473684211,0.384615385,32.11666667,10/6/2013,2013,5,28,21,away,15,NYG,299,330,88,77,36,21,Win,140,53,1,1,4,PHI,57,439,383,0
0.384615385,0.473684211,27.88333333,10/6/2013,2013,5,21,28,home,-15,PHI,330,299,136,70,21,36,Loss,53,140,1,1,0,NYG,57,383,439,4
0.375,0.4,36,10/6/2013,2013,5,17,20,away,8,CHI,283,340,10,65,26,18,Win,64,94,1,3,1,NOS,44,347,434,0
0.4,0.375,24,10/6/2013,2013,5,20,17,home,-8,NOS,340,283,43,54,18,26,Loss,94,64,3,1,0,CHI,44,434,347,1
0.375,0.1875,36.26666667,10/6/2013,2013,5,20,10,away,3,MIA,251,272,64,74,26,23,Win,133,22,2,6,0,BAL,49,384,294,2
0.1875,0.375,23.73333333,10/6/2013,2013,5,10,20,home,-3,BAL,272,251,65,57,23,26,Loss,22,133,6,2,2,MIA,49,294,384,0
0.166666667,0.583333333,31.36666667,10/6/2013,2013,5,21,20,away,-6,IND,205,208,85,67,28,34,Loss,218,109,2,2,2,SEA,62,423,317,2
0.583333333,0.166666667,28.63333333,10/6/2013,2013,5,20,21,home,6,SEA,208,205,35,60,34,28,Win,109,218,2,2,2,IND,62,317,423,2
0.466666667,0.4375,27.68333333,10/6/2013,2013,5,19,16,away,-13,GBP,222,269,50,64,9,22,Loss,64,180,5,1,0,DET,31,286,449,0
0.4375,0.466666667,32.31666667,10/6/2013,2013,5,16,19,home,13,DET,269,222,72,64,22,9,Win,180,64,1,5,0,GBP,31,449,286,0
0.416666667,0.333333333,31.06666667,10/6/2013,2013,5,21,19,away,-16,ARI,258,160,79,66,6,22,Loss,95,90,7,2,3,CAR,28,353,250,4
0.333333333,0.416666667,28.93333333,10/6/2013,2013,5,19,21,home,16,CAR,160,258,30,58,22,6,Win,90,95,2,7,4,ARI,28,250,353,3
0.692307692,0.666666667,32.56666667,10/6/2013,2013,5,34,24,away,3,DAL,414,470,55,73,51,48,Win,103,52,0,4,2,DEN,99,517,522,2
0.666666667,0.692307692,27.43333333,10/6/2013,2013,5,24,34,home,-3,DEN,470,414,81,54,48,51,Loss,52,103,4,0,2,DAL,99,522,517,2
0.375,0.363636364,33.86666667,10/6/2013,2013,5,17,17,away,-31,SFO,182,107,52,71,3,34,Loss,131,177,1,1,0,HOU,37,313,284,4
0.363636364,0.375,26.13333333,10/6/2013,2013,5,17,17,home,31,HOU,107,182,17,52,34,3,Win,177,131,1,1,4,SFO,37,284,313,0
0.363636364,0.333333333,30.91666667,10/6/2013,2013,5,27,17,away,-10,OAK,391,195,30,69,17,27,Loss,36,104,2,4,0,LAC,44,427,299,5
0.333333333,0.363636364,29.08333333,10/6/2013,2013,5,17,27,home,10,LAC,195,391,85,55,27,17,Win,104,36,4,2,5,OAK,44,299,427,0
0.545454545,0.5,24.55,10/7/2013,2013,5,15,26,away,2,ATL,170,299,24,46,30,28,Win,118,64,4,2,1,NYJ,58,288,363,0
0.5,0.545454545,35.45,10/7/2013,2013,5,26,15,home,-2,NYJ,299,170,46,70,28,30,Loss,64,118,2,4,0,ATL,58,363,288,1
0.636363636,0.454545455,27.08333333,10/10/2013,2013,6,21,26,away,-6,CHI,232,262,31,53,21,27,Loss,123,110,1,0,0,NYG,48,355,372,3
0.454545455,0.636363636,32.91666667,10/10/2013,2013,6,26,21,home,6,NYG,262,232,51,65,27,21,Win,110,123,0,1,3,CHI,48,372,355,0
0.571428571,0.357142857,33.48333333,10/13/2013,2013,6,24,23,away,14,CLE,248,269,65,72,31,17,Win,118,126,1,2,2,DET,48,366,395,1
0.357142857,0.571428571,26.51666667,10/13/2013,2013,6,23,24,home,-14,DET,269,248,87,66,17,31,Loss,126,118,2,1,1,CLE,48,395,366,2
0.352941176,0.142857143,31.36666667,10/13/2013,2013,6,15,15,away,2,BAL,298,313,55,65,19,17,Win,140,47,3,5,1,GBP,36,438,360,2
0.142857143,0.352941176,28.63333333,10/13/2013,2013,6,15,15,home,-2,GBP,313,298,40,61,17,19,Loss,47,140,5,3,2,BAL,36,360,438,1
0.388888889,0.470588235,42.86666667,10/13/2013,2013,6,26,20,away,3,BUF,318,192,78,84,3,0,Win,165,130,3,5,1,CIN,3,483,322,1
0.470588235,0.388888889,25.4,10/13/2013,2013,6,20,26,home,-3,CIN,192,318,27,69,0,3,Loss,130,165,5,3,1,BUF,3,322,483,1
0.428571429,0.428571429,24.83333333,10/13/2013,2013,6,15,27,away,25,HOU,117,267,74,41,38,13,Win,99,153,0,5,4,LAR,51,216,420,0
0.428571429,0.428571429,35.16666667,10/13/2013,2013,6,27,15,home,-25,LAR,267,117,95,73,13,38,Loss,153,99,5,0,0,HOU,51,420,216,4
0.266666667,0.285714286,34,10/13/2013,2013,6,18,16,away,-17,KCC,153,105,68,71,7,24,Loss,121,111,9,3,1,OAK,31,274,216,3
0.285714286,0.266666667,26,10/13/2013,2013,6,16,18,home,17,OAK,105,153,20,61,24,7,Win,111,121,3,9,3,KCC,31,216,274,1
0.583333333,0.428571429,36.45,10/13/2013,2013,6,22,17,away,25,MIN,236,215,40,66,35,10,Win,131,75,1,3,2,CAR,45,367,290,0
0.428571429,0.583333333,23.55,10/13/2013,2013,6,17,22,home,-25,CAR,215,236,55,60,10,35,Loss,75,131,3,1,0,MIN,45,290,367,2
0.375,0.272727273,35.81666667,10/13/2013,2013,6,16,18,away,13,NYJ,255,184,49,61,19,6,Win,73,83,4,3,2,PIT,25,328,267,0
0.272727273,0.375,24.18333333,10/13/2013,2013,6,18,16,home,-13,PIT,184,255,60,57,6,19,Loss,83,73,3,4,0,NYJ,25,267,328,2
0.5,0.4,26.23333333,10/13/2013,2013,6,21,19,away,11,TBB,287,257,31,65,31,20,Win,138,94,1,2,1,PHI,51,425,351,1
0.4,0.5,33.76666667,10/13/2013,2013,6,19,21,home,-11,PHI,257,287,72,66,20,31,Loss,94,138,2,1,1,TBB,51,351,425,1
0.357142857,0.538461538,31.25,10/13/2013,2013,6,20,26,away,-16,DEN,291,295,62,71,19,35,Loss,71,112,2,0,3,JAX,54,362,407,2
0.538461538,0.357142857,28.75,10/13/2013,2013,6,26,20,home,16,JAX,295,291,31,71,35,19,Win,112,71,0,2,2,DEN,54,407,362,3
0.333333333,0.384615385,26.63333333,10/13/2013,2013,6,13,24,away,-7,SEA,157,253,44,52,13,20,Loss,66,151,3,2,2,TEN,33,223,404,2
0.384615385,0.333333333,33.36666667,10/13/2013,2013,6,24,13,home,7,TEN,253,157,65,66,20,13,Win,151,66,2,3,2,SEA,33,404,223,2
0.384615385,0.285714286,25.68333333,10/13/2013,2013,6,16,20,away,-12,SFO,294,238,38,63,20,32,Loss,109,149,1,2,2,ARI,52,403,387,4
0.285714286,0.384615385,34.31666667,10/13/2013,2013,6,20,16,home,12,ARI,238,294,35,69,32,20,Win,149,109,2,1,4,SFO,52,387,403,2
0.357142857,0.333333333,28.15,10/13/2013,2013,6,20,26,away,-3,NEP,230,235,56,63,27,30,Loss,131,141,1,5,1,NOS,57,361,376,2
0.333333333,0.357142857,31.85,10/13/2013,2013,6,26,20,home,3,NOS,235,230,33,83,30,27,Win,141,131,5,1,2,NEP,57,376,361,1
0.5,0.416666667,34.53333333,10/13/2013,2013,6,25,18,away,-15,DAL,217,165,104,75,16,31,Loss,216,48,3,1,1,WAS,47,433,213,2
0.416666667,0.5,25.46666667,10/13/2013,2013,6,18,25,home,15,WAS,165,217,80,50,31,16,Win,48,216,1,3,2,DAL,47,213,433,1
0.2,0.5,21.48333333,10/14/2013,2013,6,12,24,away,-10,LAC,193,227,28,48,9,19,Loss,74,147,1,2,0,IND,28,267,374,1
0.5,0.2,38.51666667,10/14/2013,2013,6,24,12,home,10,IND,227,193,25,72,19,9,Win,147,74,2,1,1,LAC,28,374,267,0
0.583333333,0.333333333,27.66666667,10/17/2013,2013,7,21,22,away,12,ARI,209,204,70,64,34,22,Win,135,30,3,7,2,SEA,56,344,234,2
0.333333333,0.583333333,32.33333333,10/17/2013,2013,7,22,21,home,-12,SEA,204,209,22,70,22,34,Loss,30,135,7,3,2,ARI,56,234,344,2
0.473684211,0.230769231,30.2,10/20/2013,2013,7,15,19,away,2,MIA,178,173,53,66,23,21,Win,90,120,4,2,3,BUF,44,268,293,1
0.230769231,0.473684211,29.8,10/20/2013,2013,7,19,15,home,-2,BUF,173,178,32,64,21,23,Loss,120,90,2,4,1,MIA,44,293,268,3
0.083333333,0.523809524,23.66666667,10/20/2013,2013,7,21,27,away,-3,NYJ,205,206,100,70,0,3,Loss,90,177,4,4,1,NEP,3,295,383,1
0.523809524,0.083333333,46.21666667,10/20/2013,2013,7,27,21,home,3,NEP,206,205,45,89,3,0,Win,177,90,4,4,1,NYJ,3,383,295,1
0.3125,0.222222222,36.21666667,10/20/2013,2013,7,22,19,away,14,PHI,294,194,75,75,17,3,Win,74,84,2,3,3,DAL,20,368,278,2
0.222222222,0.3125,23.78333333,10/20/2013,2013,7,19,22,home,-14,DAL,194,294,33,75,3,17,Loss,84,74,3,2,2,PHI,20,278,368,3
0.25,0.538461538,26.06666667,10/20/2013,2013,7,21,28,away,-4,WAS,219,290,30,52,41,45,Loss,140,209,2,1,1,CHI,86,359,499,1
0.538461538,0.25,33.93333333,10/20/2013,2013,7,28,21,home,4,CHI,290,219,47,73,45,41,Win,209,140,1,2,1,WAS,86,499,359,1
0.583333333,0.272727273,37.5,10/20/2013,2013,7,27,18,away,18,JAX,276,275,61,67,24,6,Win,158,78,1,6,1,LAC,30,434,353,0
0.272727273,0.583333333,22.5,10/20/2013,2013,7,18,27,home,-18,LAC,275,276,45,59,6,24,Loss,78,158,6,1,0,JAX,30,353,434,1
0.294117647,0.333333333,37.81666667,10/20/2013,2013,7,23,15,away,-8,ATL,226,273,103,75,23,31,Loss,111,18,3,0,1,TBB,54,337,291,1
0.333333333,0.294117647,22.18333333,10/20/2013,2013,7,15,23,home,8,TBB,273,226,101,44,31,23,Win,18,111,0,3,1,ATL,54,291,337,1
0.4,0.684210526,25.48333333,10/20/2013,2013,7,18,22,away,3,DET,364,357,50,53,27,24,Win,57,77,1,0,0,CIN,51,421,434,0
0.684210526,0.4,34.51666667,10/20/2013,2013,7,22,18,home,-3,CIN,357,364,30,76,24,27,Loss,77,57,0,1,0,DET,51,434,421,0
0.307692308,0.222222222,26.66666667,10/20/2013,2013,7,15,21,away,-15,CAR,254,180,68,59,15,30,Loss,63,102,4,2,0,LAR,45,317,282,3
0.222222222,0.307692308,33.33333333,10/20/2013,2013,7,21,15,home,15,LAR,180,254,59,57,30,15,Win,102,63,2,4,3,CAR,45,282,317,0
0.5,0.357142857,35.76666667,10/20/2013,2013,7,19,15,away,14,TEN,196,298,42,64,31,17,Win,153,70,2,3,2,SFO,48,349,368,0
0.357142857,0.5,24.23333333,10/20/2013,2013,7,15,19,home,-14,SFO,298,196,100,57,17,31,Loss,70,153,3,2,0,TEN,48,368,349,2
0.333333333,0.466666667,27.8,10/20/2013,2013,7,14,20,away,-1,KCC,221,231,40,54,16,17,Loss,73,126,5,2,2,HOU,33,294,357,1
0.466666667,0.333333333,32.2,10/20/2013,2013,7,20,14,home,1,HOU,231,221,24,68,17,16,Win,126,73,2,5,1,KCC,33,357,294,2
0.388888889,0.538461538,26.63333333,10/20/2013,2013,7,17,26,away,-18,GBP,133,253,106,68,13,31,Loss,83,104,3,1,0,CLE,44,216,357,1
0.538461538,0.388888889,33.36666667,10/20/2013,2013,7,26,17,home,18,CLE,253,133,97,66,31,13,Win,104,83,1,3,1,GBP,44,357,216,0
0.5,0.583333333,28.98333333,10/20/2013,2013,7,19,17,away,-3,PIT,205,145,67,61,16,19,Loss,82,141,1,3,1,BAL,35,287,286,0
0.583333333,0.5,31.01666667,10/20/2013,2013,7,17,19,home,3,BAL,145,205,50,55,19,16,Win,141,82,3,1,0,PIT,35,286,287,1
0.3125,0.294117647,28.21666667,10/20/2013,2013,7,23,19,away,-6,IND,365,213,103,73,33,39,Loss,64,121,4,2,1,DEN,72,429,334,3
0.294117647,0.3125,31.78333333,10/20/2013,2013,7,19,23,home,6,DEN,213,365,52,71,39,33,Win,121,64,2,4,3,IND,72,334,429,1
0.388888889,0.368421053,23.63333333,10/21/2013,2013,7,13,17,away,-16,NYG,176,193,38,68,7,23,Loss,30,64,1,2,1,MIN,30,206,257,3
0.368421053,0.388888889,36.36666667,10/21/2013,2013,7,17,13,home,16,MIN,193,176,72,73,23,7,Win,64,30,2,1,3,NYG,30,257,206,1
0.416666667,0.285714286,34.55,10/24/2013,2013,8,21,19,away,18,TBB,195,249,59,62,31,13,Win,129,48,3,3,1,CAR,44,324,297,0
0.285714286,0.416666667,25.45,10/24/2013,2013,8,19,21,home,-18,CAR,249,195,21,68,13,31,Loss,48,129,3,3,0,TBB,44,297,324,1
0.470588235,0.2,34.98333333,10/27/2013,2013,8,23,19,away,-10,NEP,145,100,61,79,17,27,Loss,156,152,6,3,1,MIA,44,301,252,3
0.2,0.470588235,25.01666667,10/27/2013,2013,8,19,23,home,10,MIA,100,145,35,62,27,17,Win,152,156,3,6,3,NEP,44,252,301,1
0.25,0.526315789,23.91666667,10/27/2013,2013,8,13,20,away,-6,KCC,283,195,70,52,17,23,Loss,57,136,1,6,0,CLE,40,340,331,1
0.526315789,0.25,36.08333333,10/27/2013,2013,8,20,13,home,6,CLE,195,283,31,71,23,17,Win,136,57,6,1,1,KCC,40,331,340,0
0.666666667,0.285714286,28.48333333,10/27/2013,2013,8,25,20,away,32,JAX,177,228,35,55,42,10,Win,221,90,0,0,1,SFO,52,398,318,1
0.285714286,0.666666667,31.51666667,10/27/2013,2013,8,20,25,home,-32,SFO,228,177,76,70,10,42,Loss,90,221,0,0,1,JAX,52,318,398,1
0.421052632,0.25,38.08333333,10/27/2013,2013,8,16,15,away,8,PHI,237,152,92,71,15,7,Win,88,48,1,4,3,NYG,22,325,200,1
0.25,0.421052632,21.91666667,10/27/2013,2013,8,15,16,home,-8,NYG,152,237,48,58,7,15,Loss,48,88,4,1,1,PHI,22,200,325,3
0.230769231,0.272727273,24.81666667,10/27/2013,2013,8,13,29,away,-1,DET,206,480,31,56,30,31,Loss,62,143,0,1,4,DAL,61,268,623,0
0.272727273,0.230769231,35.18333333,10/27/2013,2013,8,29,13,home,1,DAL,480,206,61,78,31,30,Win,143,62,1,0,0,DET,61,623,268,4
0.384615385,0.466666667,27.5,10/27/2013,2013,8,20,21,away,-18,NOS,211,309,45,68,17,35,Loss,88,77,4,4,0,BUF,52,299,386,3
0.466666667,0.384615385,32.5,10/27/2013,2013,8,21,20,home,18,BUF,309,211,59,64,35,17,Win,77,88,4,4,3,NOS,52,386,299,0
0.4,0.545454545,33.28333333,10/27/2013,2013,8,15,20,away,-40,CIN,147,323,69,65,9,49,Loss,93,79,4,1,1,NYJ,58,240,402,2
0.545454545,0.4,26.71666667,10/27/2013,2013,8,20,15,home,40,NYJ,323,147,45,56,49,9,Win,79,93,1,4,2,CIN,58,402,240,1
0.266666667,0.357142857,29.98333333,10/27/2013,2013,8,20,13,away,-3,OAK,241,82,12,69,18,21,Loss,35,197,5,2,3,PIT,39,276,279,2
0.357142857,0.266666667,30.01666667,10/27/2013,2013,8,13,20,home,3,PIT,82,241,39,59,21,18,Win,197,35,2,5,2,OAK,39,279,276,3
0.428571429,0.333333333,28,10/27/2013,2013,8,22,29,away,-24,DEN,154,339,5,70,21,45,Loss,112,107,3,2,4,WAS,66,266,446,5
0.333333333,0.428571429,32,10/27/2013,2013,8,29,22,home,24,WAS,339,154,57,80,45,21,Win,107,112,2,3,5,DEN,66,446,266,4
0.4,0.3,34.31666667,10/27/2013,2013,8,20,17,away,-14,ARI,265,147,55,79,13,27,Loss,27,201,4,3,1,ATL,40,292,348,4
0.3,0.4,25.68333333,10/27/2013,2013,8,17,20,home,14,ATL,147,265,52,51,27,13,Win,201,27,3,4,4,ARI,40,348,292,1
0.722222222,0.25,40.9,10/27/2013,2013,8,26,15,away,13,MIN,282,132,120,73,44,31,Win,182,111,2,3,0,GBP,75,464,243,0
0.25,0.722222222,19.1,10/27/2013,2013,8,15,26,home,-13,GBP,132,282,46,43,31,44,Loss,111,182,3,2,0,MIN,75,243,464,0
0.181818182,0.357142857,21.85,10/28/2013,2013,8,7,23,away,5,LAR,91,139,83,40,14,9,Win,44,200,7,3,2,SEA,23,135,339,0
0.357142857,0.181818182,38.15,10/28/2013,2013,8,23,7,home,-5,SEA,139,91,53,71,9,14,Loss,200,44,3,7,0,LAR,23,339,135,2
0.5,0.214285714,40.03333333,10/31/2013,2013,9,28,15,away,-2,MIA,302,188,63,93,0,2,Loss,163,157,5,3,1,CIN,2,465,345,4
0.214285714,0.5,28.33333333,10/31/2013,2013,9,15,28,home,2,CIN,188,302,25,61,2,0,Win,157,163,3,5,4,MIA,2,345,465,1
0.230769231,0.307692308,29.76666667,11/3/2013,2013,9,15,25,away,10,BUF,115,229,38,54,23,13,Win,95,241,2,0,3,KCC,36,210,470,0
0.307692308,0.230769231,30.23333333,11/3/2013,2013,9,25,15,home,-10,KCC,229,115,48,77,13,23,Loss,241,95,0,2,0,BUF,36,470,210,3
0.583333333,0.384615385,27.15,11/3/2013,2013,9,22,21,away,7,LAR,165,203,30,61,28,21,Win,198,160,4,2,2,TEN,49,363,363,2
0.384615385,0.583333333,32.85,11/3/2013,2013,9,21,22,home,-7,TEN,203,165,44,69,21,28,Loss,160,198,2,4,2,LAR,49,363,363,2
0.272727273,0.285714286,29.53333333,11/3/2013,2013,9,23,14,away,-6,NYJ,366,140,59,66,20,26,Loss,41,198,2,2,0,NOS,46,407,338,2
0.285714286,0.272727273,30.46666667,11/3/2013,2013,9,14,23,home,6,NOS,140,366,62,58,26,20,Win,198,41,2,2,2,NYJ,46,338,407,0
0.384615385,0.357142857,31.45,11/3/2013,2013,9,22,20,away,-4,DAL,224,314,35,68,23,27,Loss,169,36,2,3,1,MIN,50,393,350,2
0.357142857,0.384615385,28.55,11/3/2013,2013,9,20,22,home,4,MIN,314,224,45,63,27,23,Win,36,169,3,2,2,DAL,50,350,393,1
0.4,0.571428571,23.48333333,11/3/2013,2013,9,12,27,away,-24,CAR,211,242,59,48,10,34,Loss,78,131,1,1,2,ATL,44,289,373,4
0.571428571,0.4,36.51666667,11/3/2013,2013,9,27,12,home,24,ATL,242,211,15,71,34,10,Win,131,78,1,1,4,CAR,44,373,289,2
0.333333333,0.705882353,25.96666667,11/3/2013,2013,9,25,27,away,-6,WAS,341,291,63,63,0,6,Loss,69,209,1,0,1,LAC,6,410,500,2
0.705882353,0.333333333,40.05,11/3/2013,2013,9,27,25,home,6,LAC,291,341,65,72,6,0,Win,209,69,0,1,2,WAS,6,500,410,1
0.533333333,0.666666667,36.61666667,11/3/2013,2013,9,24,26,away,-3,SEA,145,217,99,65,0,3,Loss,205,198,3,0,3,TBB,3,350,415,0
0.666666667,0.533333333,30.2,11/3/2013,2013,9,26,24,home,3,TBB,217,145,67,61,3,0,Win,198,205,0,3,0,SEA,3,415,350,3
0.4,0.333333333,22.1,11/3/2013,2013,9,21,29,away,29,OAK,418,350,52,57,49,20,Win,124,210,1,3,2,PHI,69,542,560,0
0.333333333,0.4,37.9,11/3/2013,2013,9,29,21,home,-29,PHI,350,418,70,92,20,49,Loss,210,124,3,1,0,OAK,69,560,542,2
0.384615385,0.583333333,31.2,11/3/2013,2013,9,24,33,away,-24,NEP,371,413,96,73,31,55,Loss,108,197,5,3,1,PIT,86,479,610,3
0.583333333,0.384615385,28.8,11/3/2013,2013,9,33,24,home,24,PIT,413,371,30,71,55,31,Win,197,108,3,5,3,NEP,86,610,479,1
0.4375,0.266666667,29.16666667,11/3/2013,2013,9,18,19,away,-6,CLE,223,242,80,67,18,24,Loss,55,73,5,2,1,BAL,42,278,315,2
0.266666667,0.4375,30.83333333,11/3/2013,2013,9,19,18,home,6,BAL,242,223,55,68,24,18,Win,73,55,2,5,2,CLE,42,315,278,1
0.307692308,0.428571429,23.8,11/3/2013,2013,9,17,22,away,3,HOU,245,340,15,58,27,24,Win,69,143,4,1,0,IND,51,314,483,0
0.428571429,0.307692308,36.2,11/3/2013,2013,9,22,17,home,-3,IND,340,245,86,68,24,27,Loss,143,69,1,4,0,HOU,51,483,314,0
0.428571429,0.111111111,33.15,11/4/2013,2013,9,25,17,away,7,GBP,271,113,45,75,27,20,Win,171,199,1,5,1,CHI,47,442,312,0
0.111111111,0.428571429,26.85,11/4/2013,2013,9,17,25,home,-7,CHI,113,271,0,55,20,27,Loss,199,171,5,1,0,GBP,47,312,442,1
0.5625,0.6,36.01666667,11/7/2013,2013,10,27,22,away,-7,MIN,242,216,63,77,27,34,Loss,191,91,4,1,1,WAS,61,433,307,0
0.6,0.5625,23.98333333,11/7/2013,2013,10,22,27,home,7,WAS,216,242,7,52,34,27,Win,91,191,1,4,0,MIN,61,307,433,1
0.363636364,0.4375,25.6,11/10/2013,2013,10,19,23,away,14,GBP,211,297,65,58,27,13,Win,204,99,3,1,2,PHI,40,415,396,1
0.4375,0.363636364,34.4,11/10/2013,2013,10,23,19,home,-14,PHI,297,211,31,75,13,27,Loss,99,204,1,3,1,GBP,40,396,415,2
0.416666667,0.411764706,28.41666667,11/10/2013,2013,10,21,19,away,2,CHI,219,300,51,61,21,19,Win,145,38,0,2,1,DET,40,364,338,1
0.411764706,0.416666667,31.58333333,11/10/2013,2013,10,19,21,home,-2,DET,300,219,39,71,19,21,Loss,38,145,2,0,1,CHI,40,338,364,1
0.214285714,0.470588235,24.73333333,11/10/2013,2013,10,16,19,away,-13,PIT,132,164,28,64,10,23,Loss,95,136,3,4,1,BUF,33,227,300,1
0.470588235,0.214285714,35.26666667,11/10/2013,2013,10,19,16,home,13,BUF,164,132,42,67,23,10,Win,136,95,4,3,1,PIT,33,300,227,1
0.263157895,0.1875,37.96666667,11/10/2013,2013,10,21,18,away,-3,BAL,244,104,134,87,0,3,Loss,120,85,5,5,3,CIN,3,364,189,3
0.1875,0.263157895,31.58333333,11/10/2013,2013,10,18,21,home,3,CIN,104,244,65,71,3,0,Win,85,120,5,5,3,BAL,3,189,364,3
0.25,0.555555556,29.4,11/10/2013,2013,10,13,19,away,2,TEN,160,279,19,56,29,27,Win,54,83,3,1,4,JAX,56,214,362,2
0.555555556,0.25,30.6,11/10/2013,2013,10,19,13,home,-2,JAX,279,160,45,70,27,29,Loss,83,54,1,3,2,TEN,56,362,214,4
0.166666667,0.5,27.96666667,11/10/2013,2013,10,12,19,away,-4,NYG,106,118,65,55,20,24,Loss,107,133,4,3,3,OAK,44,213,251,2
0.5,0.166666667,32.03333333,11/10/2013,2013,10,19,12,home,4,OAK,118,106,5,63,24,20,Win,133,107,3,4,2,NYG,44,251,213,3
0.6,0.333333333,35.5,11/10/2013,2013,10,25,16,away,23,ATL,279,162,80,69,33,10,Win,211,64,1,2,1,SEA,43,490,226,0
0.333333333,0.6,24.5,11/10/2013,2013,10,16,25,home,-23,SEA,162,279,15,54,10,33,Loss,64,211,2,1,0,ATL,43,226,490,1
0.466666667,0.166666667,30.63333333,11/10/2013,2013,10,12,21,away,30,IND,232,388,46,55,38,8,Win,140,18,2,3,5,LAR,46,372,406,1
0.166666667,0.466666667,29.36666667,11/10/2013,2013,10,21,12,home,-30,LAR,388,232,20,69,8,38,Loss,18,140,3,2,1,IND,46,406,372,5
0.411764706,0.153846154,32.05,11/10/2013,2013,10,15,10,away,1,SFO,141,46,25,66,10,9,Win,109,105,3,6,2,CAR,19,250,151,2
0.153846154,0.411764706,27.95,11/10/2013,2013,10,10,15,home,-1,CAR,46,141,25,52,9,10,Loss,105,109,6,3,2,SFO,19,151,250,2
0.375,0.4375,21.95,11/10/2013,2013,10,22,20,away,8,LAC,313,198,28,60,28,20,Win,84,131,2,4,0,DEN,48,397,329,1
0.4375,0.375,38.05,11/10/2013,2013,10,20,22,home,-8,DEN,198,313,40,68,20,28,Loss,131,84,4,2,1,LAC,48,329,397,0
0.375,0.3,28.86666667,11/10/2013,2013,10,17,19,away,-3,ARI,159,235,53,67,24,27,Loss,76,97,3,1,3,HOU,51,235,332,1
0.3,0.375,31.13333333,11/10/2013,2013,10,19,17,home,3,HOU,235,159,29,62,27,24,Win,97,76,1,3,1,ARI,51,332,235,3
0,0.75,20.46666667,11/10/2013,2013,10,9,40,away,-32,NOS,104,383,82,43,17,49,Loss,89,242,3,1,1,DAL,66,193,625,0
0.75,0,39.53333333,11/10/2013,2013,10,40,9,home,32,DAL,383,104,44,80,49,17,Win,242,89,1,3,0,NOS,66,625,193,1
0.333333333,0.25,25.2,11/11/2013,2013,10,16,18,away,-3,TBB,211,124,70,58,19,22,Loss,2,140,2,2,1,MIA,41,213,264,1
0.25,0.333333333,34.8,11/11/2013,2013,10,18,16,home,3,MIA,124,211,70,60,22,19,Win,140,2,2,2,1,TBB,41,264,213,1
0.461538462,0.545454545,32.38333333,11/14/2013,2013,11,24,20,away,3,TEN,229,218,51,69,30,27,Win,137,122,1,2,1,IND,57,366,340,0
0.545454545,0.461538462,27.61666667,11/14/2013,2013,11,20,24,home,-3,IND,218,229,34,54,27,30,Loss,122,137,2,1,0,TEN,57,340,366,1
0.470588235,0.307692308,33.7,11/17/2013,2013,11,23,22,away,-8,PHI,236,276,39,77,16,24,Loss,191,126,4,3,0,WAS,40,427,402,2
0.307692308,0.470588235,26.3,11/17/2013,2013,11,22,23,home,8,WAS,276,236,68,62,24,16,Win,126,191,3,4,2,PHI,40,402,427,0
0.444444444,0.384615385,35.68333333,11/17/2013,2013,11,23,18,away,-3,CHI,143,215,46,75,0,3,Loss,174,104,3,2,0,BAL,3,317,319,2
0.384615385,0.444444444,30.63333333,11/17/2013,2013,11,18,23,home,3,BAL,215,143,111,59,3,0,Win,104,174,2,3,2,CHI,3,319,317,0
0.375,0.375,27.73333333,11/17/2013,2013,11,21,24,away,-10,PIT,344,358,45,73,27,37,Loss,107,40,2,1,0,DET,64,451,398,3
0.375,0.375,32.26666667,11/17/2013,2013,11,24,21,home,10,DET,358,344,23,73,37,27,Win,40,107,1,2,3,PIT,64,398,451,0
0.142857143,0.272727273,26.76666667,11/17/2013,2013,11,24,24,away,-13,TBB,268,224,45,66,28,41,Loss,152,186,3,2,0,ATL,69,420,410,3
0.272727273,0.142857143,33.23333333,11/17/2013,2013,11,24,24,home,13,ATL,224,268,121,65,41,28,Win,186,152,2,3,3,TBB,69,410,420,0
0.181818182,0.421052632,26.3,11/17/2013,2013,11,12,14,away,-23,BUF,133,245,24,56,14,37,Loss,134,68,4,1,0,NYJ,51,267,313,4
0.421052632,0.181818182,33.7,11/17/2013,2013,11,14,12,home,23,NYJ,245,133,64,67,37,14,Win,68,134,1,4,4,BUF,51,313,267,0
0.3125,0.142857143,35.88333333,11/17/2013,2013,11,19,14,away,13,JAX,402,242,42,69,27,14,Win,14,32,3,2,2,ARI,41,416,274,0
0.142857143,0.3125,24.11666667,11/17/2013,2013,11,14,19,home,-13,ARI,242,402,40,60,14,27,Loss,32,14,2,3,0,JAX,41,274,416,2
0.277777778,0.125,31.51666667,11/17/2013,2013,11,12,14,away,5,HOU,176,304,77,65,28,23,Win,165,90,2,2,2,OAK,51,341,394,0
0.125,0.277777778,28.48333333,11/17/2013,2013,11,14,12,home,-5,OAK,304,176,50,72,23,28,Loss,90,165,2,2,0,HOU,51,394,341,2
0.222222222,0.071428571,32.4,11/17/2013,2013,11,15,10,away,-21,CIN,228,118,40,79,20,41,Loss,102,106,4,0,2,CLE,61,330,224,4
0.071428571,0.222222222,27.6,11/17/2013,2013,11,10,15,home,21,CLE,118,228,64,59,41,20,Win,106,102,0,4,4,CIN,61,224,330,2
0.363636364,0.2,31.4,11/17/2013,2013,11,22,21,away,-4,MIA,281,239,76,63,16,20,Loss,154,104,3,4,1,LAC,36,435,343,1
0.2,0.363636364,28.6,11/17/2013,2013,11,21,22,home,4,LAC,239,281,15,58,20,16,Win,104,154,4,3,1,MIA,36,343,435,1
0.4,0.428571429,25.35,11/17/2013,2013,11,12,23,away,-3,NOS,115,295,45,56,20,23,Loss,81,92,3,1,3,SFO,43,196,387,1
0.428571429,0.4,34.65,11/17/2013,2013,11,23,12,home,3,SFO,295,115,48,67,23,20,Win,92,81,1,3,1,NOS,43,387,196,3
0.357142857,0.363636364,34.15,11/17/2013,2013,11,19,16,away,-21,SEA,204,230,20,70,20,41,Loss,132,93,2,1,0,MIN,61,336,323,4
0.363636364,0.357142857,25.85,11/17/2013,2013,11,16,19,home,21,MIN,230,204,96,50,41,20,Win,93,132,1,2,4,SEA,61,323,336,0
0.25,0.285714286,24.76666667,11/17/2013,2013,11,16,19,away,-14,NYG,339,256,38,54,13,27,Loss,55,78,0,4,1,GBP,40,394,334,3
0.285714286,0.25,35.23333333,11/17/2013,2013,11,19,16,home,14,GBP,256,339,30,63,27,13,Win,78,55,4,0,3,NYG,40,334,394,1
0.307692308,0.375,30.11666667,11/17/2013,2013,11,24,24,away,-10,DEN,200,323,53,73,17,27,Loss,144,104,3,0,1,KCC,44,344,427,1
0.375,0.307692308,29.88333333,11/17/2013,2013,11,24,24,home,10,KCC,323,200,82,76,27,17,Win,104,144,0,3,1,DEN,44,427,344,1
0.5,0.727272727,30.76666667,11/18/2013,2013,11,28,20,away,-4,CAR,283,197,50,67,20,24,Loss,107,103,2,3,0,NEP,44,390,300,2
0.727272727,0.5,29.23333333,11/18/2013,2013,11,20,28,home,4,NEP,197,283,47,54,24,20,Win,103,107,3,2,2,CAR,44,300,390,0
0.538461538,0.5,26.23333333,11/21/2013,2013,12,19,22,away,4,ATL,271,264,66,59,17,13,Win,103,91,1,5,1,NOS,30,374,355,0
0.5,0.538461538,33.76666667,11/21/2013,2013,12,22,19,home,-4,NOS,264,271,25,66,13,17,Loss,91,103,5,1,0,ATL,30,355,374,1
0.375,0.1875,40.55,11/24/2013,2013,12,28,30,away,0,GBP,215,298,53,79,3,3,Tie,232,196,6,2,0,MIN,6,447,494,1
0.1875,0.375,34.45,11/24/2013,2013,12,30,28,home,0,MIN,298,215,50,89,3,3,Tie,196,232,2,6,1,GBP,6,494,447,0
0.285714286,0.533333333,26.63333333,11/24/2013,2013,12,10,25,away,3,DET,207,286,67,49,24,21,Win,22,104,4,2,5,TBB,45,229,390,0
0.533333333,0.285714286,33.36666667,11/24/2013,2013,12,25,10,home,-3,TBB,286,207,39,72,21,24,Loss,104,22,2,4,0,DET,45,390,229,5
0.352941176,0.25,30.2,11/24/2013,2013,12,20,13,away,4,MIA,159,280,56,69,20,16,Win,136,52,3,3,1,CAR,36,295,332,1
0.25,0.352941176,29.8,11/24/2013,2013,12,13,20,home,-4,CAR,280,159,55,62,16,20,Loss,52,136,3,3,1,MIA,36,332,295,1
0.285714286,0.352941176,33.65,11/24/2013,2013,12,19,19,away,16,CLE,217,312,8,68,27,11,Win,85,55,0,5,4,PIT,38,302,367,0
0.352941176,0.285714286,26.35,11/24/2013,2013,12,19,19,home,-16,PIT,312,217,10,73,11,27,Loss,55,85,5,0,0,CLE,38,367,302,4
0.6,0.4,36.15,11/24/2013,2013,12,30,20,away,-21,LAR,344,148,84,74,21,42,Loss,80,258,1,2,0,CHI,63,424,406,3
0.4,0.6,23.85,11/24/2013,2013,12,20,30,home,21,CHI,148,344,39,53,42,21,Win,258,80,2,1,3,LAR,63,406,424,0
0.466666667,0.333333333,30.95,11/24/2013,2013,12,24,26,away,3,KCC,387,281,97,67,41,38,Win,104,114,1,3,2,LAC,79,491,395,0
0.333333333,0.466666667,29.05,11/24/2013,2013,12,26,24,home,-3,LAC,281,387,62,59,38,41,Loss,114,104,3,1,0,KCC,79,395,491,2
0.083333333,0.230769231,25.91666667,11/24/2013,2013,12,12,15,away,-16,BAL,118,245,56,55,3,19,Loss,102,67,3,4,1,NYJ,22,220,312,3
0.230769231,0.083333333,34.08333333,11/24/2013,2013,12,15,12,home,16,NYJ,245,118,41,62,19,3,Win,67,102,4,3,3,BAL,22,312,220,1
0.411764706,0.266666667,33.68333333,11/24/2013,2013,12,16,11,away,7,HOU,215,141,63,65,13,6,Win,118,77,4,2,1,JAX,19,333,218,0
0.266666667,0.411764706,26.31666667,11/24/2013,2013,12,11,16,home,-7,JAX,141,215,22,57,6,13,Loss,77,118,2,4,0,HOU,19,218,333,1
0.555555556,0.3,35.8,11/24/2013,2013,12,22,19,away,4,OAK,312,260,100,73,23,19,Win,114,93,2,0,2,TEN,42,426,353,0
0.3,0.555555556,24.2,11/24/2013,2013,12,19,22,home,-4,TEN,260,312,50,55,19,23,Loss,93,114,0,2,0,OAK,42,353,426,2
0.384615385,0.5,23.18333333,11/24/2013,2013,12,15,27,away,-29,ARI,159,290,89,55,11,40,Loss,80,120,1,3,0,IND,51,239,410,1
0.5,0.384615385,36.81666667,11/24/2013,2013,12,27,15,home,29,IND,290,159,84,71,40,11,Win,120,80,3,1,1,ARI,51,410,239,0
0.363636364,0.25,29.35,11/24/2013,2013,12,24,22,away,3,NYG,204,154,85,62,24,21,Win,107,202,4,2,1,DAL,45,311,356,1
0.25,0.363636364,30.65,11/24/2013,2013,12,22,24,home,-3,DAL,154,204,81,62,21,24,Loss,202,107,2,4,1,NYG,45,356,311,1
0.5,0.428571429,38.96666667,11/24/2013,2013,12,28,27,away,-3,NEP,132,324,85,86,0,3,Loss,280,116,2,3,3,DEN,3,412,440,4
0.428571429,0.5,34.1,11/24/2013,2013,12,27,28,home,3,DEN,324,132,36,84,3,0,Win,116,280,3,2,4,NEP,3,440,412,3
0.285714286,0.266666667,31.43333333,11/25/2013,2013,12,15,10,away,21,WAS,228,76,25,59,27,6,Win,76,114,2,6,1,SFO,33,304,190,1
0.266666667,0.285714286,28.56666667,11/25/2013,2013,12,10,15,home,-21,SFO,76,228,30,58,6,27,Loss,114,76,6,2,1,WAS,33,190,304,1
0.2,0.75,19.56666667,11/28/2013,2013,13,7,30,away,-30,DET,102,320,25,42,10,40,Loss,24,241,7,1,4,GBP,50,126,561,3
0.75,0.2,40.43333333,11/28/2013,2013,13,30,7,home,30,GBP,320,102,50,79,40,10,Win,241,24,1,7,3,DET,50,561,126,4
0.538461538,0.538461538,27.68333333,11/28/2013,2013,13,16,23,away,-7,DAL,255,208,71,55,24,31,Loss,50,144,0,2,1,OAK,55,305,352,2
0.538461538,0.538461538,32.31666667,11/28/2013,2013,13,23,16,home,7,OAK,208,255,40,64,31,24,Win,144,50,2,0,2,DAL,55,352,305,1
0.538461538,0.588235294,30.06666667,11/28/2013,2013,13,22,16,away,-2,BAL,257,237,51,62,20,22,Loss,72,74,0,2,0,PIT,42,329,311,0
0.588235294,0.538461538,29.93333333,11/28/2013,2013,13,16,22,home,2,PIT,237,257,55,62,22,20,Win,74,72,2,0,0,BAL,42,311,329,0
0.4,0.214285714,33.91666667,12/1/2013,2013,13,24,18,away,-8,IND,185,160,74,74,14,22,Loss,162,104,1,5,1,TEN,36,347,264,4
0.214285714,0.4,26.08333333,12/1/2013,2013,13,18,24,home,8,TEN,160,185,50,62,22,14,Win,104,162,5,1,4,IND,36,264,347,1
0.4375,0.166666667,38.86666667,12/1/2013,2013,13,25,10,away,20,NYJ,328,78,28,80,23,3,Win,125,99,1,4,3,MIA,26,453,177,1
0.166666667,0.4375,21.13333333,12/1/2013,2013,13,10,25,home,-20,MIA,78,328,25,54,3,23,Loss,99,125,4,1,1,NYJ,26,177,453,3
0.1,0.384615385,25.58333333,12/1/2013,2013,13,10,20,away,-21,CAR,140,263,30,46,6,27,Loss,66,163,5,0,2,TBB,33,206,426,2
0.384615385,0.1,34.41666667,12/1/2013,2013,13,20,10,home,21,TBB,263,140,25,63,27,6,Win,163,66,0,5,2,CAR,33,426,206,2
0.333333333,0.3125,30.65,12/1/2013,2013,13,24,23,away,-3,PHI,260,202,55,68,21,24,Loss,90,105,5,5,0,ARI,45,350,307,3
0.3125,0.333333333,29.35,12/1/2013,2013,13,23,24,home,3,ARI,202,260,48,73,24,21,Win,105,90,5,5,3,PHI,45,307,350,0
0.4375,0.461538462,30.6,12/1/2013,2013,13,22,24,away,4,CLE,202,342,35,72,32,28,Win,112,97,2,3,3,JAX,60,314,439,1
0.461538462,0.4375,29.4,12/1/2013,2013,13,24,22,home,-4,JAX,342,202,50,73,28,32,Loss,97,112,3,2,1,CLE,60,439,314,3
0.181818182,0.235294118,34.13333333,12/1/2013,2013,13,20,28,away,-3,MIN,345,250,51,65,0,3,Loss,135,246,4,5,1,CHI,3,480,496,1
0.235294118,0.181818182,39.15,12/1/2013,2013,13,28,20,home,3,CHI,250,345,60,86,3,0,Win,246,135,5,4,1,MIN,3,496,480,1
0.416666667,0.454545455,33.76666667,12/1/2013,2013,13,28,19,away,3,HOU,365,264,0,69,34,31,Win,88,121,1,1,1,NEP,65,453,385,1
0.454545455,0.416666667,26.23333333,12/1/2013,2013,13,19,28,home,-3,NEP,264,365,25,59,31,34,Loss,121,88,1,1,1,HOU,65,385,453,1
0.555555556,0.357142857,38.15,12/1/2013,2013,13,26,19,away,3,BUF,272,210,75,83,3,0,Win,151,195,6,0,2,ATL,3,423,405,1
0.357142857,0.555555556,24.85,12/1/2013,2013,13,19,26,home,-3,ATL,210,272,49,63,0,3,Loss,195,151,0,6,1,BUF,3,405,423,2
0.307692308,0.333333333,26.93333333,12/1/2013,2013,13,19,20,away,-10,SFO,198,255,105,67,13,23,Loss,114,83,3,4,1,LAR,36,312,338,1
0.333333333,0.307692308,33.06666667,12/1/2013,2013,13,20,19,home,10,LAR,255,198,85,62,23,13,Win,83,114,4,3,1,SFO,36,338,312,1
0.571428571,0.384615385,28.06666667,12/1/2013,2013,13,25,27,away,7,KCC,403,293,75,66,35,28,Win,132,159,0,0,1,DEN,63,535,452,2
0.384615385,0.571428571,31.93333333,12/1/2013,2013,13,27,25,home,-7,DEN,293,403,102,67,28,35,Loss,159,132,0,0,2,KCC,63,452,535,1
0.5,0.461538462,29.66666667,12/1/2013,2013,13,19,19,away,7,LAC,190,243,30,61,17,10,Win,164,91,0,2,3,CIN,27,354,334,2
0.461538462,0.5,30.33333333,12/1/2013,2013,13,19,19,home,-7,CIN,243,190,45,63,10,17,Loss,91,164,2,0,2,LAC,27,334,354,3
0.333333333,0.3125,28.41666667,12/1/2013,2013,13,16,18,away,7,WAS,206,184,1,54,24,17,Win,80,139,3,5,1,NYG,41,286,323,1
0.3125,0.333333333,31.58333333,12/1/2013,2013,13,18,16,home,-7,NYG,184,206,55,68,17,24,Loss,139,80,5,3,1,WAS,41,323,286,1
0.4,0.5,26.36666667,12/2/2013,2013,13,12,23,away,-27,SEA,144,302,52,56,7,34,Loss,44,127,1,1,0,NOS,41,188,429,1
0.5,0.4,33.63333333,12/2/2013,2013,13,23,12,home,27,NOS,302,144,66,69,34,7,Win,127,44,1,1,1,SEA,41,429,188,0
0.470588235,0.285714286,35.36666667,12/5/2013,2013,14,23,18,away,-7,JAX,323,132,177,80,20,27,Loss,83,149,3,1,0,HOU,47,406,281,2
0.285714286,0.470588235,24.63333333,12/5/2013,2013,14,18,23,home,7,HOU,132,323,57,57,27,20,Win,149,83,1,3,2,JAX,47,281,406,0
0.428571429,0.470588235,28.91666667,12/8/2013,2013,14,18,16,away,6,PIT,186,328,36,60,34,28,Win,181,84,2,3,1,MIA,62,367,412,1
0.470588235,0.428571429,31.08333333,12/8/2013,2013,14,16,18,home,-6,MIA,328,186,63,63,28,34,Loss,84,181,3,2,1,PIT,62,412,367,1
0.090909091,0.266666667,28.16666667,12/8/2013,2013,14,14,13,away,-21,TBB,147,81,114,62,6,27,Loss,67,165,7,1,2,BUF,33,214,246,5
0.266666667,0.090909091,31.83333333,12/8/2013,2013,14,13,14,home,21,BUF,81,147,76,62,27,6,Win,165,67,1,7,5,TBB,33,246,214,2
0.333333333,0.538461538,30.56666667,12/8/2013,2013,14,19,18,away,-10,NYJ,233,209,31,65,27,37,Loss,150,143,3,1,1,OAK,64,383,352,1
0.538461538,0.333333333,29.43333333,12/8/2013,2013,14,18,19,home,10,OAK,209,233,36,58,37,27,Win,143,150,1,3,1,NYJ,64,352,383,1
0.181818182,0.2,34.16666667,12/8/2013,2013,14,20,13,away,35,WAS,154,192,30,61,45,10,Win,192,65,0,6,2,KCC,55,346,257,1
0.2,0.181818182,25.83333333,12/8/2013,2013,14,13,20,home,-35,KCC,192,154,27,65,10,45,Loss,65,192,6,0,1,WAS,55,257,346,2
0.466666667,0.4,31.66666667,12/8/2013,2013,14,24,30,away,-1,NEP,386,397,75,70,26,27,Loss,108,87,1,4,2,CLE,53,494,484,0
0.4,0.466666667,28.33333333,12/8/2013,2013,14,30,24,home,1,CLE,397,386,41,77,27,26,Win,87,108,4,1,0,NEP,53,484,494,2
0.294117647,0.375,27.8,12/8/2013,2013,14,15,23,away,-3,BAL,265,228,90,63,26,29,Loss,114,97,0,2,3,MIN,55,379,325,1
0.375,0.294117647,32.2,12/8/2013,2013,14,23,15,home,3,MIN,228,265,45,79,29,26,Win,97,114,2,0,1,BAL,55,325,379,3
0.2,0.5,22.25,12/8/2013,2013,14,21,28,away,-14,CIN,326,275,47,58,28,42,Loss,63,155,0,0,0,IND,70,389,430,0
0.5,0.2,37.75,12/8/2013,2013,14,28,21,home,14,IND,275,326,60,70,42,28,Win,155,63,0,0,0,CIN,70,430,389,0
0.333333333,0.25,28.55,12/8/2013,2013,14,11,23,away,-14,PHI,151,179,48,58,20,34,Loss,80,299,0,0,1,DET,54,231,478,3
0.25,0.333333333,31.45,12/8/2013,2013,14,23,11,home,14,DET,179,151,5,68,34,20,Win,299,80,0,0,3,PHI,54,478,231,1
0.461538462,0.466666667,26.46666667,12/8/2013,2013,14,18,20,away,-1,GBP,202,222,15,59,21,22,Loss,83,112,1,5,2,ATL,43,285,334,2
0.466666667,0.461538462,33.53333333,12/8/2013,2013,14,20,18,home,1,ATL,222,202,10,70,22,21,Win,112,83,5,1,2,GBP,43,334,285,2
0.222222222,0.384615385,20.66666667,12/8/2013,2013,14,15,39,away,-23,DEN,158,397,66,48,28,51,Loss,96,154,2,0,0,TEN,79,254,551,2
0.384615385,0.222222222,39.33333333,12/8/2013,2013,14,39,15,home,23,TEN,397,158,60,91,51,28,Win,154,96,0,2,2,DEN,79,551,254,0
0.416666667,0.384615385,27.53333333,12/8/2013,2013,14,13,19,away,-2,SFO,178,155,85,50,17,19,Loss,86,163,2,2,1,SEA,36,264,318,1
0.384615385,0.416666667,32.46666667,12/8/2013,2013,14,19,13,home,2,SEA,155,178,70,64,19,17,Win,163,86,2,2,1,SFO,36,318,264,1
0.272727273,0.571428571,24.88333333,12/8/2013,2013,14,14,25,away,-20,ARI,157,262,90,50,10,30,Loss,100,107,4,1,1,LAR,40,257,369,2
0.571428571,0.272727273,35.11666667,12/8/2013,2013,14,25,14,home,20,LAR,262,157,31,65,30,10,Win,107,100,1,4,2,ARI,40,369,257,1
0.375,0.666666667,23.06666667,12/8/2013,2013,14,18,25,away,-23,LAC,241,244,72,54,14,37,Loss,92,144,2,2,1,NYG,51,333,388,3
0.666666667,0.375,36.93333333,12/8/2013,2013,14,25,18,home,23,NYG,244,241,30,70,37,14,Win,144,92,2,2,3,LAC,51,388,333,1
0.4,0.583333333,32.45,12/8/2013,2013,14,16,24,away,-18,NOS,111,304,35,62,13,31,Loss,128,69,5,2,0,CAR,44,239,373,0
0.583333333,0.4,27.55,12/8/2013,2013,14,24,16,home,18,CAR,304,111,45,61,31,13,Win,69,128,2,5,0,NOS,44,373,239,0
0.5,0.727272727,23.26666667,12/9/2013,2013,14,24,33,away,-17,CHI,130,341,50,55,28,45,Loss,198,149,2,1,0,DAL,73,328,490,0
0.727272727,0.5,36.73333333,12/9/2013,2013,14,33,24,home,17,DAL,341,130,15,69,45,28,Win,149,198,1,2,0,CHI,73,490,328,0
0.5,0.222222222,38.81666667,12/12/2013,2013,15,24,19,away,7,DEN,160,277,35,66,27,20,Win,177,18,2,1,1,LAC,47,337,295,0
0.222222222,0.5,21.18333333,12/12/2013,2013,15,19,24,home,-7,LAC,277,160,43,53,20,27,Loss,18,177,1,2,0,DEN,47,295,337,1
0.384615385,0.533333333,32.58333333,12/15/2013,2013,15,25,22,away,7,JAX,168,195,67,72,27,20,Win,198,159,4,5,4,BUF,47,366,354,2
0.533333333,0.384615385,27.41666667,12/15/2013,2013,15,22,25,home,-7,BUF,195,168,80,72,20,27,Loss,159,198,5,4,2,JAX,47,354,366,4
0.5,0.357142857,26.13333333,12/15/2013,2013,15,22,19,away,-1,ATL,373,189,66,67,26,27,Loss,103,54,1,3,2,WAS,53,476,243,7
0.357142857,0.5,33.86666667,12/15/2013,2013,15,19,22,home,1,WAS,189,373,73,62,27,26,Win,54,103,3,1,7,ATL,53,243,476,2
0.333333333,0.333333333,26.81666667,12/15/2013,2013,15,12,19,away,-22,IND,132,179,114,63,3,25,Loss,107,152,4,1,1,HOU,28,239,331,2
0.333333333,0.333333333,33.18333333,12/15/2013,2013,15,19,12,home,22,HOU,179,132,36,69,25,3,Win,152,107,1,4,2,IND,28,331,239,1
0.642857143,0.333333333,34.8,12/15/2013,2013,15,23,20,away,7,CLE,261,273,40,64,38,31,Win,179,93,2,0,2,CHI,69,440,366,3
0.333333333,0.642857143,25.2,12/15/2013,2013,15,20,23,home,-7,CHI,273,261,90,56,31,38,Loss,93,179,0,2,3,CLE,69,366,440,2
0.230769231,0.1,33.96666667,12/15/2013,2013,15,21,12,away,23,NYG,193,156,50,67,23,0,Win,134,25,4,4,5,SEA,23,327,181,1
0.1,0.230769231,26.03333333,12/15/2013,2013,15,12,21,home,-23,SEA,156,193,38,53,0,23,Loss,25,134,4,4,1,NYG,23,181,327,5
0.5,0.615384615,23.56666667,12/15/2013,2013,15,25,29,away,-18,MIN,396,370,94,65,30,48,Loss,79,85,4,3,1,PHI,78,475,455,1
0.615384615,0.5,36.43333333,12/15/2013,2013,15,29,25,home,18,PHI,370,396,25,73,48,30,Win,85,79,3,4,1,MIN,78,455,475,1
0.4,0.1,39.83333333,12/15/2013,2013,15,22,13,away,19,TBB,189,144,62,71,33,14,Win,187,39,2,4,2,SFO,47,376,183,0
0.1,0.4,20.16666667,12/15/2013,2013,15,13,22,home,-19,SFO,144,189,32,50,14,33,Loss,39,187,4,2,0,TBB,47,183,376,2
0.529411765,0.363636364,31.35,12/15/2013,2013,15,29,20,away,-4,MIA,357,289,2,78,20,24,Loss,96,89,1,4,1,NEP,44,453,378,1
0.363636364,0.529411765,28.65,12/15/2013,2013,15,20,29,home,4,NEP,289,357,21,64,24,20,Win,89,96,4,1,1,MIA,44,378,453,1
0.533333333,0.454545455,26.98333333,12/15/2013,2013,15,19,21,away,-10,CAR,140,261,20,60,20,30,Loss,157,131,4,2,0,NYJ,50,297,392,1
0.454545455,0.533333333,33.01666667,12/15/2013,2013,15,21,19,home,10,NYJ,261,140,59,62,30,20,Win,131,157,2,4,1,CAR,50,392,297,0
0.444444444,0.5,25.88333333,12/15/2013,2013,15,19,26,away,25,OAK,306,331,91,51,56,31,Win,78,130,2,0,7,KCC,87,384,461,1
0.5,0.444444444,34.11666667,12/15/2013,2013,15,26,19,home,-25,KCC,331,306,90,74,31,56,Loss,130,78,0,2,1,OAK,87,461,384,7
0.333333333,0.5,32.2,12/15/2013,2013,15,30,17,away,-11,LAR,371,158,77,80,16,27,Loss,61,144,4,0,0,NOS,43,432,302,3
0.5,0.333333333,27.8,12/15/2013,2013,15,17,30,home,11,NOS,158,371,30,54,27,16,Win,144,61,0,4,3,LAR,43,302,432,0
0.5,0.5,30.96666667,12/15/2013,2013,15,24,32,away,3,TEN,215,394,69,68,3,0,Win,145,66,2,3,3,ARI,3,360,460,0
0.5,0.5,33.73333333,12/15/2013,2013,15,32,24,home,-3,ARI,394,215,16,80,0,3,Loss,66,145,3,2,0,TEN,3,460,360,3
0.538461538,0.222222222,28.3,12/15/2013,2013,15,26,27,away,1,DAL,283,332,59,68,37,36,Win,150,134,2,3,2,GBP,73,433,466,1
0.222222222,0.538461538,31.7,12/15/2013,2013,15,27,26,home,-1,GBP,332,283,79,69,36,37,Loss,134,150,3,2,1,DAL,73,466,433,2
0.285714286,0.2,28.4,12/15/2013,2013,15,19,19,away,-10,PIT,222,184,50,67,20,30,Loss,57,106,1,1,1,CIN,50,279,290,1
0.2,0.285714286,31.6,12/15/2013,2013,15,19,19,home,10,CIN,184,222,25,62,30,20,Win,106,57,1,1,1,PIT,50,290,279,1
0.285714286,0.307692308,27.58333333,12/16/2013,2013,15,18,19,away,2,DET,215,230,60,60,18,16,Win,90,119,1,1,3,BAL,34,305,349,0
0.307692308,0.285714286,32.41666667,12/16/2013,2013,15,19,18,home,-2,BAL,230,215,89,63,16,18,Loss,119,90,1,1,0,DET,34,349,305,3
0.285714286,0.428571429,25.9,12/22/2013,2013,16,14,18,away,-10,LAR,111,148,26,56,13,23,Loss,59,129,7,1,2,TBB,36,170,277,2
0.428571429,0.285714286,34.1,12/22/2013,2013,16,18,14,home,10,TBB,148,111,85,60,23,13,Win,129,59,1,7,2,LAR,36,277,170,2
0.230769231,0.272727273,35.65,12/22/2013,2013,16,22,15,away,4,JAX,164,226,4,73,20,16,Win,182,63,3,2,1,TEN,36,346,289,1
0.272727273,0.230769231,24.35,12/22/2013,2013,16,15,22,home,-4,TEN,226,164,15,57,16,20,Loss,63,182,2,3,1,JAX,36,289,346,1
0.4,0.4375,26.21666667,12/22/2013,2013,16,16,17,away,1,WAS,214,197,42,52,24,23,Win,95,100,2,0,1,DAL,47,309,297,2
0.4375,0.4,33.78333333,12/22/2013,2013,16,17,16,home,-1,DAL,197,214,44,64,23,24,Loss,100,95,0,2,2,WAS,47,297,309,1
0.181818182,0.375,28.88333333,12/22/2013,2013,16,25,14,away,24,HOU,397,153,67,70,37,13,Win,114,87,1,3,2,DEN,50,511,240,0
0.375,0.181818182,31.11666667,12/22/2013,2013,16,14,25,home,-24,DEN,153,397,57,66,13,37,Loss,87,114,3,1,0,HOU,50,240,511,2
0.277777778,0,38.8,12/22/2013,2013,16,20,10,away,-4,CAR,239,141,40,81,13,17,Loss,126,81,6,4,1,NOS,30,365,222,2
0,0.277777778,21.2,12/22/2013,2013,16,10,20,home,4,NOS,141,239,26,44,17,13,Win,81,126,4,6,2,CAR,30,222,365,1
0,0.571428571,20.46666667,12/22/2013,2013,16,10,24,away,-28,CIN,94,345,40,48,14,42,Loss,115,81,4,2,1,MIN,56,209,426,4
0.571428571,0,39.53333333,12/22/2013,2013,16,24,10,home,28,MIN,345,94,55,77,42,14,Win,81,115,2,4,4,CIN,56,426,209,1
0.142857143,0.368421053,23.48333333,12/22/2013,2013,16,6,18,away,-19,BUF,89,187,37,52,0,19,Loss,14,203,7,1,1,MIA,19,103,390,2
0.368421053,0.142857143,36.51666667,12/22/2013,2013,16,18,6,home,19,MIA,187,89,31,77,19,0,Win,203,14,1,7,2,BUF,19,390,103,1
0.388888889,0.125,38.33333333,12/22/2013,2013,16,19,18,away,16,KCC,232,132,31,72,23,7,Win,135,155,1,5,4,IND,30,367,287,0
0.125,0.388888889,21.66666667,12/22/2013,2013,16,18,19,home,-16,IND,132,232,65,53,7,23,Loss,155,135,5,1,0,KCC,30,287,367,4
0.416666667,0.666666667,27.28333333,12/22/2013,2013,16,19,25,away,-11,NYJ,168,214,24,64,13,24,Loss,115,208,3,0,0,CLE,37,283,422,2
0.666666667,0.416666667,32.71666667,12/22/2013,2013,16,25,19,home,11,CLE,214,168,35,76,24,13,Win,208,115,0,3,2,NYJ,37,422,283,0
0.352941176,0.470588235,29.71666667,12/22/2013,2013,16,15,24,away,3,DET,238,207,30,65,3,0,Win,41,148,2,2,3,NYG,3,279,355,2
0.470588235,0.352941176,37.75,12/22/2013,2013,16,24,15,home,-3,NYG,207,238,60,80,0,3,Loss,148,41,2,2,2,DET,3,355,279,3
0.315789474,0.153846154,37.4,12/22/2013,2013,16,16,10,away,7,SEA,168,89,46,70,17,10,Win,139,103,2,4,2,ARI,27,307,192,4
0.153846154,0.315789474,22.6,12/22/2013,2013,16,10,16,home,-7,ARI,89,168,102,51,10,17,Loss,103,139,4,2,4,SEA,27,192,307,2
0.2,0.428571429,26.66666667,12/22/2013,2013,16,21,26,away,7,GBP,192,219,58,59,38,31,Win,151,151,1,3,2,PIT,69,343,370,2
0.428571429,0.2,33.33333333,12/22/2013,2013,16,26,21,home,-7,PIT,219,192,90,72,31,38,Loss,151,151,3,1,2,GBP,69,370,343,2
0.307692308,0.545454545,25.3,12/22/2013,2013,16,14,24,away,-13,LAC,206,196,73,54,13,26,Loss,59,148,1,1,3,OAK,39,265,344,2
0.545454545,0.307692308,34.7,12/22/2013,2013,16,24,14,home,13,OAK,196,206,24,67,26,13,Win,148,59,1,1,2,LAC,39,344,265,3
0.307692308,0.357142857,31.96666667,12/22/2013,2013,16,21,19,away,34,BAL,158,237,58,62,41,7,Win,142,121,2,4,4,NEP,48,300,358,0
0.357142857,0.307692308,28.03333333,12/22/2013,2013,16,19,21,home,-34,NEP,237,158,83,74,7,41,Loss,121,142,4,2,0,BAL,48,358,300,4
0.357142857,0.555555556,29.66666667,12/22/2013,2013,16,18,28,away,-43,PHI,196,225,10,63,11,54,Loss,61,289,5,2,1,CHI,65,257,514,2
0.555555556,0.357142857,30.33333333,12/22/2013,2013,16,28,18,home,43,CHI,225,196,15,63,54,11,Win,289,61,2,5,2,PHI,65,514,257,1
0.533333333,0.444444444,30.46666667,12/23/2013,2013,16,25,20,away,-10,SFO,341,180,37,69,24,34,Loss,61,199,1,3,0,ATL,58,402,379,2
0.444444444,0.533333333,29.53333333,12/23/2013,2013,16,20,25,home,10,ATL,180,341,45,54,34,24,Win,199,61,3,1,2,SFO,58,379,402,0
0.4,0.461538462,32.4,12/29/2013,2013,17,22,18,away,13,MIA,220,204,36,70,20,7,Win,154,92,0,0,3,NYJ,27,374,296,0
0.461538462,0.4,27.6,12/29/2013,2013,17,18,22,home,-13,NYJ,204,220,38,62,7,20,Loss,92,154,0,0,0,MIA,27,296,374,3
0.25,0.214285714,28.35,12/29/2013,2013,17,12,14,away,-14,NYG,160,156,30,75,6,20,Loss,91,122,3,1,3,WAS,26,251,278,4
0.214285714,0.25,31.65,12/29/2013,2013,17,14,12,home,14,WAS,156,160,20,68,20,6,Win,122,91,1,3,4,NYG,26,278,251,3
0.214285714,0.5,26.33333333,12/29/2013,2013,17,19,23,away,-20,IND,308,299,50,70,10,30,Loss,42,80,3,1,0,JAX,40,350,379,2
0.5,0.214285714,33.66666667,12/29/2013,2013,17,23,19,home,20,JAX,299,308,10,70,30,10,Win,80,42,1,3,2,IND,40,379,350,0
0.4,0.416666667,29.71666667,12/29/2013,2013,17,15,17,away,-13,PIT,221,172,30,64,7,20,Loss,79,120,3,1,2,CLE,27,300,292,2
0.416666667,0.4,30.28333333,12/29/2013,2013,17,17,15,home,13,CLE,172,221,15,61,20,7,Win,120,79,1,3,2,PIT,27,292,300,2
0.4,0.285714286,27.75,12/29/2013,2013,17,19,17,away,-6,TEN,223,160,55,57,10,16,Loss,65,151,1,1,1,HOU,26,288,311,4
0.285714286,0.4,32.25,12/29/2013,2013,17,17,19,home,6,HOU,160,223,76,61,16,10,Win,151,65,1,1,4,TEN,26,311,288,1
0.266666667,0.538461538,26.05,12/29/2013,2013,17,17,21,away,-17,CIN,175,281,56,66,17,34,Loss,47,111,2,0,4,BAL,51,222,392,3
0.538461538,0.266666667,33.95,12/29/2013,2013,17,21,17,home,17,BAL,281,175,76,66,34,17,Win,111,47,0,2,3,CIN,51,392,222,4
0.466666667,0.4375,25.56666667,12/29/2013,2013,17,16,20,away,1,ATL,149,231,38,57,21,20,Win,134,76,1,9,1,CAR,41,283,307,2
0.4375,0.466666667,34.43333333,12/29/2013,2013,17,20,16,home,-1,CAR,231,149,56,69,20,21,Loss,76,134,9,1,2,ATL,41,307,283,1
0.333333333,0.272727273,32.61666667,12/29/2013,2013,17,14,19,away,-1,MIN,182,171,52,60,13,14,Loss,63,174,5,3,2,DET,27,245,345,0
0.272727273,0.333333333,27.38333333,12/29/2013,2013,17,19,14,home,1,DET,171,182,25,56,14,13,Win,174,63,3,5,0,MIN,27,345,245,2
0.230769231,0.538461538,25.8,12/29/2013,2013,17,18,21,away,-25,NOS,215,370,78,62,17,42,Loss,75,98,2,1,0,TBB,59,290,468,1
0.538461538,0.230769231,34.2,12/29/2013,2013,17,21,18,home,25,TBB,370,215,94,62,42,17,Win,98,75,1,2,1,NOS,59,468,290,0
0.5,0.5,35.15,12/29/2013,2013,17,25,17,away,5,CHI,313,224,15,76,33,28,Win,160,121,3,1,2,GBP,61,473,345,2
0.5,0.5,24.85,12/29/2013,2013,17,17,25,home,-5,GBP,224,313,40,49,28,33,Loss,121,160,1,3,2,CHI,61,345,473,2
0.307692308,0.307692308,27.21666667,12/29/2013,2013,17,19,24,away,-14,NEP,224,115,54,68,20,34,Loss,169,267,4,1,1,BUF,54,393,382,0
0.307692308,0.307692308,32.78333333,12/29/2013,2013,17,24,19,home,14,BUF,115,224,31,68,34,20,Win,267,169,1,4,0,NEP,54,382,393,1
0.181818182,0.307692308,26.33333333,12/29/2013,2013,17,11,20,away,-18,SEA,145,158,87,50,9,27,Loss,13,111,2,4,0,LAR,36,158,269,2
0.307692308,0.181818182,33.66666667,12/29/2013,2013,17,20,11,home,18,LAR,158,145,65,63,27,9,Win,111,13,4,2,2,SEA,36,269,158,0
0.428571429,0.529411765,34.6,12/29/2013,2013,17,22,19,away,-3,LAC,189,219,5,69,0,3,Loss,143,186,2,3,1,KCC,3,332,405,0
0.529411765,0.428571429,37.13333333,12/29/2013,2013,17,19,22,home,3,KCC,219,189,22,72,3,0,Win,186,143,3,2,0,LAC,3,405,332,1
0.230769231,0.266666667,27.66666667,12/29/2013,2013,17,19,19,away,3,ARI,292,399,20,59,23,20,Win,83,83,2,1,2,SFO,43,375,482,0
0.266666667,0.230769231,32.33333333,12/29/2013,2013,17,19,19,home,-3,SFO,399,292,30,72,20,23,Loss,83,83,1,2,0,ARI,43,482,375,2
0.6,0.384615385,35.48333333,12/29/2013,2013,17,28,17,away,20,OAK,334,191,56,73,34,14,Win,124,64,3,2,1,DEN,48,458,255,0
0.384615385,0.6,24.51666667,12/29/2013,2013,17,17,28,home,-20,DEN,191,334,10,60,14,34,Loss,64,124,2,3,0,OAK,48,255,458,1
0.384615385,0.272727273,29.71666667,12/29/2013,2013,17,21,21,away,2,DAL,229,358,50,66,24,22,Win,137,56,5,0,3,PHI,46,366,414,1
0.272727273,0.384615385,30.28333333,12/29/2013,2013,17,21,21,home,-2,PHI,358,229,5,64,22,24,Loss,56,137,0,5,1,DAL,46,414,366,3
0.5625,0.5,37.55,1/4/2014,2013,PF,30,28,away,-1,IND,363,436,15,80,44,45,Loss,150,100,2,1,4,KCC,89,513,536,1
0.5,0.5625,22.45,1/4/2014,2013,PF,28,30,home,1,KCC,436,363,19,65,45,44,Win,100,150,1,2,1,IND,89,536,513,4
0.538461538,0.25,34.88333333,1/4/2014,2013,PF,26,17,away,2,PHI,249,176,85,68,26,24,Win,185,80,2,2,0,NOS,50,434,256,2
0.25,0.538461538,25.11666667,1/4/2014,2013,PF,17,26,home,-2,NOS,176,249,38,57,24,26,Loss,80,185,2,2,2,PHI,50,256,434,0
0.333333333,0.25,29.46666667,1/5/2014,2013,PF,16,27,away,17,CIN,122,326,28,57,27,10,Win,196,113,1,3,4,LAC,37,318,439,0
0.25,0.333333333,30.53333333,1/5/2014,2013,PF,27,16,home,-17,LAC,326,122,38,79,10,27,Loss,113,196,3,1,0,CIN,37,439,318,4
0.5,0.272727273,29.1,1/5/2014,2013,PF,22,18,away,3,GBP,214,157,10,63,23,20,Win,167,124,3,4,0,SFO,43,381,281,1
0.272727273,0.5,30.9,1/5/2014,2013,PF,18,22,home,-3,SFO,157,214,20,61,20,23,Loss,124,167,4,3,1,GBP,43,281,381,0
0.25,0.357142857,30.5,1/11/2014,2013,PF,25,13,away,-8,SEA,296,103,69,70,15,23,Loss,108,174,1,3,0,NOS,38,404,277,1
0.357142857,0.25,29.5,1/11/2014,2013,PF,13,25,home,8,NOS,103,296,52,56,23,15,Win,174,108,3,1,1,SEA,38,277,404,0
0.4,0.611111111,25,1/11/2014,2013,PF,16,23,away,-21,NEP,317,185,42,65,22,43,Loss,69,234,3,2,0,IND,65,386,419,4
0.611111111,0.4,35,1/11/2014,2013,PF,23,16,home,21,IND,185,317,35,73,43,22,Win,234,69,2,3,4,NEP,65,419,386,0
0.428571429,0.6,29.91666667,1/12/2014,2013,PF,21,18,away,13,CAR,189,232,40,65,23,10,Win,126,93,1,5,2,SFO,33,315,325,0
0.6,0.428571429,30.08333333,1/12/2014,2013,PF,18,21,home,-13,SFO,232,189,73,54,10,23,Loss,93,126,5,1,0,CAR,33,325,315,2
0.333333333,0.692307692,24.55,1/12/2014,2013,PF,13,26,away,-7,DEN,194,230,63,49,17,24,Loss,65,133,4,0,2,LAC,41,259,363,0
0.692307692,0.333333333,35.45,1/12/2014,2013,PF,26,13,home,7,LAC,230,194,50,70,24,17,Win,133,65,0,4,0,DEN,41,363,259,2
0.5,0.538461538,24.26666667,1/19/2014,2013,PF,19,27,away,-10,DEN,256,400,15,56,16,26,Loss,64,107,2,0,0,NEP,42,320,507,0
0.538461538,0.5,35.73333333,1/19/2014,2013,PF,27,19,home,10,NEP,400,256,34,71,26,16,Win,107,64,0,2,0,DEN,42,507,320,0
0.272727273,0.357142857,28.53333333,1/19/2014,2013,PF,16,14,away,-6,SEA,147,193,65,54,17,23,Loss,161,115,2,4,1,SFO,40,308,308,3
0.357142857,0.272727273,31.46666667,1/19/2014,2013,PF,14,16,home,6,SFO,193,147,66,58,23,17,Win,115,161,4,2,3,SEA,40,308,308,1
0.583333333,0.461538462,31.88333333,2/2/2014,2013,PF,17,18,away,35,DEN,206,279,104,55,43,8,Win,135,27,0,1,4,SEA,51,341,306,0
0.461538462,0.583333333,28.11666667,2/2/2014,2013,PF,18,17,home,-35,SEA,279,206,44,64,8,43,Loss,27,135,1,0,0,DEN,51,306,341,4
0.5,0.363636364,26.66666667,9/4/2014,2014,1,19,25,away,-20,SEA,175,191,65,57,16,36,Loss,80,207,3,1,1,GBP,52,255,398,1
0.363636364,0.5,33.33333333,9/4/2014,2014,1,25,19,home,20,GBP,191,175,69,66,36,16,Win,207,80,1,3,1,SEA,52,398,255,1
0.615384615,0.545454545,30.41666667,9/7/2014,2014,1,30,28,away,-3,ATL,333,445,27,70,0,3,Loss,139,123,0,1,1,NOS,3,472,568,2
0.545454545,0.615384615,31.3,9/7/2014,2014,1,28,30,home,3,NOS,445,333,96,69,3,0,Win,123,139,1,0,2,ATL,3,568,472,1
0.25,0.285714286,28.28333333,9/7/2014,2014,1,18,15,away,28,LAR,170,246,60,57,34,6,Win,185,72,0,5,2,MIN,40,355,318,0
0.285714286,0.25,31.71666667,9/7/2014,2014,1,15,18,home,-28,MIN,246,170,121,63,6,34,Loss,72,185,5,0,0,LAR,40,318,355,2
0.181818182,0.333333333,27.55,9/7/2014,2014,1,23,24,away,-3,PIT,198,376,55,64,27,30,Loss,191,127,3,3,1,CLE,57,389,503,0
0.333333333,0.181818182,32.45,9/7/2014,2014,1,24,23,home,3,CLE,376,198,96,67,30,27,Win,127,191,3,3,0,PIT,57,503,389,1
0.142857143,0.421052632,29.23333333,9/7/2014,2014,1,18,24,away,-17,PHI,242,275,55,70,17,34,Loss,64,145,3,5,3,JAX,51,306,420,1
0.421052632,0.142857143,30.76666667,9/7/2014,2014,1,24,18,home,17,JAX,275,242,50,82,34,17,Win,145,64,5,3,1,PHI,51,420,306,3
0.25,0.416666667,25.16666667,9/7/2014,2014,1,11,20,away,-5,NYJ,133,190,20,49,14,19,Loss,25,212,2,2,2,OAK,33,158,402,0
0.416666667,0.25,34.83333333,9/7/2014,2014,1,20,11,home,5,OAK,190,133,105,65,19,14,Win,212,25,2,2,0,NYJ,33,402,158,2
0.285714286,0.470588235,30.5,9/7/2014,2014,1,16,26,away,7,BAL,301,329,45,64,23,16,Win,79,94,0,3,2,CIN,39,380,423,0
0.470588235,0.285714286,29.5,9/7/2014,2014,1,26,16,home,-7,CIN,329,301,29,85,16,23,Loss,94,79,3,0,0,BAL,39,423,380,2
0.333333333,0.416666667,30.53333333,9/7/2014,2014,1,15,29,away,3,CHI,167,341,108,56,3,0,Win,193,86,1,2,3,BUF,3,360,427,1
0.416666667,0.333333333,34.7,9/7/2014,2014,1,29,15,home,-3,BUF,341,167,43,69,0,3,Loss,86,193,2,1,1,CHI,3,427,360,3
0.25,0.5,30.9,9/7/2014,2014,1,20,16,away,-11,HOU,241,206,71,63,6,17,Loss,131,115,3,0,1,WAS,23,372,321,2
0.5,0.25,29.1,9/7/2014,2014,1,16,20,home,11,WAS,206,241,45,56,17,6,Win,115,131,0,3,2,HOU,23,321,372,1
0.4375,0.083333333,37.73333333,9/7/2014,2014,1,24,15,away,16,KCC,243,178,110,75,26,10,Win,162,67,4,4,3,TEN,36,405,245,0
0.083333333,0.4375,22.26666667,9/7/2014,2014,1,15,24,home,-16,TEN,178,243,25,56,10,26,Loss,67,162,4,4,0,KCC,36,245,405,3
0.294117647,0.538461538,29.55,9/7/2014,2014,1,20,25,away,-13,MIA,226,169,100,80,20,33,Loss,89,191,4,1,3,NEP,53,315,360,2
0.538461538,0.294117647,30.45,9/7/2014,2014,1,25,20,home,13,NEP,169,226,26,71,33,20,Win,191,89,1,4,2,MIA,53,360,315,3
0.4,0.5,35.2,9/7/2014,2014,1,19,17,away,6,TBB,221,162,55,68,20,14,Win,113,102,1,3,3,CAR,34,334,264,0
0.5,0.4,24.8,9/7/2014,2014,1,17,19,home,-6,CAR,162,221,15,55,14,20,Loss,102,113,3,1,0,TBB,34,264,334,3
0.583333333,0.555555556,28.6,9/7/2014,2014,1,19,26,away,11,DAL,192,255,78,54,28,17,Win,127,127,1,3,4,SFO,45,319,382,0
0.555555556,0.583333333,31.4,9/7/2014,2014,1,26,19,home,-11,SFO,255,192,72,63,17,28,Loss,127,127,3,1,0,DAL,45,382,319,4
0.307692308,0.5,27.6,9/7/2014,2014,1,24,24,away,-7,DEN,354,259,45,70,24,31,Loss,54,102,3,1,0,IND,55,408,361,2
0.5,0.307692308,32.4,9/7/2014,2014,1,24,24,home,7,IND,259,354,70,69,31,24,Win,102,54,1,3,2,DEN,55,361,408,0
0.230769231,0.666666667,23.93333333,9/8/2014,2014,1,16,20,away,-21,DET,144,341,25,57,14,35,Loss,53,76,2,1,0,NYG,49,197,417,2
0.666666667,0.230769231,36.06666667,9/8/2014,2014,1,20,16,home,21,NYG,341,144,85,63,35,14,Win,76,53,1,2,2,DET,49,417,197,0
0.4,0.461538462,28.18333333,9/8/2014,2014,1,15,22,away,-1,ARI,238,294,47,60,17,18,Loss,52,109,0,2,2,LAC,35,290,403,1
0.461538462,0.4,31.81666667,9/8/2014,2014,1,22,15,home,1,LAC,294,238,23,65,18,17,Win,109,52,2,0,1,ARI,35,403,290,2
0.5,0.416666667,24.86666667,9/11/2014,2014,2,17,25,away,-20,BAL,202,166,75,57,6,26,Loss,99,157,2,0,0,PIT,32,301,323,3
0.416666667,0.5,35.13333333,9/11/2014,2014,2,25,17,home,20,PIT,166,202,35,65,26,6,Win,157,99,0,2,3,BAL,32,323,301,0
0.3125,0.333333333,31.28333333,9/14/2014,2014,2,23,13,away,-19,BUF,210,202,20,74,10,29,Loss,80,113,4,0,0,MIA,39,290,315,2
0.333333333,0.3125,28.71666667,9/14/2014,2014,2,13,23,home,19,MIA,202,210,40,59,29,10,Win,113,80,0,4,2,BUF,39,315,290,0
0.230769231,0.428571429,20.98333333,9/14/2014,2014,2,8,32,away,-31,WAS,123,258,44,48,10,41,Loss,25,191,10,3,0,JAX,51,148,449,1
0.428571429,0.230769231,39.01666667,9/14/2014,2014,2,32,8,home,31,JAX,258,123,98,81,41,10,Win,191,25,3,10,1,WAS,51,449,148,0
0.5625,0.2,41.18333333,9/14/2014,2014,2,26,13,away,16,TEN,148,232,25,76,26,10,Win,220,82,4,2,2,DAL,36,368,314,1
0.2,0.5625,18.81666667,9/14/2014,2014,2,13,26,home,-16,DAL,232,148,30,49,10,26,Loss,82,220,2,4,1,TEN,36,314,368,2
0.384615385,0.5,27.51666667,9/14/2014,2014,2,21,24,away,11,NYG,142,260,71,61,25,14,Win,124,81,4,2,4,ARI,39,266,341,0
0.5,0.384615385,32.48333333,9/14/2014,2014,2,24,21,home,-11,ARI,260,142,70,68,14,25,Loss,81,124,2,4,0,NYG,39,341,266,4
0.357142857,0.363636364,31.56666667,9/14/2014,2014,2,16,17,away,23,MIN,142,163,163,59,30,7,Win,150,54,1,6,4,NEP,37,292,217,0
0.363636364,0.357142857,28.43333333,9/14/2014,2014,2,17,16,home,-23,NEP,163,142,58,61,7,30,Loss,54,150,6,1,0,MIN,37,217,292,4
0.538461538,0.4375,31.83333333,9/14/2014,2014,2,26,23,away,-2,CLE,223,202,39,69,24,26,Loss,174,122,2,1,0,NOS,50,397,324,2
0.4375,0.538461538,28.16666667,9/14/2014,2014,2,23,26,home,2,NOS,202,223,30,72,26,24,Win,122,174,1,2,2,CLE,50,324,397,0
0.25,0.428571429,27.01666667,9/14/2014,2014,2,19,21,away,-14,CIN,212,302,56,65,10,24,Loss,97,170,2,0,0,ATL,34,309,472,3
0.428571429,0.25,32.98333333,9/14/2014,2014,2,21,19,home,14,ATL,302,212,55,69,24,10,Win,170,97,0,2,3,CIN,34,472,309,0
0.4,0.25,30.68333333,9/14/2014,2014,2,21,20,away,-17,CAR,253,251,33,70,7,24,Loss,70,62,4,4,0,DET,31,323,313,3
0.25,0.4,29.31666667,9/14/2014,2014,2,20,21,home,17,DET,251,253,45,62,24,7,Win,62,70,4,4,3,CAR,31,313,323,0
0.454545455,0.5,32.08333333,9/14/2014,2014,2,20,18,away,2,TBB,220,175,65,60,19,17,Win,119,157,2,1,1,LAR,36,339,332,1
0.5,0.454545455,27.91666667,9/14/2014,2014,2,18,20,home,-2,LAR,175,220,30,52,17,19,Loss,157,119,1,2,1,TBB,36,332,339,1
0.375,0.588235294,17.75,9/14/2014,2014,2,14,26,away,-9,LAC,180,276,53,40,21,30,Loss,108,101,2,1,0,SEA,51,288,377,1
0.588235294,0.375,42.25,9/14/2014,2014,2,26,14,home,9,SEA,276,180,53,75,30,21,Win,101,108,1,2,1,LAC,51,377,288,0
0.6,0.222222222,38.6,9/14/2014,2014,2,20,22,away,16,OAK,139,263,85,65,30,14,Win,188,101,0,0,4,HOU,44,327,364,0
0.222222222,0.6,21.4,9/14/2014,2014,2,22,20,home,-16,HOU,263,139,24,59,14,30,Loss,101,188,0,0,0,OAK,44,364,327,4
0.470588235,0.5,30.43333333,9/14/2014,2014,2,19,25,away,-7,GBP,166,310,82,71,24,31,Loss,147,80,2,4,1,NYJ,55,313,390,1
0.5,0.470588235,29.56666667,9/14/2014,2014,2,25,19,home,7,NYJ,310,166,34,68,31,24,Win,80,147,4,2,1,GBP,55,390,313,1
0.6875,0.375,36.23333333,9/14/2014,2014,2,28,19,away,-7,DEN,247,237,62,75,17,24,Loss,133,88,2,1,0,KCC,41,380,325,0
0.375,0.6875,23.76666667,9/14/2014,2014,2,19,28,home,7,KCC,237,247,71,46,24,17,Win,88,133,1,2,0,DEN,41,325,380,0
0.333333333,0.538461538,26.15,9/14/2014,2014,2,19,19,away,8,SFO,170,232,58,52,28,20,Win,46,127,1,4,4,CHI,48,216,359,0
0.538461538,0.333333333,33.85,9/14/2014,2014,2,19,19,home,-8,CHI,232,170,118,65,20,28,Loss,127,46,4,1,0,SFO,48,359,216,4
0.416666667,0.333333333,23.75,9/15/2014,2014,2,24,25,away,3,IND,331,172,90,64,30,27,Win,127,169,0,0,2,PHI,57,458,341,1
0.333333333,0.416666667,36.25,9/15/2014,2014,2,25,24,home,-3,PHI,172,331,70,72,27,30,Loss,169,127,0,0,1,IND,57,341,458,2
0.230769231,0.727272727,27.35,9/18/2014,2014,3,10,26,away,-42,ATL,153,344,110,57,14,56,Loss,64,144,3,1,4,TBB,70,217,488,5
0.727272727,0.230769231,32.65,9/18/2014,2014,3,26,10,home,42,TBB,344,153,50,65,56,14,Win,144,64,1,3,5,ATL,70,488,217,4
0.384615385,0.428571429,31.56666667,9/21/2014,2014,3,20,18,away,12,BUF,250,205,44,63,22,10,Win,83,87,2,3,0,LAC,32,333,292,0
0.428571429,0.384615385,28.43333333,9/21/2014,2014,3,18,20,home,-12,LAC,205,250,110,65,10,22,Loss,87,83,3,2,0,BUF,32,292,333,0
0.5,0.615384615,27.16666667,9/21/2014,2014,3,19,26,away,3,LAR,217,327,15,52,34,31,Win,123,121,0,0,3,DAL,65,340,448,2
0.615384615,0.5,32.83333333,9/21/2014,2014,3,26,19,home,-3,DAL,327,217,119,72,31,34,Loss,121,123,0,0,2,LAR,65,448,340,3
0.533333333,0.363636364,34.8,9/21/2014,2014,3,27,22,away,-3,PHI,427,325,131,76,34,37,Loss,84,54,0,0,1,WAS,71,511,379,1
0.363636364,0.533333333,25.2,9/21/2014,2014,3,22,27,home,3,WAS,325,427,70,66,37,34,Win,54,84,0,0,1,PHI,71,379,511,1
0.166666667,0.333333333,27.43333333,9/21/2014,2014,3,20,26,away,-13,NYG,292,226,40,62,17,30,Loss,119,193,2,1,1,HOU,47,411,419,3
0.333333333,0.166666667,32.56666667,9/21/2014,2014,3,26,20,home,13,HOU,226,292,31,71,30,17,Win,193,119,1,2,3,NYG,47,419,411,1
0.4,0.692307692,26.45,9/21/2014,2014,3,13,27,away,-11,NOS,188,288,44,54,9,20,Loss,59,108,2,1,0,MIN,29,247,396,0
0.692307692,0.4,33.55,9/21/2014,2014,3,27,13,home,11,MIN,288,188,30,68,20,9,Win,108,59,1,2,0,NOS,29,396,247,0
0.166666667,0.333333333,31.26666667,9/21/2014,2014,3,22,25,away,-26,CIN,177,184,99,64,7,33,Loss,149,116,2,0,1,TEN,40,326,300,2
0.333333333,0.166666667,28.73333333,9/21/2014,2014,3,25,22,home,26,TEN,184,177,50,57,33,7,Win,116,149,0,2,2,CIN,40,300,326,1
0.333333333,0.454545455,30.91666667,9/21/2014,2014,3,23,19,away,2,CLE,217,290,32,64,23,21,Win,160,85,0,0,0,BAL,44,377,375,1
0.454545455,0.333333333,29.08333333,9/21/2014,2014,3,19,23,home,-2,BAL,290,217,94,55,21,23,Loss,85,160,0,0,1,CLE,44,375,377,0
0.4,0.611111111,21.78333333,9/21/2014,2014,3,14,21,away,-12,DET,147,238,30,51,7,19,Loss,76,115,2,2,3,GBP,26,223,353,1
0.611111111,0.4,38.21666667,9/21/2014,2014,3,21,14,home,12,GBP,238,147,40,74,19,7,Win,115,76,2,2,1,DET,26,353,223,3
0.571428571,0.4,37.05,9/21/2014,2014,3,27,18,away,27,JAX,385,239,46,74,44,17,Win,144,105,2,4,3,IND,61,529,344,0
0.4,0.571428571,22.95,9/21/2014,2014,3,18,27,home,-27,IND,239,385,15,55,17,44,Loss,105,144,4,2,0,JAX,61,344,529,3
0.384615385,0.5,28.41666667,9/21/2014,2014,3,14,21,away,-7,NEP,174,221,49,56,9,16,Loss,67,76,0,2,0,OAK,25,241,297,1
0.5,0.384615385,31.58333333,9/21/2014,2014,3,21,14,home,7,OAK,221,174,59,71,16,9,Win,76,67,2,0,1,NEP,25,297,241,0
0.5,0.615384615,32.33333333,9/21/2014,2014,3,20,24,away,-9,ARI,236,254,107,61,14,23,Loss,82,84,1,0,1,SFO,37,318,338,0
0.615384615,0.5,27.66666667,9/21/2014,2014,3,24,20,home,9,SFO,254,236,36,61,23,14,Win,84,82,0,1,0,ARI,37,338,318,1
0.375,0.411764706,27.7,9/21/2014,2014,3,20,26,away,-6,SEA,296,255,27,70,0,6,Loss,36,129,1,3,1,DEN,6,332,384,2
0.411764706,0.375,38.06666667,9/21/2014,2014,3,26,20,home,6,DEN,255,296,34,75,6,0,Win,129,36,3,1,2,SEA,6,384,332,1
0.5625,0.266666667,33.7,9/21/2014,2014,3,23,18,away,19,MIA,168,191,23,71,34,15,Win,174,141,5,4,0,KCC,49,342,332,2
0.266666667,0.5625,26.3,9/21/2014,2014,3,18,23,home,-19,KCC,191,168,65,67,15,34,Loss,141,174,4,5,2,MIA,49,332,342,0
0.272727273,0.333333333,34.65,9/21/2014,2014,3,24,20,away,18,CAR,190,307,91,65,37,19,Win,264,42,1,3,2,PIT,56,454,349,0
0.333333333,0.272727273,25.35,9/21/2014,2014,3,20,24,home,-18,PIT,307,190,105,54,19,37,Loss,42,264,3,1,0,CAR,56,349,454,2
0.466666667,0.4,28.13333333,9/22/2014,2014,3,17,21,away,8,NYJ,197,300,95,63,27,19,Win,60,114,4,3,3,CHI,46,257,414,1
0.4,0.466666667,31.86666667,9/22/2014,2014,3,21,17,home,-8,CHI,300,197,78,72,19,27,Loss,114,60,3,4,1,NYJ,46,414,257,3
0.6875,0.125,37.28333333,9/25/2014,2014,4,31,17,away,31,WAS,295,243,66,78,45,14,Win,154,86,1,2,6,NYG,59,449,329,1
0.125,0.6875,22.71666667,9/25/2014,2014,4,17,31,home,-31,NYG,243,295,88,52,14,45,Loss,86,154,2,1,1,WAS,59,329,449,6
0.5,0.636363636,23.63333333,9/28/2014,2014,4,21,33,away,21,CHI,302,261,70,47,38,17,Win,56,235,1,1,2,GBP,55,358,496,0
0.636363636,0.5,36.36666667,9/28/2014,2014,4,33,21,home,-21,GBP,261,302,46,77,17,38,Loss,235,56,1,1,0,CHI,55,496,358,2
0.3125,0.357142857,29.06666667,9/28/2014,2014,4,17,19,away,-6,HOU,220,264,40,69,17,23,Loss,96,37,2,3,3,BUF,40,316,301,2
0.357142857,0.3125,30.93333333,9/28/2014,2014,4,19,17,home,6,BUF,264,220,90,63,23,17,Win,37,96,3,2,2,HOU,40,301,316,3
0.111111111,0.5,17.65,9/28/2014,2014,4,16,31,away,-24,IND,176,393,68,47,17,41,Loss,85,105,3,0,1,TEN,58,261,498,3
0.5,0.111111111,42.35,9/28/2014,2014,4,31,16,home,24,TEN,393,176,88,82,41,17,Win,105,85,0,3,3,IND,58,498,261,1
0.666666667,0.769230769,29.6,9/28/2014,2014,4,20,25,away,-28,BAL,248,327,59,62,10,38,Loss,67,127,2,0,0,CAR,48,315,454,1
0.769230769,0.666666667,30.4,9/28/2014,2014,4,25,20,home,28,CAR,327,248,40,61,38,10,Win,127,67,0,2,1,BAL,48,454,315,0
0.4,0.466666667,34.88333333,9/28/2014,2014,4,17,17,away,7,NYJ,272,204,33,65,24,17,Win,88,132,4,2,2,DET,41,360,336,0
0.466666667,0.4,25.11666667,9/28/2014,2014,4,17,17,home,-7,DET,204,272,32,62,17,24,Loss,132,88,2,4,0,NYJ,41,336,360,2
0.538461538,0.428571429,25.75,9/28/2014,2014,4,21,27,away,3,PIT,287,305,50,63,27,24,Win,63,85,1,5,1,TBB,51,350,390,1
0.428571429,0.538461538,34.25,9/28/2014,2014,4,27,21,home,-3,TBB,305,287,125,73,24,27,Loss,85,63,5,1,1,PIT,51,390,350,1
0.454545455,0.428571429,30.9,9/28/2014,2014,4,24,17,away,24,OAK,278,264,35,66,38,14,Win,157,53,0,2,4,MIA,52,435,317,3
0.428571429,0.454545455,29.1,9/28/2014,2014,4,17,24,home,-24,MIA,264,278,80,64,14,38,Loss,53,157,2,0,3,OAK,52,317,435,4
0.642857143,0.5625,30.56666667,9/28/2014,2014,4,21,19,away,-19,LAC,235,365,32,65,14,33,Loss,85,42,3,2,0,JAX,47,320,407,3
0.5625,0.642857143,29.43333333,9/28/2014,2014,4,19,21,home,19,JAX,365,235,57,61,33,14,Win,42,85,2,3,3,LAC,47,407,320,0
0.384615385,0.421052632,17.71666667,9/28/2014,2014,4,11,20,away,-5,SFO,191,189,70,56,21,26,Loss,22,218,1,4,1,PHI,47,213,407,4
0.421052632,0.384615385,42.28333333,9/28/2014,2014,4,20,11,home,5,PHI,189,191,80,76,26,21,Win,218,22,4,1,4,SFO,47,407,213,1
0.666666667,0.461538462,27.13333333,9/28/2014,2014,4,23,26,away,-13,MIN,288,317,50,64,28,41,Loss,123,241,1,0,0,ATL,69,411,558,2
0.461538462,0.666666667,32.86666667,9/28/2014,2014,4,26,23,home,13,ATL,317,288,40,74,41,28,Win,241,123,0,1,2,MIN,69,558,411,0
0.4,0.571428571,25.25,9/28/2014,2014,4,20,24,away,-21,DAL,334,255,20,59,17,38,Loss,104,190,2,1,0,NOS,55,438,445,3
0.571428571,0.4,34.75,9/28/2014,2014,4,24,20,home,21,NOS,255,334,50,65,38,17,Win,190,104,1,2,3,DAL,55,445,438,0
0.222222222,0.583333333,23.55,9/29/2014,2014,4,13,26,away,-27,KCC,215,236,30,49,14,41,Loss,75,207,3,2,0,NEP,55,290,443,3
0.583333333,0.222222222,36.45,9/29/2014,2014,4,26,13,home,27,NEP,236,215,35,66,41,14,Win,207,75,2,3,3,KCC,55,443,290,0
0.333333333,0.363636364,32.15,10/2/2014,2014,5,20,15,away,-32,GBP,188,164,91,75,10,42,Loss,111,156,6,2,1,MIN,52,299,320,3
0.363636364,0.333333333,27.85,10/2/2014,2014,5,15,20,home,32,MIN,164,188,30,52,42,10,Win,156,111,2,6,3,GBP,52,320,299,1
0.384615385,0.416666667,32.98333333,10/5/2014,2014,5,17,22,away,-7,CAR,262,231,79,62,24,31,Loss,85,91,4,2,3,CHI,55,347,322,4
0.416666667,0.384615385,27.01666667,10/5/2014,2014,5,22,17,home,7,CHI,231,262,30,63,31,24,Win,91,85,2,4,4,CAR,55,322,347,3
0.333333333,0.571428571,29.28333333,10/5/2014,2014,5,27,22,away,1,TEN,284,261,74,74,29,28,Win,176,149,1,3,0,CLE,57,460,410,1
0.571428571,0.333333333,30.71666667,10/5/2014,2014,5,22,27,home,-1,CLE,261,284,68,65,28,29,Loss,149,176,3,1,1,TEN,57,410,460,0
0.5,0.533333333,33.08333333,10/5/2014,2014,5,29,22,away,-6,PHI,341,207,82,76,28,34,Loss,125,145,4,0,3,LAR,62,466,352,3
0.533333333,0.5,26.91666667,10/5/2014,2014,5,22,29,home,6,LAR,207,341,39,70,34,28,Win,145,125,0,4,3,PHI,62,352,466,3
0.153846154,0.6,28.31666667,10/5/2014,2014,5,20,22,away,-10,NYG,307,193,81,67,20,30,Loss,90,124,1,1,2,ATL,50,397,317,1
0.6,0.153846154,31.68333333,10/5/2014,2014,5,22,20,home,10,ATL,193,307,15,65,30,20,Win,124,90,1,1,1,NYG,50,317,397,2
0.333333333,0.461538462,27.06666667,10/5/2014,2014,5,20,34,away,-6,NOS,248,371,113,54,0,6,Loss,66,140,1,0,3,TBB,6,314,511,1
0.461538462,0.333333333,38.53333333,10/5/2014,2014,5,34,20,home,6,TBB,371,248,50,86,6,0,Win,140,66,0,1,1,NOS,6,511,314,3
0.307692308,0.571428571,31.13333333,10/5/2014,2014,5,15,24,away,-3,DAL,154,316,35,56,0,3,Loss,176,140,0,1,3,HOU,3,330,456,1
0.571428571,0.307692308,36.11666667,10/5/2014,2014,5,24,15,home,3,HOU,316,154,56,75,3,0,Win,140,176,1,0,1,DAL,3,456,330,3
0.3125,0.090909091,32.31666667,10/5/2014,2014,5,19,13,away,3,DET,294,204,74,67,17,14,Win,49,69,2,6,2,BUF,31,343,273,1
0.090909091,0.3125,27.68333333,10/5/2014,2014,5,13,19,home,-3,BUF,204,294,62,57,14,17,Loss,69,49,6,2,1,DET,31,273,343,2
0.090909091,0.466666667,21.28333333,10/5/2014,2014,5,15,26,away,-7,IND,197,305,36,57,13,20,Loss,90,127,4,1,4,BAL,33,287,432,3
0.466666667,0.090909091,38.71666667,10/5/2014,2014,5,26,15,home,7,BAL,305,197,83,80,20,13,Win,127,90,1,4,3,IND,33,432,287,4
0.5,0.25,35.28333333,10/5/2014,2014,5,20,12,away,8,JAX,261,187,50,68,17,9,Win,111,56,4,1,2,PIT,26,372,243,1
0.25,0.5,24.71666667,10/5/2014,2014,5,12,20,home,-8,PIT,187,261,34,52,9,17,Loss,56,111,1,4,1,JAX,26,243,372,2
0.1875,0.4375,24.71666667,10/5/2014,2014,5,9,24,away,-21,DEN,178,476,15,56,20,41,Loss,37,92,3,1,2,ARI,61,215,568,0
0.4375,0.1875,35.28333333,10/5/2014,2014,5,24,9,home,21,ARI,476,178,67,76,41,20,Win,92,37,1,3,0,DEN,61,568,215,2
0.545454545,0.375,23.93333333,10/5/2014,2014,5,14,22,away,-5,SFO,158,186,29,50,17,22,Loss,107,171,0,3,0,KCC,39,265,357,1
0.375,0.545454545,36.06666667,10/5/2014,2014,5,22,14,home,5,KCC,186,158,10,70,22,17,Win,171,107,3,0,1,SFO,39,357,265,0
0.083333333,0.666666667,21.1,10/5/2014,2014,5,11,21,away,-31,LAC,60,277,94,54,0,31,Loss,91,162,2,3,1,NYJ,31,151,439,2
0.666666667,0.083333333,38.9,10/5/2014,2014,5,21,11,home,31,NYJ,277,60,76,71,31,0,Win,162,91,3,2,2,LAC,31,439,151,1
0,0.375,21.06666667,10/5/2014,2014,5,17,30,away,-26,NEP,241,285,37,48,17,43,Loss,79,220,1,1,0,CIN,60,320,505,3
0.375,0,38.93333333,10/5/2014,2014,5,30,17,home,26,CIN,285,241,114,82,43,17,Win,220,79,1,1,3,NEP,60,505,320,0
0.357142857,0.25,34.93333333,10/6/2014,2014,5,20,14,away,10,WAS,178,275,90,63,27,17,Win,225,32,3,1,0,SEA,44,403,307,0
0.25,0.357142857,25.06666667,10/6/2014,2014,5,14,20,home,-10,SEA,275,178,30,54,17,27,Loss,32,225,1,3,0,WAS,44,307,403,0
0.5,0.125,36.81666667,10/9/2014,2014,6,27,18,away,5,HOU,363,196,51,82,33,28,Win,93,136,3,5,2,IND,61,456,332,2
0.125,0.5,23.18333333,10/9/2014,2014,6,18,27,home,-5,IND,196,363,66,52,28,33,Loss,136,93,5,3,2,HOU,61,332,456,2
0.533333333,0.272727273,31.11666667,10/12/2014,2014,6,27,14,away,-2,TEN,297,220,35,75,14,16,Loss,82,70,6,3,0,JAX,30,379,290,2
0.272727273,0.533333333,28.88333333,10/12/2014,2014,6,14,27,home,2,JAX,220,297,48,55,16,14,Win,70,82,3,6,2,TEN,30,290,379,0
0.538461538,0.166666667,32.23333333,10/12/2014,2014,6,23,22,away,31,TBB,306,277,70,63,48,17,Win,169,87,0,5,1,BAL,65,475,364,1
0.166666667,0.538461538,27.76666667,10/12/2014,2014,6,22,23,home,-31,BAL,277,306,43,67,17,48,Loss,87,169,5,0,1,TBB,65,364,475,1
0.4375,0.357142857,33.56666667,10/12/2014,2014,6,21,15,away,14,NYJ,221,173,101,68,31,17,Win,138,31,2,4,2,DEN,48,359,204,0
0.357142857,0.4375,26.43333333,10/12/2014,2014,6,15,21,home,-14,DEN,173,221,9,62,17,31,Loss,31,138,4,2,0,NYJ,48,204,359,2
0.076923077,0.214285714,32.35,10/12/2014,2014,6,18,15,away,14,MIN,155,143,40,65,17,3,Win,100,69,4,8,3,DET,20,255,212,0
0.214285714,0.076923077,27.65,10/12/2014,2014,6,15,18,home,-14,DET,143,155,60,63,3,17,Loss,69,100,8,4,0,MIN,20,212,255,3
0.466666667,0.533333333,30.33333333,10/12/2014,2014,6,22,19,away,15,BUF,346,268,60,66,37,22,Win,50,68,2,5,3,NEP,59,396,336,0
0.533333333,0.466666667,29.66666667,10/12/2014,2014,6,19,22,home,-15,NEP,268,346,107,66,22,37,Loss,68,50,5,2,0,BUF,59,336,396,3
0.470588235,0.625,39.5,10/12/2014,2014,6,29,29,away,0,CIN,284,320,60,80,3,3,Tie,147,193,0,1,2,CAR,6,431,513,1
0.625,0.470588235,35.5,10/12/2014,2014,6,29,29,home,0,CAR,320,284,119,75,3,3,Tie,193,147,1,0,1,CIN,6,513,431,2
0.375,0.363636364,33.08333333,10/12/2014,2014,6,22,19,away,-21,CLE,221,210,42,76,10,31,Loss,138,158,2,1,1,PIT,41,359,368,1
0.363636364,0.375,26.91666667,10/12/2014,2014,6,19,22,home,21,PIT,210,221,60,56,31,10,Win,158,138,1,2,1,CLE,41,368,359,1
0.470588235,0.4,37.2,10/12/2014,2014,6,27,19,away,3,MIA,248,237,44,79,27,24,Win,121,112,3,1,3,GBP,51,369,349,0
0.4,0.470588235,22.8,10/12/2014,2014,6,19,27,home,-3,GBP,237,248,25,55,24,27,Loss,112,121,1,3,0,MIA,51,349,369,3
0.571428571,0.615384615,37.03333333,10/12/2014,2014,6,24,17,away,3,OAK,307,282,60,69,31,28,Win,116,114,1,0,1,LAC,59,423,396,0
0.615384615,0.571428571,22.96666667,10/12/2014,2014,6,17,24,home,-3,LAC,282,307,78,54,28,31,Loss,114,116,0,1,0,OAK,59,396,423,1
0.466666667,0.307692308,36.25,10/12/2014,2014,6,23,12,away,14,ATL,375,245,47,69,27,13,Win,103,42,2,4,1,CHI,40,478,287,0
0.307692308,0.466666667,23.75,10/12/2014,2014,6,12,23,home,-14,CHI,245,375,52,54,13,27,Loss,42,103,4,2,0,ATL,40,287,478,1
0.588235294,0.384615385,37.65,10/12/2014,2014,6,23,9,away,7,SEA,239,126,46,69,30,23,Win,162,80,1,2,1,DAL,53,401,206,2
0.384615385,0.588235294,22.35,10/12/2014,2014,6,9,23,home,-7,DAL,126,239,58,48,23,30,Loss,80,162,2,1,2,SEA,53,206,401,1
0.2,0.411764706,25.68333333,10/12/2014,2014,6,21,19,away,-10,ARI,335,243,62,57,20,30,Loss,72,74,2,1,0,WAS,50,407,317,4
0.411764706,0.2,34.31666667,10/12/2014,2014,6,19,21,home,10,WAS,243,335,108,68,30,20,Win,74,72,1,2,4,ARI,50,317,407,0
0.142857143,0.307692308,27.56666667,10/12/2014,2014,6,12,24,away,-27,PHI,168,245,75,60,0,27,Loss,86,203,8,1,2,NYG,27,254,448,1
0.307692308,0.142857143,32.43333333,10/12/2014,2014,6,24,12,home,27,NYG,245,168,25,71,27,0,Win,203,86,1,8,1,PHI,27,448,254,2
0.428571429,0.357142857,28.63333333,10/13/2014,2014,6,17,19,away,14,LAR,343,216,23,65,31,17,Win,89,93,0,5,1,SFO,48,432,309,1
0.357142857,0.428571429,31.36666667,10/13/2014,2014,6,19,17,home,-14,SFO,216,343,38,71,17,31,Loss,93,89,5,0,1,LAR,48,309,432,1
0.5625,0.461538462,40.9,10/16/2014,2014,7,28,16,away,-2,NEP,205,260,70,80,25,27,Loss,218,63,3,1,0,NYJ,52,423,323,0
0.461538462,0.5625,19.1,10/16/2014,2014,7,16,28,home,2,NYJ,260,205,64,53,27,25,Win,63,218,1,3,0,NEP,52,323,423,0
0.266666667,0.363636364,26.78333333,10/19/2014,2014,7,16,23,away,-22,BAL,186,248,76,65,7,29,Loss,68,123,5,1,3,ATL,36,254,371,1
0.363636364,0.266666667,33.21666667,10/19/2014,2014,7,23,16,home,22,ATL,248,186,72,62,29,7,Win,123,68,1,5,1,BAL,36,371,254,3
0.272727273,0.272727273,30.93333333,10/19/2014,2014,7,14,16,away,-2,WAS,160,251,96,49,17,19,Loss,76,100,1,3,2,TEN,36,236,351,2
0.272727273,0.272727273,29.06666667,10/19/2014,2014,7,16,14,home,2,TEN,251,160,50,57,19,17,Win,100,76,3,1,2,WAS,36,351,236,2
0.5,0.444444444,32.4,10/19/2014,2014,7,25,18,away,-2,LAR,292,173,86,68,26,28,Loss,171,102,3,0,0,SEA,54,463,275,0
0.444444444,0.5,27.6,10/19/2014,2014,7,18,25,home,2,SEA,173,292,20,48,28,26,Win,102,171,0,3,0,LAR,54,275,463,0
0.235294118,0.3125,28.45,10/19/2014,2014,7,13,20,away,-18,JAX,197,151,50,74,6,24,Loss,69,185,3,2,3,CLE,30,266,336,3
0.3125,0.235294118,31.55,10/19/2014,2014,7,20,13,home,18,CLE,151,197,25,68,24,6,Win,185,69,2,3,3,JAX,30,336,266,3
0.076923077,0.384615385,20.28333333,10/19/2014,2014,7,8,27,away,-27,IND,103,335,20,54,0,27,Loss,32,171,4,2,2,CIN,27,135,506,0
0.384615385,0.076923077,39.71666667,10/19/2014,2014,7,27,8,home,27,CIN,335,103,57,78,27,0,Win,171,32,2,4,0,IND,27,506,135,2
0.3125,0.333333333,32.38333333,10/19/2014,2014,7,16,22,away,-1,BUF,118,255,50,60,16,17,Loss,158,118,5,6,4,MIN,33,276,373,2
0.333333333,0.3125,27.61666667,10/19/2014,2014,7,22,16,home,1,MIN,255,118,48,68,17,16,Win,118,158,6,5,2,BUF,33,373,276,4
0.363636364,0.416666667,37.36666667,10/19/2014,2014,7,24,14,away,13,CHI,256,172,84,69,27,14,Win,137,52,4,3,3,MIA,41,393,224,0
0.416666667,0.363636364,22.63333333,10/19/2014,2014,7,14,24,home,-13,MIA,172,256,15,51,14,27,Loss,52,137,3,4,0,CHI,41,224,393,3
0.25,0.466666667,27.7,10/19/2014,2014,7,25,21,away,-1,DET,335,285,134,67,23,24,Loss,73,59,1,3,2,NOS,47,408,344,2
0.466666667,0.25,32.3,10/19/2014,2014,7,21,25,home,1,NOS,285,335,71,67,24,23,Win,59,73,3,1,2,DET,47,344,408,2
0.333333333,0.363636364,30.18333333,10/19/2014,2014,7,23,22,away,-21,GBP,223,241,70,67,17,38,Loss,108,122,3,2,0,CAR,55,331,363,1
0.363636364,0.333333333,29.81666667,10/19/2014,2014,7,22,23,home,21,CAR,241,223,29,56,38,17,Win,122,108,2,3,1,GBP,55,363,331,0
0.5,0.3,39,10/19/2014,2014,7,22,19,away,3,LAC,211,182,73,70,23,20,Win,154,69,3,2,1,KCC,43,365,251,0
0.3,0.5,21,10/19/2014,2014,7,19,22,home,-3,KCC,182,211,49,49,20,23,Loss,69,154,2,3,0,LAC,43,251,365,1
0.6,0.333333333,36.95,10/19/2014,2014,7,25,13,away,11,OAK,242,164,43,69,24,13,Win,123,56,1,1,0,ARI,37,365,220,1
0.333333333,0.6,23.05,10/19/2014,2014,7,13,25,home,-11,ARI,164,242,74,48,13,24,Loss,56,123,1,1,1,OAK,37,220,365,0
0.384615385,0.642857143,26.18333333,10/19/2014,2014,7,20,20,away,-10,DAL,248,267,40,59,21,31,Loss,104,156,0,2,1,NYG,52,352,423,2
0.642857143,0.384615385,33.81666667,10/19/2014,2014,7,20,20,home,10,NYG,267,248,46,60,31,21,Win,156,104,2,0,2,DAL,52,423,352,1
0.230769231,0.555555556,32.01666667,10/19/2014,2014,7,22,23,away,-25,DEN,248,304,62,70,17,42,Loss,62,115,6,2,0,SFO,59,310,419,1
0.555555556,0.230769231,27.98333333,10/19/2014,2014,7,23,22,home,25,SFO,304,248,75,56,42,17,Win,115,62,2,6,1,DEN,59,419,310,0
0.333333333,0.357142857,27.9,10/20/2014,2014,7,20,18,away,-7,PIT,261,252,20,63,23,30,Loss,132,76,1,3,1,HOU,53,393,328,3
0.357142857,0.333333333,32.1,10/20/2014,2014,7,18,20,home,7,HOU,252,261,38,62,30,23,Win,76,132,3,1,3,PIT,53,328,393,1
0.4,0.615384615,29.23333333,10/23/2014,2014,8,22,27,away,-14,DEN,245,286,77,58,21,35,Loss,61,139,2,0,0,LAC,56,306,425,2
0.615384615,0.4,30.76666667,10/23/2014,2014,8,27,22,home,14,LAC,286,245,71,65,35,21,Win,139,61,0,2,2,DEN,56,425,306,0
0.533333333,0.5,30.91666667,10/26/2014,2014,8,22,22,away,1,ATL,325,213,85,70,22,21,Win,60,78,0,2,1,DET,43,385,291,1
0.5,0.533333333,29.08333333,10/26/2014,2014,8,22,22,home,-1,DET,213,325,39,55,21,22,Loss,78,60,2,0,1,ATL,43,291,385,1
0.272727273,0.5,24.36666667,10/26/2014,2014,8,13,23,away,-27,KCC,116,215,68,51,7,34,Loss,84,140,7,2,1,LAR,41,200,355,1
0.5,0.272727273,35.63333333,10/26/2014,2014,8,23,13,home,27,LAR,215,116,51,64,34,7,Win,140,84,2,7,1,KCC,41,355,200,1
0.4375,0.166666667,35.36666667,10/26/2014,2014,8,24,13,away,14,TEN,193,290,35,80,30,16,Win,212,36,5,2,2,HOU,46,405,326,0
0.166666667,0.4375,24.63333333,10/26/2014,2014,8,13,24,home,-14,HOU,290,193,61,56,16,30,Loss,36,212,2,5,0,TEN,46,326,405,2
0.4,0.083333333,30.56666667,10/26/2014,2014,8,22,15,away,6,TBB,235,159,59,65,6,0,Win,97,66,1,5,2,MIN,6,332,225,0
0.083333333,0.4,29.71666667,10/26/2014,2014,8,15,22,home,-6,MIN,159,235,52,56,0,6,Loss,66,97,5,1,0,TBB,6,225,332,2
0.363636364,0.2,29,10/26/2014,2014,8,19,17,away,4,CAR,191,152,41,59,13,9,Win,119,114,1,3,2,SEA,22,310,266,2
0.2,0.363636364,31,10/26/2014,2014,8,17,19,home,-4,SEA,152,191,20,56,9,13,Loss,114,119,3,1,2,CAR,22,266,310,2
0.384615385,0.571428571,29.26666667,10/26/2014,2014,8,18,19,away,-3,CIN,187,239,51,61,24,27,Loss,107,111,1,2,2,BAL,51,294,350,2
0.571428571,0.384615385,30.73333333,10/26/2014,2014,8,19,18,home,3,BAL,239,187,40,64,27,24,Win,111,107,2,1,2,CIN,51,350,294,2
0.416666667,0.4,27.61666667,10/26/2014,2014,8,17,19,away,14,JAX,178,201,52,56,27,13,Win,148,176,3,4,3,MIA,40,326,377,1
0.4,0.416666667,32.38333333,10/26/2014,2014,8,19,17,home,-14,MIA,201,178,37,68,13,27,Loss,176,148,4,3,1,JAX,40,377,326,3
0.363636364,0.636363636,27.28333333,10/26/2014,2014,8,27,32,away,-28,NEP,231,365,41,64,23,51,Loss,153,122,3,1,0,CHI,74,384,487,2
0.636363636,0.363636364,32.71666667,10/26/2014,2014,8,32,27,home,28,CHI,365,231,38,71,51,23,Win,122,153,1,3,2,NEP,74,487,384,0
0.25,0.473684211,27.71666667,10/26/2014,2014,8,12,22,away,20,NYJ,213,137,49,53,43,23,Win,67,175,4,4,6,BUF,66,280,312,0
0.473684211,0.25,32.28333333,10/26/2014,2014,8,22,12,home,-20,BUF,137,213,90,81,23,43,Loss,175,67,4,4,0,NYJ,66,312,280,6
0.45,0.411764706,31.16666667,10/26/2014,2014,8,27,17,away,-4,ARI,411,329,103,87,20,24,Loss,110,71,0,0,1,PHI,44,521,400,3
0.411764706,0.45,28.83333333,10/26/2014,2014,8,17,27,home,4,PHI,329,411,95,65,24,20,Win,71,110,0,0,3,ARI,44,400,521,1
0.315789474,0.166666667,34.86666667,10/26/2014,2014,8,19,15,away,-10,CLE,311,267,54,81,13,23,Loss,76,39,4,1,0,OAK,36,387,306,3
0.166666667,0.315789474,25.13333333,10/26/2014,2014,8,15,19,home,10,OAK,267,311,30,54,23,13,Win,39,76,1,4,3,CLE,36,306,387,0
0.5,0.615384615,20.28333333,10/26/2014,2014,8,26,34,away,-17,PIT,385,522,43,57,34,51,Loss,63,117,2,0,2,IND,85,448,639,2
0.615384615,0.5,39.71666667,10/26/2014,2014,8,34,26,home,17,IND,522,385,59,81,51,34,Win,117,63,0,2,2,PIT,85,639,448,2
0.142857143,0.6,28.35,10/26/2014,2014,8,23,28,away,-21,NOS,402,302,84,63,23,44,Loss,89,193,4,2,1,GBP,67,491,495,3
0.6,0.142857143,31.65,10/26/2014,2014,8,28,23,home,21,GBP,302,402,35,65,44,23,Win,193,89,2,4,3,NOS,67,495,491,1
0.428571429,0.416666667,38.2,10/27/2014,2014,8,19,20,away,3,DAL,286,224,45,64,3,0,Win,123,171,3,5,2,WAS,3,409,395,1
0.416666667,0.428571429,28.61666667,10/27/2014,2014,8,20,19,home,-3,WAS,224,286,35,64,0,3,Loss,171,123,5,3,1,DAL,3,395,409,2
0.538461538,0.428571429,35.3,10/30/2014,2014,9,27,15,away,18,CAR,270,122,36,75,28,10,Win,105,109,4,4,2,NOS,38,375,231,2
0.428571429,0.538461538,24.7,10/30/2014,2014,9,15,27,home,-18,NOS,122,270,67,54,10,28,Loss,109,105,4,4,2,CAR,38,231,375,2
0.333333333,0.357142857,30.53333333,11/2/2014,2014,9,20,19,away,-5,CLE,252,274,33,61,17,22,Loss,113,56,2,4,2,TBB,39,365,330,2
0.357142857,0.333333333,29.46666667,11/2/2014,2014,9,19,20,home,5,TBB,274,252,44,65,22,17,Win,56,113,4,2,2,CLE,39,330,365,2
0.6,0.272727273,31.46666667,11/2/2014,2014,9,22,18,away,11,DAL,237,174,62,65,28,17,Win,102,92,2,1,2,ARI,45,339,266,1
0.272727273,0.6,28.53333333,11/2/2014,2014,9,18,22,home,-11,ARI,174,237,33,59,17,28,Loss,92,102,1,2,1,DAL,45,266,339,2
0.5625,0.384615385,32.21666667,11/2/2014,2014,9,30,15,away,10,HOU,293,182,55,79,31,21,Win,190,118,4,4,1,PHI,52,483,300,4
0.384615385,0.5625,27.78333333,11/2/2014,2014,9,15,30,home,-10,PHI,182,293,54,59,21,31,Loss,118,190,4,4,4,HOU,52,300,483,1
0.333333333,0.615384615,31.58333333,11/2/2014,2014,9,22,23,away,-14,KCC,225,196,40,69,10,24,Loss,139,113,3,1,0,NYJ,34,364,309,0
0.615384615,0.333333333,28.41666667,11/2/2014,2014,9,23,22,home,14,NYJ,196,225,20,56,24,10,Win,113,139,1,3,0,KCC,34,309,364,0
0.333333333,0.461538462,27.26666667,11/2/2014,2014,9,19,23,away,-10,CIN,233,232,35,60,23,33,Loss,132,191,2,2,2,JAX,56,365,423,1
0.461538462,0.333333333,32.73333333,11/2/2014,2014,9,23,19,home,10,JAX,232,233,40,67,33,23,Win,191,132,2,2,1,CIN,56,423,365,2
0.272727273,0.571428571,23.88333333,11/2/2014,2014,9,10,28,away,-37,MIA,128,309,57,49,0,37,Loss,50,132,4,0,0,LAC,37,178,441,4
0.571428571,0.272727273,36.11666667,11/2/2014,2014,9,28,10,home,37,LAC,309,128,25,74,37,0,Win,132,50,0,4,4,MIA,37,441,178,0
0.461538462,0.533333333,29.56666667,11/2/2014,2014,9,21,24,away,-3,MIN,225,252,55,62,26,29,Loss,122,100,5,2,0,WAS,55,347,352,1
0.533333333,0.461538462,30.43333333,11/2/2014,2014,9,24,21,home,3,WAS,252,225,60,71,29,26,Win,100,122,2,5,1,MIN,55,352,347,0
0.333333333,0.25,27.56666667,11/2/2014,2014,9,13,20,away,3,SFO,102,183,83,52,13,10,Win,91,80,1,8,2,LAR,23,193,263,2
0.25,0.333333333,32.43333333,11/2/2014,2014,9,20,13,home,-3,LAR,183,102,44,62,10,13,Loss,80,91,8,1,2,SFO,23,263,193,2
0.272727273,0.375,30.55,11/2/2014,2014,9,26,29,away,-22,NEP,429,332,72,75,21,43,Loss,43,66,1,1,1,DEN,64,472,398,2
0.375,0.272727273,29.45,11/2/2014,2014,9,29,26,home,22,DEN,332,429,71,79,43,21,Win,66,43,1,1,2,NEP,64,398,472,1
0.333333333,0.388888889,24.9,11/2/2014,2014,9,17,21,away,-6,SEA,189,177,69,60,24,30,Loss,37,149,1,1,0,OAK,54,226,326,3
0.388888889,0.333333333,35.1,11/2/2014,2014,9,21,17,home,6,OAK,177,189,65,74,30,24,Win,149,37,1,1,3,SEA,54,326,226,0
0.230769231,0.428571429,28.56666667,11/2/2014,2014,9,22,22,away,-20,PIT,269,321,108,67,23,43,Loss,63,55,4,3,1,BAL,66,332,376,2
0.428571429,0.230769231,31.43333333,11/2/2014,2014,9,22,22,home,20,BAL,321,269,67,65,43,23,Win,55,63,3,4,2,PIT,66,376,332,1
0.333333333,0.25,33.05,11/3/2014,2014,9,22,22,away,16,NYG,345,349,30,71,40,24,Win,98,89,1,3,1,IND,64,443,438,0
0.25,0.333333333,26.95,11/3/2014,2014,9,22,22,home,-16,IND,349,345,30,75,24,40,Loss,89,98,3,1,0,NYG,64,438,443,1
0.4375,0.176470588,35.81666667,11/6/2014,2014,10,21,11,away,21,CIN,198,79,62,75,24,3,Win,170,86,0,2,4,CLE,27,368,165,1
0.176470588,0.4375,24.18333333,11/6/2014,2014,10,11,21,home,-21,CLE,79,198,55,63,3,24,Loss,86,170,2,0,1,CIN,27,165,368,4
0.230769231,0.4375,29.3,11/9/2014,2014,10,16,21,away,4,BUF,151,253,19,59,17,13,Win,127,111,6,1,3,KCC,30,278,364,1
0.4375,0.230769231,30.7,11/9/2014,2014,10,21,16,home,-4,KCC,253,151,44,71,13,17,Loss,111,127,1,6,1,BUF,30,364,278,3
0.357142857,0.25,28.43333333,11/9/2014,2014,10,20,19,away,-4,DET,178,288,44,60,16,20,Loss,50,63,3,3,1,MIA,36,228,351,2
0.25,0.357142857,31.56666667,11/9/2014,2014,10,19,20,home,4,MIA,288,178,98,64,20,16,Win,63,50,3,3,2,DET,36,351,228,1
0.307692308,0.285714286,31.53333333,11/9/2014,2014,10,16,20,away,14,JAX,248,262,65,59,31,17,Win,151,71,1,4,3,DAL,48,399,333,1
0.285714286,0.307692308,28.46666667,11/9/2014,2014,10,20,16,home,-14,DAL,262,248,19,65,17,31,Loss,71,151,4,1,1,JAX,48,333,399,3
0.4,0.444444444,33.76666667,11/9/2014,2014,10,21,23,away,3,NOS,186,287,15,68,3,0,Win,144,136,4,2,3,SFO,3,330,423,1
0.444444444,0.4,36,11/9/2014,2014,10,23,21,home,-3,SFO,287,186,43,80,0,3,Loss,136,144,2,4,1,NOS,3,423,330,3
0.333333333,0.307692308,29.21666667,11/9/2014,2014,10,14,18,away,-14,BAL,143,161,67,54,7,21,Loss,67,151,5,1,0,TEN,28,210,312,2
0.307692308,0.333333333,30.78333333,11/9/2014,2014,10,18,14,home,14,TEN,161,143,40,62,21,7,Win,151,67,1,5,2,BAL,28,312,210,0
0.545454545,0.4,29.45,11/9/2014,2014,10,22,15,away,-7,NYJ,326,125,20,62,13,20,Loss,36,150,2,4,0,PIT,33,362,275,4
0.4,0.545454545,30.55,11/9/2014,2014,10,15,22,home,7,PIT,125,326,75,58,20,13,Win,150,36,4,2,4,NYJ,33,275,362,0
0.5,0.705882353,29.8,11/9/2014,2014,10,19,23,away,10,TBB,212,281,30,60,27,17,Win,110,92,1,4,3,ATL,44,322,373,0
0.705882353,0.5,30.2,11/9/2014,2014,10,23,19,home,-10,ATL,281,212,79,70,17,27,Loss,92,110,4,1,0,TBB,44,373,322,3
0.466666667,0.277777778,32.36666667,11/9/2014,2014,10,25,10,away,24,OAK,353,192,95,76,41,17,Win,118,30,0,0,3,DEN,58,471,222,2
0.277777778,0.466666667,27.63333333,11/9/2014,2014,10,10,25,home,-24,DEN,192,353,37,62,17,41,Loss,30,118,0,0,2,OAK,58,222,471,3
0.1,0.4,26.66666667,11/9/2014,2014,10,16,21,away,-17,ARI,174,307,80,58,14,31,Loss,70,28,6,3,1,LAR,45,244,335,3
0.4,0.1,33.33333333,11/9/2014,2014,10,21,16,home,17,LAR,307,174,35,66,31,14,Win,28,70,3,6,3,ARI,45,335,244,1
0.5,0.583333333,26.8,11/9/2014,2014,10,20,27,away,-21,SEA,270,160,35,63,17,38,Loss,54,350,2,2,3,NYG,55,324,510,2
0.583333333,0.5,33.2,11/9/2014,2014,10,27,20,home,21,NYG,160,270,50,64,38,17,Win,350,54,2,2,2,SEA,55,510,324,3
0.25,0.461538462,30.31666667,11/9/2014,2014,10,21,21,away,-41,GBP,256,319,163,68,14,55,Loss,55,132,4,0,1,CHI,69,311,451,3
0.461538462,0.25,29.68333333,11/9/2014,2014,10,21,21,home,41,CHI,319,256,50,64,55,14,Win,132,55,0,4,3,GBP,69,451,311,1
0.5,0.333333333,38.08333333,11/10/2014,2014,10,21,17,away,-24,PHI,215,328,30,81,21,45,Loss,102,37,9,1,0,CAR,66,317,365,5
0.333333333,0.5,21.91666667,11/10/2014,2014,10,17,21,home,24,CAR,328,215,50,62,45,21,Win,37,102,1,9,5,PHI,66,365,317,0
0.4,0.444444444,27.63333333,11/13/2014,2014,11,13,24,away,-13,MIA,183,205,70,60,9,22,Loss,54,125,2,5,2,BUF,31,237,330,0
0.444444444,0.4,32.36666667,11/13/2014,2014,11,24,13,home,13,BUF,205,183,30,63,22,9,Win,125,54,5,2,0,MIA,31,330,237,2
0.181818182,0.588235294,21.36666667,11/16/2014,2014,11,10,24,away,-8,CHI,147,330,18,46,13,21,Loss,96,138,2,0,2,MIN,34,243,468,1
0.588235294,0.181818182,38.63333333,11/16/2014,2014,11,24,10,home,8,MIN,330,147,60,74,21,13,Win,138,96,0,2,1,CHI,34,468,243,2
0.388888889,0.2,33.88333333,11/16/2014,2014,11,29,24,away,16,CLE,211,310,55,84,23,7,Win,213,65,0,3,2,HOU,30,424,375,1
0.2,0.388888889,26.11666667,11/16/2014,2014,11,24,29,home,-16,HOU,310,211,67,76,7,23,Loss,65,213,3,0,1,CLE,30,375,424,2
0.416666667,0.333333333,36.2,11/16/2014,2014,11,25,20,away,-4,KCC,168,108,50,71,20,24,Loss,204,190,2,0,2,SEA,44,372,298,0
0.333333333,0.416666667,23.8,11/16/2014,2014,11,20,25,home,4,SEA,108,168,6,46,24,20,Win,190,204,0,2,0,KCC,44,298,372,2
0.333333333,0.230769231,31.96666667,11/16/2014,2014,11,22,22,away,2,CAR,260,285,58,74,19,17,Win,86,106,2,2,2,ATL,36,346,391,1
0.230769231,0.333333333,28.03333333,11/16/2014,2014,11,22,22,home,-2,ATL,285,260,15,64,17,19,Loss,106,86,2,2,1,CAR,36,391,346,2
0.692307692,0.615384615,29.23333333,11/16/2014,2014,11,22,24,away,17,NOS,219,255,33,59,27,10,Win,186,75,1,0,1,CIN,37,405,330,0
0.615384615,0.692307692,30.76666667,11/16/2014,2014,11,24,22,home,-17,CIN,255,219,34,67,10,27,Loss,75,186,0,1,0,NOS,37,330,405,1
0.3,0.307692308,25.81666667,11/16/2014,2014,11,12,20,away,20,WAS,281,167,101,46,27,7,Win,48,155,2,6,3,TBB,34,329,322,1
0.307692308,0.3,34.18333333,11/16/2014,2014,11,20,12,home,-20,TBB,167,281,67,69,7,27,Loss,155,48,6,2,1,WAS,34,322,329,3
0.333333333,0.352941176,24.16666667,11/16/2014,2014,11,21,16,away,-15,LAR,369,206,62,66,7,22,Loss,28,131,2,3,0,DEN,29,397,337,2
0.352941176,0.333333333,35.83333333,11/16/2014,2014,11,16,21,home,15,DEN,206,369,25,65,22,7,Win,131,28,3,2,2,LAR,29,337,397,0
0.428571429,0.4,34.98333333,11/16/2014,2014,11,20,17,away,6,NYG,185,265,35,68,16,10,Win,148,65,1,2,5,SFO,26,333,330,1
0.4,0.428571429,25.01666667,11/16/2014,2014,11,17,20,home,-6,SFO,265,185,54,68,10,16,Loss,65,148,2,1,1,NYG,26,330,333,5
0.2,0.266666667,25.23333333,11/16/2014,2014,11,9,18,away,-7,LAC,162,180,41,55,6,13,Loss,71,120,2,2,0,OAK,19,233,300,1
0.266666667,0.2,34.76666667,11/16/2014,2014,11,18,9,home,7,OAK,180,162,40,68,13,6,Win,120,71,2,2,1,LAC,19,300,233,0
0.333333333,0.571428571,27.3,11/16/2014,2014,11,22,25,away,-33,GBP,320,365,53,78,20,53,Loss,109,110,3,1,0,PHI,73,429,475,4
0.571428571,0.333333333,32.7,11/16/2014,2014,11,25,22,home,33,PHI,365,320,52,64,53,20,Win,110,109,1,3,4,GBP,73,475,429,0
0.333333333,0.571428571,29.28333333,11/16/2014,2014,11,11,18,away,-8,ARI,164,306,80,53,6,14,Loss,98,46,4,0,2,DET,20,262,352,1
0.571428571,0.333333333,30.71666667,11/16/2014,2014,11,18,11,home,8,DET,306,164,35,58,14,6,Win,46,98,0,4,1,ARI,20,352,262,2
0.818181818,0.384615385,34.35,11/16/2014,2014,11,33,17,away,22,IND,257,303,53,74,42,20,Win,246,19,0,1,1,NEP,62,503,322,2
0.384615385,0.818181818,25.65,11/16/2014,2014,11,17,33,home,-22,NEP,303,257,27,56,20,42,Loss,19,246,1,0,2,IND,62,322,503,1
0.538461538,0.375,39.81666667,11/17/2014,2014,11,29,14,away,3,TEN,180,263,39,73,27,24,Win,206,49,5,0,1,PIT,51,386,312,1
0.375,0.538461538,20.18333333,11/17/2014,2014,11,14,29,home,-3,PIT,263,180,10,39,24,27,Loss,49,206,0,5,1,TEN,51,312,386,1
0.142857143,0.5,29.93333333,11/20/2014,2014,12,16,18,away,-4,OAK,217,172,59,62,20,24,Loss,96,179,2,1,1,KCC,44,313,351,0
0.5,0.142857143,30.06666667,11/20/2014,2014,12,18,16,home,4,KCC,172,217,60,66,24,20,Win,179,96,1,2,0,OAK,44,351,313,1
0.4,0.5625,30.61666667,11/23/2014,2014,12,29,21,away,2,ATL,313,252,30,71,26,24,Win,162,63,1,3,2,CLE,50,475,315,3
0.5625,0.4,29.38333333,11/23/2014,2014,12,21,29,home,-2,CLE,252,313,40,69,24,26,Loss,63,162,3,1,3,ATL,50,315,475,2
0.166666667,0.526315789,26.8,11/23/2014,2014,12,16,26,away,-19,PHI,299,298,56,63,24,43,Loss,52,164,5,2,2,TEN,67,351,462,3
0.526315789,0.166666667,33.2,11/23/2014,2014,12,26,16,home,19,TEN,298,299,69,83,43,24,Win,164,52,2,5,3,PHI,67,462,351,2
0.294117647,0.428571429,30.18333333,11/23/2014,2014,12,21,29,away,-25,NEP,244,349,54,73,9,34,Loss,91,90,2,0,1,DET,43,335,439,1
0.428571429,0.294117647,29.81666667,11/23/2014,2014,12,29,21,home,25,DET,349,244,89,73,34,9,Win,90,91,0,2,1,NEP,43,439,335,1
0.545454545,0.384615385,31.75,11/23/2014,2014,12,24,20,away,3,MIN,207,196,75,62,24,21,Win,155,112,1,2,1,GBP,45,362,308,0
0.384615385,0.545454545,28.25,11/23/2014,2014,12,20,24,home,-3,GBP,196,207,77,64,21,24,Loss,112,155,2,1,0,MIN,45,308,362,1
0.25,0.529411765,25.91666667,11/23/2014,2014,12,11,24,away,-20,IND,114,214,43,54,3,23,Loss,80,175,4,5,3,JAX,26,194,389,2
0.529411765,0.25,34.08333333,11/23/2014,2014,12,24,11,home,20,JAX,214,114,54,72,23,3,Win,175,80,5,4,2,IND,26,389,194,3
0.55,0.285714286,39.16666667,11/23/2014,2014,12,24,18,away,9,HOU,233,184,60,78,22,13,Win,139,64,0,1,1,CIN,35,372,248,1
0.285714286,0.55,20.83333333,11/23/2014,2014,12,18,24,home,-9,CIN,184,233,15,65,13,22,Loss,64,139,1,0,1,HOU,35,248,372,1
0.411764706,0.25,30.16666667,11/23/2014,2014,12,17,12,away,-8,CHI,301,112,87,75,13,21,Loss,66,92,5,3,1,TBB,34,367,204,4
0.25,0.411764706,29.83333333,11/23/2014,2014,12,12,17,home,8,TBB,112,301,45,56,21,13,Win,92,66,3,5,4,CHI,34,204,367,1
0.25,0.384615385,24.55,11/23/2014,2014,12,12,16,away,-16,SEA,140,169,25,49,3,19,Loss,64,124,3,7,0,ARI,22,204,293,1
0.384615385,0.25,35.45,11/23/2014,2014,12,16,12,home,16,ARI,169,140,74,58,19,3,Win,124,64,7,3,1,SEA,22,293,204,0
0.428571429,0.333333333,28.85,11/23/2014,2014,12,16,19,away,-3,LAC,210,282,90,61,24,27,Loss,107,128,1,3,3,LAR,51,317,410,3
0.333333333,0.428571429,31.15,11/23/2014,2014,12,19,16,home,3,LAR,282,210,85,60,27,24,Win,128,107,3,1,3,LAC,51,410,317,3
0.5,0.692307692,25.71666667,11/23/2014,2014,12,25,29,away,-3,DEN,216,249,50,58,36,39,Loss,97,201,1,1,1,MIA,75,313,450,1
0.692307692,0.5,34.28333333,11/23/2014,2014,12,29,25,home,3,MIA,249,216,98,71,39,36,Win,201,97,1,1,1,DEN,75,450,313,1
0.153846154,0.384615385,29.91666667,11/23/2014,2014,12,12,16,away,-4,SFO,77,246,53,52,13,17,Loss,136,66,5,2,3,WAS,30,213,312,1
0.384615385,0.153846154,30.08333333,11/23/2014,2014,12,16,12,home,4,WAS,246,77,47,60,17,13,Win,66,136,2,5,1,SFO,30,312,213,3
0.4,0.6875,24.88333333,11/23/2014,2014,12,18,27,away,3,NYG,266,328,63,53,31,28,Win,119,89,2,2,1,DAL,59,385,417,1
0.6875,0.4,35.11666667,11/23/2014,2014,12,27,18,home,-3,DAL,328,266,30,74,28,31,Loss,89,119,2,2,1,NYG,59,417,385,1
0.2,0.538461538,29.1,11/24/2014,2014,12,11,21,away,-35,BUF,126,220,60,57,3,38,Loss,92,116,7,1,0,NYJ,41,218,336,1
0.538461538,0.2,30.9,11/24/2014,2014,12,21,11,home,35,NYJ,220,126,24,62,38,3,Win,116,92,1,7,1,BUF,41,336,218,0
0.692307692,0.416666667,30.25,11/24/2014,2014,12,23,26,away,7,NOS,234,399,42,57,34,27,Win,215,126,1,4,1,BAL,61,449,525,1
0.416666667,0.692307692,29.75,11/24/2014,2014,12,26,23,home,-7,BAL,399,234,50,70,27,34,Loss,126,215,4,1,1,NOS,61,525,449,1
0.416666667,0.416666667,26.58333333,11/27/2014,2014,13,18,28,away,-17,DET,256,383,41,59,17,34,Loss,13,91,3,2,1,CHI,51,269,474,2
0.416666667,0.416666667,33.41666667,11/27/2014,2014,13,28,18,home,17,CHI,383,256,38,70,34,17,Win,91,13,2,3,2,DET,51,474,269,1
0.533333333,0.333333333,30.41666667,11/27/2014,2014,13,26,16,away,23,DAL,208,174,20,75,33,10,Win,256,93,1,4,3,PHI,43,464,267,1
0.333333333,0.533333333,29.58333333,11/27/2014,2014,13,16,26,home,-23,PHI,174,208,42,58,10,33,Loss,93,256,4,1,1,DAL,43,267,464,3
0.357142857,0.363636364,35.31666667,11/27/2014,2014,13,16,16,away,16,SFO,222,100,105,60,19,3,Win,157,64,4,4,3,SEA,22,379,164,0
0.363636364,0.357142857,24.68333333,11/27/2014,2014,13,16,16,home,-16,SEA,100,222,20,51,3,19,Loss,64,157,4,4,0,SFO,22,164,379,3
0.333333333,0.625,36.08333333,11/30/2014,2014,13,24,19,away,-22,IND,341,361,78,74,27,49,Loss,84,126,6,1,3,WAS,76,425,487,1
0.625,0.333333333,23.91666667,11/30/2014,2014,13,19,24,home,22,WAS,361,341,94,49,49,27,Win,126,84,1,6,1,IND,76,487,425,3
0.333333333,0.647058824,26.73333333,11/30/2014,2014,13,19,24,away,-24,HOU,237,358,66,56,21,45,Loss,83,99,3,0,1,TEN,66,320,457,4
0.647058824,0.333333333,33.26666667,11/30/2014,2014,13,24,19,home,24,TEN,358,237,40,69,45,21,Win,99,83,0,3,4,HOU,66,457,320,1
0.25,0.133333333,29.08333333,11/30/2014,2014,13,19,15,away,-16,BUF,241,181,76,66,10,26,Loss,74,106,2,1,2,CLE,36,315,287,3
0.133333333,0.25,30.91666667,11/30/2014,2014,13,15,19,home,16,CLE,181,241,45,62,26,10,Win,106,74,1,2,3,BUF,36,287,315,2
0.818181818,0.583333333,29.81666667,11/30/2014,2014,13,31,24,away,1,BAL,376,225,91,65,34,33,Win,64,125,2,0,0,LAC,67,440,350,2
0.583333333,0.818181818,30.18333333,11/30/2014,2014,13,24,31,home,-1,LAC,225,376,98,63,33,34,Loss,125,64,0,2,2,BAL,67,350,440,0
0.466666667,0.25,34.65,11/30/2014,2014,13,22,18,away,-1,JAX,213,140,40,73,24,25,Loss,116,118,4,7,0,NYG,49,329,258,3
0.25,0.466666667,25.35,11/30/2014,2014,13,18,22,home,1,NYG,140,213,49,64,25,24,Win,118,116,7,4,3,JAX,49,258,329,0
0.454545455,0.181818182,30.61666667,11/30/2014,2014,13,19,14,away,1,TBB,176,188,73,58,14,13,Win,112,75,2,1,1,CIN,27,288,263,3
0.181818182,0.454545455,29.38333333,11/30/2014,2014,13,14,19,home,-1,CIN,188,176,94,55,13,14,Loss,75,112,1,2,3,TBB,27,263,288,1
0.222222222,0.125,36.93333333,11/30/2014,2014,13,17,17,away,-52,LAR,183,176,73,75,0,52,Loss,61,172,6,1,0,OAK,52,244,348,5
0.125,0.222222222,23.06666667,11/30/2014,2014,13,17,17,home,52,OAK,176,183,60,49,52,0,Win,172,61,1,6,5,LAR,52,348,244,0
0.4,0.428571429,26.01666667,11/30/2014,2014,13,20,36,away,3,PIT,250,435,77,54,35,32,Win,143,103,1,1,2,NOS,67,393,538,0
0.428571429,0.4,33.98333333,11/30/2014,2014,13,36,20,home,-3,NOS,435,250,28,82,32,35,Loss,103,143,1,1,0,PIT,67,538,393,2
0.4375,0.363636364,35.8,11/30/2014,2014,13,23,12,away,-18,MIN,170,118,35,72,13,31,Loss,178,92,4,3,0,CAR,44,348,210,1
0.363636364,0.4375,24.2,11/30/2014,2014,13,12,23,home,18,CAR,118,170,25,48,31,13,Win,92,178,3,4,1,MIN,44,210,348,0
0.142857143,0.4375,22.95,11/30/2014,2014,13,18,22,away,-11,ATL,294,358,34,50,18,29,Loss,35,142,0,1,1,ARI,47,329,500,3
0.4375,0.142857143,37.05,11/30/2014,2014,13,22,18,home,11,ARI,358,294,76,76,29,18,Win,142,35,1,0,3,ATL,47,500,329,1
0.4,0.588235294,23.41666667,11/30/2014,2014,13,20,24,away,-5,GBP,236,348,25,54,21,26,Loss,84,130,1,3,0,NEP,47,320,478,0
0.588235294,0.4,36.58333333,11/30/2014,2014,13,24,20,home,5,NEP,348,236,22,70,26,21,Win,130,84,3,1,0,GBP,47,478,320,0
0.428571429,0.111111111,38.78333333,11/30/2014,2014,13,21,11,away,13,KCC,174,110,32,80,29,16,Win,214,41,1,6,3,DEN,45,388,151,1
0.111111111,0.428571429,21.21666667,11/30/2014,2014,13,11,21,home,-13,DEN,110,174,35,44,16,29,Loss,41,214,6,1,1,KCC,45,151,388,3
0.384615385,0.466666667,27.41666667,12/1/2014,2014,13,16,18,away,3,NYJ,217,49,20,55,16,13,Win,74,277,2,2,1,MIA,29,291,326,1
0.466666667,0.384615385,32.58333333,12/1/2014,2014,13,18,16,home,-3,MIA,49,217,57,64,13,16,Loss,277,74,2,2,1,NYJ,29,326,291,1
0.5,0.2,32.46666667,12/4/2014,2014,14,21,23,away,13,CHI,203,341,97,62,41,28,Win,194,35,1,0,2,DAL,69,397,376,0
0.2,0.5,27.53333333,12/4/2014,2014,14,23,21,home,-13,DAL,341,203,54,61,28,41,Loss,35,194,0,1,0,CHI,69,376,397,2
0.5,0.272727273,32.75,12/7/2014,2014,14,25,16,away,21,CIN,350,322,20,70,42,21,Win,193,86,0,3,2,PIT,63,543,408,0
0.272727273,0.5,27.25,12/7/2014,2014,14,16,25,home,-21,PIT,322,350,54,59,21,42,Loss,86,193,3,0,0,CIN,63,408,543,2
0.5,0.25,32.81666667,12/7/2014,2014,14,19,13,away,24,WAS,198,179,98,56,24,0,Win,131,27,4,7,2,LAR,24,329,206,0
0.25,0.5,27.18333333,12/7/2014,2014,14,13,19,home,-24,LAR,179,198,51,55,0,24,Loss,27,131,7,4,0,WAS,24,206,329,2
0.444444444,0.153846154,34.71666667,12/7/2014,2014,14,19,12,away,29,TEN,260,146,70,73,36,7,Win,142,61,0,8,3,NYG,43,402,207,1
0.153846154,0.444444444,25.28333333,12/7/2014,2014,14,12,19,home,-29,NYG,146,260,39,57,7,36,Loss,61,142,8,0,1,TEN,43,207,402,3
0.466666667,0.357142857,36,12/7/2014,2014,14,24,18,away,31,NOS,226,218,55,73,41,10,Win,271,92,0,2,2,CAR,51,497,310,0
0.357142857,0.466666667,24,12/7/2014,2014,14,18,24,home,-31,CAR,218,226,30,68,10,41,Loss,92,271,2,0,0,NOS,51,310,497,2
0.470588235,0.5,35.86666667,12/7/2014,2014,14,19,19,away,-6,MIN,242,297,40,74,0,6,Loss,168,114,3,3,2,NYJ,6,410,411,2
0.5,0.470588235,28.78333333,12/7/2014,2014,14,19,19,home,6,NYJ,297,242,70,58,6,0,Win,114,168,3,3,2,MIN,6,411,410,2
0.416666667,0.333333333,30.3,12/7/2014,2014,14,26,16,away,15,MIA,264,186,36,65,28,13,Win,183,63,1,6,0,BAL,41,447,249,1
0.333333333,0.416666667,29.7,12/7/2014,2014,14,16,26,home,-15,BAL,186,264,30,55,13,28,Loss,63,183,6,1,1,MIA,41,249,447,0
0.3125,0.266666667,28.06666667,12/7/2014,2014,14,23,14,away,1,CLE,269,133,40,76,25,24,Win,93,115,3,1,2,IND,49,362,248,4
0.266666667,0.3125,31.93333333,12/7/2014,2014,14,14,23,home,-1,IND,133,269,85,63,24,25,Loss,115,93,1,3,4,CLE,49,248,362,2
0.285714286,0.466666667,23.41666667,12/7/2014,2014,14,15,22,away,-17,DET,207,294,50,59,17,34,Loss,26,113,6,4,1,TBB,51,233,407,3
0.466666667,0.285714286,36.58333333,12/7/2014,2014,14,22,15,home,17,TBB,294,207,122,69,34,17,Win,113,26,4,6,3,DET,51,407,233,1
0.214285714,0.333333333,32.48333333,12/7/2014,2014,14,19,17,away,14,JAX,135,188,64,63,27,13,Win,169,74,1,4,1,HOU,40,304,262,0
0.333333333,0.214285714,27.51666667,12/7/2014,2014,14,17,19,home,-14,HOU,188,135,40,66,13,27,Loss,74,169,4,1,0,JAX,40,262,304,1
0.5625,0.4,33.48333333,12/7/2014,2014,14,24,15,away,-7,DEN,341,173,98,77,17,24,Loss,74,133,4,0,3,BUF,41,415,306,3
0.4,0.5625,26.51666667,12/7/2014,2014,14,15,24,home,7,BUF,173,341,45,49,24,17,Win,133,74,0,4,3,DEN,41,306,415,3
0.428571429,0.4,29.98333333,12/7/2014,2014,14,19,18,away,-3,ARI,264,225,75,61,14,17,Loss,126,141,5,2,0,KCC,31,390,366,2
0.4,0.428571429,30.01666667,12/7/2014,2014,14,18,19,home,3,KCC,225,264,40,65,17,14,Win,141,126,2,5,2,ARI,31,366,390,0
0.4375,0.181818182,41.93333333,12/7/2014,2014,14,28,9,away,10,PHI,252,82,67,85,24,14,Win,188,57,2,3,2,SEA,38,440,139,2
0.181818182,0.4375,18.06666667,12/7/2014,2014,14,9,28,home,-10,SEA,82,252,69,45,14,24,Loss,57,188,3,2,2,PHI,38,139,440,2
0.272727273,0.461538462,27.08333333,12/7/2014,2014,14,18,19,away,-11,OAK,151,245,50,56,13,24,Loss,97,85,5,1,0,SFO,37,248,330,2
0.461538462,0.272727273,32.91666667,12/7/2014,2014,14,19,18,home,11,SFO,245,151,84,60,24,13,Win,85,97,1,5,2,OAK,37,330,248,0
0.4375,0.307692308,34.55,12/7/2014,2014,14,24,13,away,9,LAC,310,163,70,73,23,14,Win,87,53,1,4,1,NEP,37,397,216,2
0.307692308,0.4375,25.45,12/7/2014,2014,14,13,24,home,-9,NEP,163,310,61,54,14,23,Loss,53,87,4,1,2,LAC,37,216,397,1
0.454545455,0.583333333,26.98333333,12/8/2014,2014,14,26,28,away,-6,GBP,374,323,11,64,37,43,Loss,91,179,1,1,0,ATL,80,465,502,1
0.583333333,0.454545455,33.01666667,12/8/2014,2014,14,28,26,home,6,ATL,323,374,40,67,43,37,Win,179,91,1,1,1,GBP,80,502,465,0
0.294117647,0.266666667,34.4,12/11/2014,2014,15,13,13,away,6,LAR,131,211,59,64,12,6,Win,143,69,1,2,2,ARI,18,274,280,0
0.266666667,0.294117647,25.6,12/11/2014,2014,15,13,13,home,-6,ARI,211,131,69,61,6,12,Loss,69,143,2,1,0,LAR,18,280,274,2
0.545454545,0.545454545,30.71666667,12/14/2014,2014,15,22,20,away,7,ATL,353,310,34,58,27,20,Win,45,97,1,0,1,PIT,47,398,407,0
0.545454545,0.545454545,29.28333333,12/14/2014,2014,15,20,22,home,-7,PIT,310,353,25,57,20,27,Loss,97,45,0,1,0,ATL,47,407,398,1
0.285714286,0.307692308,32.51666667,12/14/2014,2014,15,21,17,away,-11,NYG,228,238,135,68,13,24,Loss,144,49,7,1,1,WAS,37,372,287,1
0.307692308,0.285714286,27.48333333,12/14/2014,2014,15,17,21,home,11,WAS,238,228,60,57,24,13,Win,49,144,1,7,1,NYG,37,287,372,1
0.1875,0.615384615,33.76666667,12/14/2014,2014,15,23,23,away,-28,NEP,308,287,35,74,13,41,Loss,76,108,4,0,1,MIA,54,384,395,2
0.615384615,0.1875,26.23333333,12/14/2014,2014,15,23,23,home,28,MIA,287,308,51,64,41,13,Win,108,76,0,4,2,NEP,54,395,384,1
0.277777778,0.230769231,30,12/14/2014,2014,15,17,16,away,-18,KCC,202,295,75,77,13,31,Loss,78,93,4,1,1,OAK,44,280,388,1
0.230769231,0.277777778,30,12/14/2014,2014,15,16,17,home,18,OAK,295,202,84,59,31,13,Win,93,78,1,4,1,KCC,44,388,280,1
0.3125,0.166666667,31.08333333,12/14/2014,2014,15,14,20,away,-7,IND,152,168,66,67,10,17,Loss,137,110,1,2,2,HOU,27,289,278,2
0.166666667,0.3125,28.91666667,12/14/2014,2014,15,20,14,home,7,HOU,168,152,45,64,17,10,Win,110,137,2,1,2,IND,27,278,289,2
0.277777778,0.333333333,31.7,12/14/2014,2014,15,13,17,away,-8,BAL,166,221,60,69,12,20,Loss,82,93,8,0,1,JAX,32,248,314,1
0.333333333,0.277777778,28.3,12/14/2014,2014,15,17,13,home,8,JAX,221,166,70,56,20,12,Win,93,82,0,8,1,BAL,32,314,248,1
0.285714286,0.25,27.03333333,12/14/2014,2014,15,21,13,away,-8,BUF,175,140,70,67,13,21,Loss,158,113,1,3,1,GBP,34,333,253,2
0.25,0.285714286,32.96666667,12/14/2014,2014,15,13,21,home,8,GBP,140,175,75,63,21,13,Win,113,158,3,1,2,BUF,34,253,333,1
0.416666667,0.384615385,22.61666667,12/14/2014,2014,15,15,28,away,-2,CAR,136,269,29,54,17,19,Loss,151,123,3,3,1,TBB,36,287,392,3
0.384615385,0.416666667,37.38333333,12/14/2014,2014,15,28,15,home,2,TBB,269,136,25,75,19,17,Win,123,151,3,3,3,CAR,36,392,287,1
0.5,0.1,38.86666667,12/14/2014,2014,15,24,5,away,30,CLE,103,54,41,71,30,0,Win,244,53,2,3,2,CIN,30,347,107,1
0.1,0.5,21.13333333,12/14/2014,2014,15,5,24,home,-30,CIN,54,103,68,38,0,30,Loss,53,244,3,2,1,CLE,30,107,347,2
0.153846154,0.375,30.05,12/14/2014,2014,15,17,17,away,5,TEN,163,253,46,60,16,11,Win,114,89,3,1,1,NYJ,27,277,342,0
0.375,0.153846154,29.95,12/14/2014,2014,15,17,17,home,-5,NYJ,253,163,76,64,11,16,Loss,89,114,1,3,0,TEN,27,342,277,1
0.25,0.461538462,32.73333333,12/14/2014,2014,15,18,20,away,12,LAC,226,232,71,61,22,10,Win,111,56,1,0,2,DEN,32,337,288,0
0.461538462,0.25,27.26666667,12/14/2014,2014,15,20,18,home,-12,DEN,232,226,65,61,10,22,Loss,56,111,0,1,0,LAC,32,288,337,2
0.363636364,0.181818182,34.71666667,12/14/2014,2014,15,21,11,away,-2,DET,284,153,25,66,14,16,Loss,76,80,4,0,0,MIN,30,360,233,2
0.181818182,0.363636364,25.28333333,12/14/2014,2014,15,11,21,home,2,MIN,153,284,35,50,16,14,Win,80,76,0,4,2,DET,30,233,360,0
0.4,0.571428571,31.03333333,12/14/2014,2014,15,14,18,away,-10,SEA,105,138,78,57,7,17,Loss,140,152,6,5,1,SFO,24,245,290,0
0.571428571,0.4,28.96666667,12/14/2014,2014,15,18,14,home,10,SFO,138,105,50,61,17,7,Win,152,140,5,6,0,SEA,24,290,245,1
0.384615385,0.454545455,41.91666667,12/14/2014,2014,15,26,19,away,11,PHI,249,219,79,76,38,27,Win,115,75,3,4,3,DAL,65,364,294,1
0.454545455,0.384615385,18.08333333,12/14/2014,2014,15,19,26,home,-11,DAL,219,249,95,53,27,38,Loss,75,115,4,3,1,PHI,65,294,364,3
0.363636364,0.166666667,33.51666667,12/15/2014,2014,15,25,16,away,16,CHI,360,153,25,64,31,15,Win,83,125,2,7,3,NOS,46,443,278,1
0.166666667,0.363636364,26.48333333,12/15/2014,2014,15,16,25,home,-16,NOS,153,360,74,58,15,31,Loss,125,83,7,2,1,CHI,46,278,443,3
0.466666667,0.384615385,34.86666667,12/18/2014,2014,16,19,17,away,-8,JAX,262,111,47,67,13,21,Loss,95,177,4,4,0,TEN,34,357,288,0
0.384615385,0.466666667,25.13333333,12/18/2014,2014,16,17,19,home,8,TEN,111,262,25,56,21,13,Win,177,95,4,4,0,JAX,34,288,357,0
0.5625,0.222222222,32.06666667,12/20/2014,2014,16,30,21,away,-3,WAS,361,205,102,84,24,27,Loss,134,100,3,2,2,PHI,51,495,305,2
0.222222222,0.5625,27.93333333,12/20/2014,2014,16,21,30,home,3,PHI,205,361,15,54,27,24,Win,100,134,2,3,2,WAS,51,305,495,2
0.5,0.454545455,34.31666667,12/20/2014,2014,16,28,21,away,3,SFO,348,92,38,80,3,0,Win,98,355,2,2,3,LAC,3,446,447,3
0.454545455,0.5,30.58333333,12/20/2014,2014,16,21,28,home,-3,LAC,92,348,92,66,0,3,Loss,355,98,2,2,3,SFO,3,447,446,3
0.583333333,0.692307692,26.9,12/21/2014,2014,16,20,36,away,-2,MIA,238,383,74,58,35,37,Loss,119,110,4,1,2,MIN,72,357,493,1
0.692307692,0.583333333,33.1,12/21/2014,2014,16,36,20,home,2,MIN,383,238,54,77,37,35,Win,110,119,1,4,1,MIA,72,493,357,2
0.266666667,0.333333333,25.03333333,12/21/2014,2014,16,15,18,away,-12,HOU,178,190,56,68,13,25,Loss,33,123,2,0,1,BAL,38,211,313,3
0.333333333,0.266666667,34.96666667,12/21/2014,2014,16,18,15,home,12,BAL,190,178,69,81,25,13,Win,123,33,0,2,3,HOU,38,313,211,1
0.384615385,0.333333333,31.93333333,12/21/2014,2014,16,22,17,away,6,CHI,229,170,60,69,20,14,Win,138,64,4,2,1,DET,34,367,234,3
0.333333333,0.384615385,28.06666667,12/21/2014,2014,16,17,22,home,-6,DET,170,229,86,63,14,20,Loss,64,138,2,4,3,CHI,34,234,367,1
0.25,0.5625,21.95,12/21/2014,2014,16,8,27,away,-4,CAR,144,195,49,46,13,17,Loss,84,209,3,1,2,CLE,30,228,404,1
0.5625,0.25,38.05,12/21/2014,2014,16,27,8,home,4,CLE,195,144,49,77,17,13,Win,209,84,1,3,1,CAR,30,404,228,2
0.466666667,0.5,32.15,12/21/2014,2014,16,18,22,away,16,NOS,322,271,64,62,30,14,Win,81,57,0,5,4,ATL,44,403,328,0
0.5,0.466666667,27.85,12/21/2014,2014,16,22,18,home,-16,ATL,271,322,25,70,14,30,Loss,57,81,5,0,0,NOS,44,328,403,4
0.461538462,0.285714286,38.63333333,12/21/2014,2014,16,23,6,away,17,TBB,310,93,40,72,20,3,Win,121,16,1,7,1,GBP,23,431,109,1
0.285714286,0.461538462,21.36666667,12/21/2014,2014,16,6,23,home,-17,GBP,93,310,30,47,3,20,Loss,16,121,7,1,1,TBB,23,109,431,1
0.428571429,0.5,31.11666667,12/21/2014,2014,16,22,19,away,-8,PIT,288,214,39,66,12,20,Loss,39,68,6,1,0,KCC,32,327,282,1
0.5,0.428571429,28.88333333,12/21/2014,2014,16,19,22,home,8,KCC,214,288,40,52,20,12,Win,68,39,1,6,1,PIT,32,282,327,0
0.461538462,0.384615385,27.65,12/21/2014,2014,16,19,16,away,1,NYJ,146,191,38,63,17,16,Win,85,116,4,2,1,NEP,33,231,307,1
0.384615385,0.461538462,32.35,12/21/2014,2014,16,16,19,home,-1,NEP,191,146,14,61,16,17,Loss,116,85,2,4,1,NYJ,33,307,231,1
0.470588235,0.166666667,34.78333333,12/21/2014,2014,16,19,23,away,10,LAR,386,281,149,67,37,27,Win,128,106,1,2,3,NYG,64,514,387,0
0.166666667,0.470588235,25.21666667,12/21/2014,2014,16,23,19,home,-10,NYG,281,386,76,54,27,37,Loss,106,128,2,1,0,LAR,64,387,514,3
0.266666667,0.3125,26.21666667,12/21/2014,2014,16,15,18,away,-2,OAK,308,207,55,64,24,26,Loss,13,140,2,1,0,BUF,50,321,347,2
0.3125,0.266666667,33.78333333,12/21/2014,2014,16,18,15,home,2,BUF,207,308,35,71,26,24,Win,140,13,1,2,2,OAK,50,347,321,0
0.384615385,0.5,24.51666667,12/21/2014,2014,16,17,25,away,-35,DAL,228,250,55,56,7,42,Loss,1,127,2,1,1,IND,49,229,377,3
0.5,0.384615385,35.48333333,12/21/2014,2014,16,25,17,home,35,IND,250,228,67,62,42,7,Win,127,1,1,2,3,DAL,49,377,229,1
0.416666667,0.2,33.05,12/21/2014,2014,16,23,17,away,29,ARI,329,187,97,67,35,6,Win,267,29,1,4,1,SEA,41,596,216,0
0.2,0.416666667,26.95,12/21/2014,2014,16,17,23,home,-29,SEA,187,329,5,64,6,35,Loss,29,267,4,1,0,ARI,41,216,596,1
0.416666667,0.181818182,28.36666667,12/22/2014,2014,16,22,20,away,-9,CIN,300,146,72,65,28,37,Loss,85,207,2,0,2,DEN,65,385,353,4
0.181818182,0.416666667,31.63333333,12/22/2014,2014,16,20,22,home,9,DEN,146,300,45,62,37,28,Win,207,85,0,2,4,CIN,65,353,385,2
0.230769231,0.307692308,30.71666667,12/28/2014,2014,17,16,22,away,-10,BAL,150,290,58,61,10,20,Loss,109,129,4,1,0,CLE,30,259,419,2
0.307692308,0.230769231,29.28333333,12/28/2014,2014,17,22,16,home,10,CLE,290,150,55,65,20,10,Win,129,109,1,4,2,BAL,30,419,259,0
0.333333333,0.333333333,30.4,12/28/2014,2014,17,20,20,away,27,WAS,299,309,48,61,44,17,Win,174,104,0,3,4,DAL,61,473,413,1
0.333333333,0.333333333,29.6,12/28/2014,2014,17,20,20,home,-27,DAL,309,299,101,68,17,44,Loss,104,174,3,0,1,WAS,61,413,473,4
0.3125,0.25,33.43333333,12/28/2014,2014,17,16,9,away,17,TEN,314,50,20,66,27,10,Win,64,142,1,4,1,IND,37,378,192,0
0.25,0.3125,26.56666667,12/28/2014,2014,17,9,16,home,-17,IND,50,314,20,59,10,27,Loss,142,64,4,1,0,TEN,37,192,378,1
0,0.555555556,20.2,12/28/2014,2014,17,13,24,away,-6,HOU,112,235,25,53,17,23,Loss,121,123,5,3,2,JAX,40,233,358,0
0.555555556,0,39.8,12/28/2014,2014,17,24,13,home,6,JAX,235,112,55,77,23,17,Win,123,121,3,5,0,HOU,40,358,233,2
0.181818182,0.166666667,31.35,12/28/2014,2014,17,21,15,away,-12,KCC,249,140,67,66,7,19,Loss,112,111,7,4,0,LAC,26,361,251,3
0.166666667,0.181818182,28.65,12/28/2014,2014,17,15,21,home,12,LAC,140,249,46,57,19,7,Win,111,112,4,7,3,KCC,26,251,361,0
0.428571429,0.307692308,31.26666667,12/28/2014,2014,17,18,23,away,13,MIA,390,208,40,62,37,24,Win,104,179,1,7,1,NYJ,61,494,387,1
0.307692308,0.428571429,28.73333333,12/28/2014,2014,17,23,18,home,-13,NYJ,208,390,40,66,24,37,Loss,179,104,7,1,1,MIA,61,387,494,1
0.266666667,0.533333333,31.55,12/28/2014,2014,17,12,15,away,-4,MIN,165,190,50,59,9,13,Loss,99,121,2,3,1,CHI,22,264,311,0
0.533333333,0.266666667,28.45,12/28/2014,2014,17,15,12,home,4,CHI,190,165,25,61,13,9,Win,121,99,3,2,0,MIN,22,311,264,1
0.454545455,0.333333333,29.05,12/28/2014,2014,17,16,14,away,8,NEP,164,144,44,58,17,9,Win,104,116,2,4,0,BUF,26,268,260,1
0.333333333,0.454545455,30.95,12/28/2014,2014,17,14,16,home,-8,BUF,144,164,55,62,9,17,Loss,116,104,4,2,1,NEP,26,260,268,0
0.4375,0.388888889,25.38333333,12/28/2014,2014,17,23,22,away,8,NYG,262,429,35,72,34,26,Win,164,76,4,0,1,PHI,60,426,505,1
0.388888889,0.4375,34.61666667,12/28/2014,2014,17,22,23,home,-8,PHI,429,262,106,78,26,34,Loss,76,164,0,4,1,NYG,60,505,426,1
0.5,0.529411765,27.21666667,12/28/2014,2014,17,20,18,away,3,TBB,268,97,15,63,23,20,Win,70,183,2,3,1,NOS,43,338,280,3
0.529411765,0.5,32.78333333,12/28/2014,2014,17,18,20,home,-3,NOS,97,268,23,65,20,23,Loss,183,70,3,2,3,TBB,43,280,338,1
0.4,0.4375,31.21666667,12/28/2014,2014,17,17,16,away,31,ATL,112,225,36,52,34,3,Win,194,63,1,6,3,CAR,37,306,288,0
0.4375,0.4,28.78333333,12/28/2014,2014,17,16,17,home,-31,CAR,225,112,36,69,3,34,Loss,63,194,6,1,0,ATL,37,288,306,3
0.363636364,0.615384615,25.7,12/28/2014,2014,17,23,24,away,-10,GBP,202,225,53,66,20,30,Loss,111,152,2,1,2,DET,50,313,377,1
0.615384615,0.363636364,34.3,12/28/2014,2014,17,24,23,home,10,DET,225,202,40,62,30,20,Win,152,111,1,2,1,GBP,50,377,313,2
0.333333333,0.466666667,26.98333333,12/28/2014,2014,17,10,25,away,-33,DEN,132,309,86,57,14,47,Loss,67,142,3,1,1,OAK,61,199,451,2
0.466666667,0.333333333,33.01666667,12/28/2014,2014,17,25,10,home,33,OAK,309,132,16,74,47,14,Win,142,67,1,3,2,DEN,61,451,199,1
0.4,0.416666667,30.6,12/28/2014,2014,17,26,18,away,-3,SFO,299,189,21,67,17,20,Loss,98,206,2,1,0,ARI,37,397,395,3
0.416666667,0.4,29.4,12/28/2014,2014,17,18,26,home,3,ARI,189,299,78,60,20,17,Win,206,98,1,2,3,SFO,37,395,397,0
0.25,0.466666667,28.81666667,12/28/2014,2014,17,15,16,away,-14,SEA,203,222,45,60,6,20,Loss,42,132,4,3,2,LAR,26,245,354,3
0.466666667,0.25,31.18333333,12/28/2014,2014,17,16,15,home,14,LAR,222,203,20,62,20,6,Win,132,42,3,4,3,SEA,26,354,245,2
0.428571429,0.272727273,34.96666667,12/28/2014,2014,17,19,18,away,-10,PIT,221,317,45,70,17,27,Loss,116,29,3,0,3,CIN,44,337,346,3
0.272727273,0.428571429,25.03333333,12/28/2014,2014,17,18,19,home,10,CIN,317,221,10,57,27,17,Win,29,116,0,3,3,PIT,44,346,337,3
0.25,0.333333333,22.9,1/3/2015,2014,PF,8,25,away,-11,CAR,51,198,38,47,16,27,Loss,27,188,4,1,3,ARI,43,78,386,3
0.333333333,0.25,37.1,1/3/2015,2014,PF,25,8,home,11,ARI,198,51,80,74,27,16,Win,188,27,1,4,3,CAR,43,386,78,3
0.363636364,0.3125,24.71666667,1/3/2015,2014,PF,19,22,away,13,PIT,246,319,14,55,30,17,Win,53,68,1,5,3,BAL,47,299,387,1
0.3125,0.363636364,35.28333333,1/3/2015,2014,PF,22,19,home,-13,BAL,319,246,114,72,17,30,Loss,68,53,5,1,1,PIT,47,387,299,3
0.4,0.428571429,25.83333333,1/4/2015,2014,PF,14,22,away,-16,IND,144,368,45,59,10,26,Loss,110,114,3,1,1,CIN,36,254,482,1
0.428571429,0.4,34.16666667,1/4/2015,2014,PF,22,14,home,16,CIN,368,144,66,70,26,10,Win,114,110,1,3,1,IND,36,482,254,1
0.363636364,0.428571429,29.55,1/4/2015,2014,PF,19,18,away,-4,DAL,307,242,44,67,20,24,Loss,90,73,3,6,1,DET,44,397,315,3
0.428571429,0.363636364,30.45,1/4/2015,2014,PF,18,19,home,4,DET,242,307,46,58,24,20,Win,73,90,6,3,3,DAL,44,315,397,1
0.111111111,0.545454545,32.65,1/10/2015,2014,PF,28,29,away,-4,NEP,292,408,65,73,31,35,Loss,136,14,0,2,1,BAL,66,428,422,2
0.545454545,0.111111111,27.35,1/10/2015,2014,PF,29,28,home,4,BAL,408,292,60,66,35,31,Win,14,136,2,0,2,NEP,66,422,428,1
0.5625,0.538461538,34.05,1/10/2015,2014,PF,21,16,away,-14,SEA,230,248,35,68,17,31,Loss,132,100,2,2,0,CAR,48,362,348,3
0.538461538,0.5625,25.95,1/10/2015,2014,PF,16,21,home,14,CAR,248,230,60,52,31,17,Win,100,132,2,2,3,SEA,48,348,362,0
0.5,0.642857143,30.65,1/11/2015,2014,PF,21,23,away,-5,GBP,170,297,35,51,21,26,Loss,145,119,4,2,1,DAL,47,315,416,1
0.642857143,0.5,29.35,1/11/2015,2014,PF,23,21,home,5,DAL,297,170,87,66,26,21,Win,119,145,2,4,1,GBP,47,416,315,1
0.384615385,0.25,34.01666667,1/11/2015,2014,PF,23,19,away,11,DEN,265,200,67,71,24,13,Win,99,88,0,2,1,IND,37,364,288,2
0.25,0.384615385,25.98333333,1/11/2015,2014,PF,19,23,home,-11,IND,200,265,8,68,13,24,Loss,88,99,2,0,2,DEN,37,288,364,1
0.214285714,0.5,32.25,1/18/2015,2014,PF,19,20,away,-6,SEA,171,203,45,65,0,6,Loss,135,194,1,5,5,GBP,6,306,397,2
0.5,0.214285714,31.06666667,1/18/2015,2014,PF,20,19,home,6,GBP,203,171,40,70,6,0,Win,194,135,5,1,2,SEA,6,397,306,5
0.272727273,0.666666667,22.18333333,1/18/2015,2014,PF,17,28,away,-38,NEP,126,220,23,52,7,45,Loss,83,177,0,1,1,IND,52,209,397,3
0.666666667,0.272727273,37.81666667,1/18/2015,2014,PF,28,17,home,38,IND,220,126,45,76,45,7,Win,177,83,1,0,3,NEP,52,397,209,1
0.571428571,0.3,33.76666667,2/1/2015,2014,PF,25,20,away,4,SEA,320,234,36,72,28,24,Win,57,162,1,3,1,NEP,52,377,396,2
0.3,0.571428571,26.23333333,2/1/2015,2014,PF,20,25,home,-4,NEP,234,320,70,53,24,28,Loss,162,57,3,1,2,SEA,52,396,377,1
0.466666667,0.636363636,32.08333333,9/10/2015,2015,1,23,26,away,-7,NEP,330,281,77,66,21,28,Loss,134,80,3,2,0,PIT,49,464,361,1
0.636363636,0.466666667,27.91666667,9/10/2015,2015,1,26,23,home,7,PIT,281,330,64,58,28,21,Win,80,134,2,3,1,NEP,49,361,464,0
0.6,0.647058824,28.13333333,9/13/2015,2015,1,21,25,away,8,CHI,189,213,74,53,31,23,Win,133,189,0,2,1,GBP,54,322,402,0
0.647058824,0.6,31.86666667,9/13/2015,2015,1,25,21,home,-8,GBP,213,189,64,71,23,31,Loss,189,133,2,0,0,CHI,54,402,322,1
0.230769231,0.214285714,35.31666667,9/13/2015,2015,1,19,24,away,7,HOU,233,298,25,67,27,20,Win,97,98,2,5,2,KCC,47,330,396,0
0.214285714,0.230769231,24.68333333,9/13/2015,2015,1,24,19,home,-7,KCC,298,233,39,73,20,27,Loss,98,97,5,2,0,HOU,47,396,330,2
0.5,0.538461538,31.66666667,9/13/2015,2015,1,15,18,away,-21,NYJ,217,179,109,63,10,31,Loss,104,154,3,0,1,CLE,41,321,333,5
0.538461538,0.5,28.33333333,9/13/2015,2015,1,18,15,home,21,CLE,179,217,30,60,31,10,Win,154,104,0,3,5,NYJ,41,333,321,1
0.533333333,0.384615385,29.06666667,9/13/2015,2015,1,23,15,away,-13,BUF,240,195,49,68,14,27,Loss,64,147,2,0,0,IND,41,304,342,3
0.384615385,0.533333333,30.93333333,9/13/2015,2015,1,15,23,home,13,IND,195,240,113,55,27,14,Win,147,64,0,2,3,BUF,41,342,304,0
0.416666667,0.428571429,22.1,9/13/2015,2015,1,19,20,away,7,WAS,182,188,39,55,17,10,Win,74,161,3,1,2,MIA,27,256,349,1
0.428571429,0.416666667,37.9,9/13/2015,2015,1,20,19,home,-7,MIA,188,182,88,69,10,17,Loss,161,74,1,3,1,WAS,27,349,256,2
0.470588235,0.25,34.1,9/13/2015,2015,1,17,18,away,11,JAX,158,169,22,68,20,9,Win,105,96,2,5,3,CAR,29,263,265,1
0.25,0.470588235,25.9,9/13/2015,2015,1,18,17,home,-11,CAR,169,158,25,66,9,20,Loss,96,105,5,2,1,JAX,29,265,263,3
0.421052632,0.545454545,37.46666667,9/13/2015,2015,1,21,19,away,-3,LAR,219,276,46,79,0,3,Loss,124,76,6,2,3,SEA,3,343,352,1
0.545454545,0.421052632,28.53333333,9/13/2015,2015,1,19,21,home,3,SEA,276,219,30,55,3,0,Win,76,124,2,6,1,LAR,3,352,343,3
0.388888889,0.5,33.4,9/13/2015,2015,1,18,25,away,-12,ARI,354,307,73,70,19,31,Loss,54,120,2,0,1,NOS,50,408,427,1
0.5,0.388888889,26.6,9/13/2015,2015,1,25,18,home,12,NOS,307,354,30,57,31,19,Win,120,54,0,2,1,ARI,50,427,408,1
0.3,0.545454545,21.8,9/13/2015,2015,1,16,28,away,-5,LAC,233,387,29,47,28,33,Loss,69,96,1,2,3,DET,61,302,483,2
0.545454545,0.3,38.2,9/13/2015,2015,1,28,16,home,5,DET,387,233,40,74,33,28,Win,96,69,2,1,2,LAC,61,483,302,3
0.444444444,0.214285714,31.51666667,9/13/2015,2015,1,20,16,away,28,TBB,185,181,55,49,42,14,Win,124,92,2,4,2,TEN,56,309,273,1
0.214285714,0.444444444,28.48333333,9/13/2015,2015,1,16,20,home,-28,TEN,181,185,97,63,14,42,Loss,92,124,4,2,1,TBB,56,273,309,2
0.307692308,0.25,32.53333333,9/13/2015,2015,1,22,16,away,20,OAK,269,183,50,65,33,13,Win,127,63,0,2,2,CIN,46,396,246,0
0.25,0.307692308,27.46666667,9/13/2015,2015,1,16,22,home,-20,CIN,183,269,32,61,13,33,Loss,63,127,2,0,0,OAK,46,246,396,2
0.153846154,0.444444444,22.71666667,9/13/2015,2015,1,11,16,away,-6,DEN,100,150,15,57,13,19,Loss,73,69,2,4,1,BAL,32,173,219,2
0.444444444,0.153846154,37.28333333,9/13/2015,2015,1,16,11,home,6,BAL,150,100,45,69,19,13,Win,69,73,4,2,2,DEN,32,219,173,1
0.428571429,0.545454545,22.83333333,9/13/2015,2015,1,18,27,away,-1,DAL,186,356,44,61,26,27,Loss,99,80,1,0,3,NYG,53,285,436,0
0.545454545,0.428571429,37.16666667,9/13/2015,2015,1,27,18,home,1,NYG,356,186,35,68,27,26,Win,80,99,0,1,0,DAL,53,436,285,3
0.25,0.285714286,24.55,9/14/2015,2015,1,23,21,away,-2,ATL,336,290,88,68,24,26,Loss,63,105,0,1,2,PHI,50,399,395,2
0.285714286,0.25,35.45,9/14/2015,2015,1,21,23,home,2,PHI,290,336,57,70,26,24,Win,105,63,1,0,2,ATL,50,395,399,2
0.111111111,0.416666667,26.96666667,9/14/2015,2015,1,17,25,away,-17,SFO,177,165,25,54,3,20,Loss,71,230,5,1,1,MIN,23,248,395,1
0.416666667,0.111111111,33.03333333,9/14/2015,2015,1,25,17,home,17,MIN,165,177,57,66,20,3,Win,230,71,1,5,1,SFO,23,395,248,1
0.375,0,31.01666667,9/17/2015,2015,2,21,20,away,7,KCC,238,167,85,70,31,24,Win,61,147,3,5,5,DEN,55,299,314,1
0,0.375,28.98333333,9/17/2015,2015,2,20,21,home,-7,DEN,167,238,60,58,24,31,Loss,147,61,5,3,1,KCC,55,314,299,5
0.263157895,0.307692308,27.71666667,9/20/2015,2015,2,21,25,away,-7,CAR,239,178,70,82,17,24,Loss,61,172,1,2,1,HOU,41,300,350,1
0.307692308,0.263157895,32.28333333,9/20/2015,2015,2,25,21,home,7,HOU,178,239,92,72,24,17,Win,172,61,2,1,1,CAR,41,350,300,1
0.411764706,0.6,36.98333333,9/20/2015,2015,2,27,21,away,-25,PIT,298,369,46,82,18,43,Loss,111,84,5,0,0,SFO,61,409,453,1
0.6,0.411764706,23.01666667,9/20/2015,2015,2,21,27,home,25,SFO,369,298,58,52,43,18,Win,84,111,0,5,1,PIT,61,453,409,0
0.357142857,0.5,28.53333333,9/20/2015,2015,2,18,21,away,7,NOS,194,219,90,59,26,19,Win,139,104,3,4,3,TBB,45,333,323,2
0.5,0.357142857,31.46666667,9/20/2015,2015,2,21,18,home,-7,TBB,219,194,115,69,19,26,Loss,104,139,4,3,2,NOS,45,323,333,3
0.461538462,0.5,28.9,9/20/2015,2015,2,25,20,away,-10,MIN,285,151,39,70,16,26,Loss,38,199,1,1,1,DET,42,323,350,3
0.5,0.461538462,31.1,9/20/2015,2015,2,20,25,home,10,DET,151,285,97,61,26,16,Win,199,38,1,1,3,MIN,42,350,323,1
0.555555556,0.166666667,30.06666667,9/20/2015,2015,2,21,18,away,25,CHI,185,226,58,52,48,23,Win,115,109,0,2,2,ARI,71,300,335,2
0.166666667,0.555555556,29.93333333,9/20/2015,2015,2,18,21,home,-25,ARI,226,185,170,62,23,48,Loss,109,115,2,0,2,CHI,71,335,300,2
0.3,0.307692308,29.95,9/20/2015,2015,2,27,23,away,8,BUF,451,189,119,76,40,32,Win,56,160,2,8,3,NEP,72,507,349,2
0.307692308,0.3,30.05,9/20/2015,2015,2,23,27,home,-8,NEP,189,451,140,65,32,40,Loss,160,56,8,2,2,BUF,72,349,507,3
0.363636364,0.4,30.15,9/20/2015,2015,2,19,20,away,-5,CIN,223,214,64,56,19,24,Loss,131,175,4,0,2,LAC,43,354,389,3
0.4,0.363636364,29.85,9/20/2015,2015,2,20,19,home,5,LAC,214,223,75,62,24,19,Win,175,131,0,4,3,CIN,43,389,354,2
0.4375,0.363636364,35.18333333,9/20/2015,2015,2,21,13,away,-14,CLE,219,158,85,74,14,28,Loss,166,116,7,2,0,TEN,42,385,274,3
0.363636364,0.4375,24.81666667,9/20/2015,2015,2,13,21,home,14,TEN,158,219,40,47,28,14,Win,116,166,2,7,3,CLE,42,274,385,0
0.647058824,0.588235294,31.58333333,9/20/2015,2015,2,25,19,away,4,NYG,346,291,65,70,24,20,Win,56,97,2,2,1,ATL,44,402,388,0
0.588235294,0.647058824,28.41666667,9/20/2015,2015,2,19,25,home,-4,ATL,291,346,35,65,20,24,Loss,97,56,2,2,0,NYG,44,388,402,1
0.166666667,0.5,22.26666667,9/20/2015,2015,2,11,19,away,-14,WAS,146,191,80,46,10,24,Loss,67,182,1,2,1,LAR,34,213,373,0
0.5,0.166666667,37.73333333,9/20/2015,2015,2,19,11,home,14,LAR,191,146,53,66,24,10,Win,182,67,2,1,0,WAS,34,373,213,1
0.333333333,0.357142857,29.86666667,9/20/2015,2015,2,17,19,away,-3,JAX,344,273,112,62,20,23,Loss,42,123,2,0,0,MIA,43,386,396,0
0.357142857,0.333333333,30.13333333,9/20/2015,2015,2,19,17,home,3,MIA,273,344,93,66,23,20,Win,123,42,0,2,0,JAX,43,396,386,0
0.363636364,0.642857143,30.43333333,9/20/2015,2015,2,29,27,away,-4,OAK,384,351,109,70,33,37,Loss,109,97,0,1,1,BAL,70,493,448,2
0.642857143,0.363636364,29.56666667,9/20/2015,2015,2,27,29,home,4,BAL,351,384,106,66,37,33,Win,97,109,1,0,2,OAK,70,448,493,1
0.333333333,0.181818182,40.41666667,9/20/2015,2015,2,21,17,away,10,PHI,250,219,142,70,20,10,Win,109,7,3,1,3,DAL,30,359,226,2
0.181818182,0.333333333,19.58333333,9/20/2015,2015,2,17,21,home,-10,DAL,219,250,60,55,10,20,Loss,7,109,1,3,2,PHI,30,226,359,3
0.333333333,0.363636364,26.7,9/20/2015,2015,2,21,21,away,-10,GBP,205,234,92,57,17,27,Loss,119,127,2,2,1,SEA,44,324,361,2
0.363636364,0.333333333,33.3,9/20/2015,2015,2,21,21,home,10,SEA,234,205,35,64,27,17,Win,127,119,2,2,2,GBP,44,361,324,1
0.333333333,0.428571429,31.8,9/21/2015,2015,2,20,17,away,13,IND,243,250,90,62,20,7,Win,101,93,1,0,5,NYJ,27,344,343,1
0.428571429,0.333333333,28.2,9/21/2015,2015,2,17,20,home,-13,NYJ,250,243,84,61,7,20,Loss,93,101,0,1,1,IND,27,343,344,5
0.4,0.333333333,28.5,9/24/2015,2015,3,22,19,away,-11,NYG,305,279,58,70,21,32,Loss,88,84,1,0,0,WAS,53,393,363,3
0.333333333,0.4,31.5,9/24/2015,2015,3,19,22,home,11,WAS,279,305,67,63,32,21,Win,84,88,0,1,3,NYG,53,363,393,0
0.642857143,0.166666667,34.21666667,9/27/2015,2015,3,26,23,away,11,DAL,280,220,70,69,39,28,Win,158,127,1,2,1,ATL,67,438,347,0
0.166666667,0.642857143,25.78333333,9/27/2015,2015,3,23,26,home,-11,ATL,220,280,31,49,28,39,Loss,127,158,2,1,0,DAL,67,347,438,1
0.363636364,0.307692308,25.01666667,9/27/2015,2015,3,20,28,away,2,TEN,245,345,71,56,35,33,Win,133,88,3,3,2,IND,68,378,433,2
0.307692308,0.363636364,34.98333333,9/27/2015,2015,3,28,20,home,-2,IND,345,245,55,74,33,35,Loss,88,133,3,3,2,TEN,68,433,378,2
0.428571429,0.5,32.48333333,9/27/2015,2015,3,19,21,away,7,CLE,314,316,85,62,27,20,Win,155,39,0,5,2,OAK,47,469,355,1
0.5,0.428571429,27.51666667,9/27/2015,2015,3,21,19,home,-7,OAK,316,314,50,68,20,27,Loss,39,155,5,0,1,CLE,47,355,469,2
0.533333333,0.4375,30.13333333,9/27/2015,2015,3,23,19,away,4,BAL,372,362,67,65,28,24,Win,86,36,2,0,1,CIN,52,458,398,2
0.4375,0.533333333,29.86666667,9/27/2015,2015,3,19,23,home,-4,CIN,362,372,116,67,24,28,Loss,36,86,0,2,2,BAL,52,398,458,1
0.5,0.785714286,25.33333333,9/27/2015,2015,3,15,35,away,-34,NEP,236,346,114,55,17,51,Loss,57,125,2,2,0,JAX,68,293,471,1
0.785714286,0.5,34.66666667,9/27/2015,2015,3,35,15,home,34,JAX,346,236,30,76,51,17,Win,125,57,2,2,1,NEP,68,471,293,0
0.583333333,0.454545455,32.73333333,9/27/2015,2015,3,27,24,away,-5,CAR,310,312,55,63,22,27,Loss,70,119,1,1,0,NOS,49,380,431,2
0.454545455,0.583333333,27.26666667,9/27/2015,2015,3,24,27,home,5,NOS,312,310,88,62,27,22,Win,119,70,1,1,2,CAR,49,431,380,0
0.285714286,0.411764706,28.18333333,9/27/2015,2015,3,18,19,away,7,NYJ,108,276,21,67,24,17,Win,123,47,1,1,4,PHI,41,231,323,1
0.411764706,0.285714286,31.81666667,9/27/2015,2015,3,19,18,home,-7,PHI,276,108,53,75,17,24,Loss,47,123,1,1,1,NYJ,41,323,231,4
0.083333333,0.444444444,23.71666667,9/27/2015,2015,3,14,30,away,-10,HOU,261,227,84,56,9,19,Loss,57,186,0,1,1,TBB,28,318,413,1
0.444444444,0.083333333,36.28333333,9/27/2015,2015,3,30,14,home,10,TBB,227,261,58,86,19,9,Win,186,57,1,0,1,HOU,28,413,318,1
0.470588235,0.333333333,33.48333333,9/27/2015,2015,3,21,18,away,-17,MIN,279,121,74,72,14,31,Loss,90,163,4,0,1,LAC,45,369,284,2
0.333333333,0.470588235,26.51666667,9/27/2015,2015,3,18,21,home,17,LAC,121,279,39,55,31,14,Win,163,90,0,4,2,MIN,45,284,369,1
0.5,0.2,32.31666667,9/27/2015,2015,3,17,12,away,6,LAR,197,187,63,57,12,6,Win,62,71,5,2,1,PIT,18,259,258,1
0.2,0.5,27.68333333,9/27/2015,2015,3,12,17,home,-6,PIT,187,197,47,49,6,12,Loss,71,62,2,5,1,LAR,18,258,259,1
0.333333333,0.461538462,23.46666667,9/27/2015,2015,3,10,28,away,-40,ARI,53,307,45,50,7,47,Loss,103,139,2,1,1,SFO,54,156,446,4
0.461538462,0.333333333,36.53333333,9/27/2015,2015,3,28,10,home,40,SFO,307,53,24,70,47,7,Win,139,103,1,2,4,ARI,54,446,156,1
0.538461538,0.307692308,31.88333333,9/27/2015,2015,3,21,21,away,27,MIA,277,289,40,63,41,14,Win,151,102,0,2,3,BUF,55,428,391,0
0.307692308,0.538461538,28.11666667,9/27/2015,2015,3,21,21,home,-27,BUF,289,277,36,71,14,41,Loss,102,151,2,0,0,MIA,55,391,428,3
0.230769231,0.3125,27.4,9/27/2015,2015,3,7,17,away,-26,SEA,48,212,40,46,0,26,Loss,98,159,2,4,0,CHI,26,146,371,0
0.3125,0.230769231,32.6,9/27/2015,2015,3,17,7,home,26,CHI,212,48,41,63,26,0,Win,159,98,4,2,0,SEA,26,371,146,0
0.333333333,0.333333333,28.86666667,9/27/2015,2015,3,19,22,away,12,DET,313,262,94,62,24,12,Win,41,28,1,4,3,DEN,36,354,290,2
0.333333333,0.333333333,31.13333333,9/27/2015,2015,3,22,19,home,-12,DEN,262,313,75,68,12,24,Loss,28,41,4,1,2,DET,36,290,354,3
0.2,0.363636364,26.5,9/28/2015,2015,3,23,26,away,-10,GBP,251,325,38,65,28,38,Loss,75,123,7,1,0,KCC,66,326,448,1
0.363636364,0.2,33.5,9/28/2015,2015,3,26,23,home,10,KCC,325,251,89,68,38,28,Win,123,75,1,7,1,GBP,66,448,326,0
0.352941176,0.153846154,37.71666667,10/1/2015,2015,4,21,17,away,3,PIT,165,96,30,78,3,0,Win,191,167,5,4,0,BAL,3,356,263,2
0.153846154,0.352941176,32.15,10/1/2015,2015,4,17,21,home,-3,BAL,96,165,20,63,0,3,Loss,167,191,4,5,2,PIT,3,263,356,0
0.375,0,37.38333333,10/4/2015,2015,4,23,17,away,13,MIA,218,167,163,72,27,14,Win,207,59,0,3,2,NYJ,41,425,226,1
0,0.375,22.61666667,10/4/2015,2015,4,17,23,home,-13,NYJ,167,218,80,58,14,27,Loss,59,207,3,0,1,MIA,41,226,425,2
0.388888889,0.466666667,36.16666667,10/4/2015,2015,4,21,22,away,-3,IND,289,266,92,79,0,3,Loss,142,60,1,3,2,JAX,3,431,326,0
0.466666667,0.388888889,34.23333333,10/4/2015,2015,4,22,21,home,3,JAX,266,289,45,74,3,0,Win,60,142,3,1,0,IND,3,326,431,2
0.2,0.1875,30.55,10/4/2015,2015,4,19,14,away,14,BUF,211,258,85,64,24,10,Win,92,55,1,2,2,NYG,34,303,313,1
0.1875,0.2,29.45,10/4/2015,2015,4,14,19,home,-14,NYG,258,211,135,68,10,24,Loss,55,92,2,1,1,BUF,34,313,303,2
0.272727273,0.5,27.86666667,10/4/2015,2015,4,17,25,away,14,TBB,111,270,45,57,37,23,Win,133,141,2,2,5,CAR,60,244,411,1
0.5,0.272727273,32.13333333,10/4/2015,2015,4,25,17,home,-14,CAR,270,111,48,75,23,37,Loss,141,133,2,2,1,TBB,60,411,244,5
0.333333333,0.529411765,18.86666667,10/4/2015,2015,4,14,25,away,-3,WAS,233,290,72,51,20,23,Loss,87,127,5,1,1,PHI,43,320,417,2
0.529411765,0.333333333,41.13333333,10/4/2015,2015,4,25,14,home,3,PHI,290,233,110,79,23,20,Win,127,87,1,5,2,WAS,43,417,320,1
0.461538462,0.588235294,26.63333333,10/4/2015,2015,4,16,23,away,-2,CHI,173,273,47,57,20,22,Loss,70,98,2,3,3,OAK,42,243,371,2
0.588235294,0.461538462,33.36666667,10/4/2015,2015,4,23,16,home,2,OAK,273,173,48,75,22,20,Win,98,70,3,2,2,CHI,42,371,243,3
0.466666667,0.5625,24.13333333,10/4/2015,2015,4,24,22,away,-27,ATL,374,243,35,75,21,48,Loss,54,135,1,2,0,HOU,69,428,378,4
0.5625,0.466666667,35.86666667,10/4/2015,2015,4,22,24,home,27,HOU,243,374,80,64,48,21,Win,135,54,2,1,4,ATL,69,378,428,0
0.4375,0.6,36.88333333,10/4/2015,2015,4,24,18,away,-15,CIN,348,321,46,73,21,36,Loss,113,124,5,0,0,KCC,57,461,445,1
0.6,0.4375,23.11666667,10/4/2015,2015,4,18,24,home,15,KCC,321,348,84,50,36,21,Win,124,113,0,5,1,CIN,57,445,461,0
0.307692308,0.272727273,34.31666667,10/4/2015,2015,4,20,23,away,-3,LAC,332,347,91,66,27,30,Loss,100,91,4,2,0,CLE,57,432,438,1
0.272727273,0.307692308,25.68333333,10/4/2015,2015,4,23,20,home,3,CLE,347,332,31,61,30,27,Win,91,100,2,4,1,LAC,57,438,432,0
0.333333333,0.307692308,36.56666667,10/4/2015,2015,4,18,8,away,14,SFO,200,119,65,68,17,3,Win,162,77,3,6,1,GBP,20,362,196,0
0.307692308,0.333333333,23.43333333,10/4/2015,2015,4,8,18,home,-14,GBP,119,200,30,50,3,17,Loss,77,162,6,3,0,SFO,20,196,362,1
0.384615385,0.181818182,26.78333333,10/4/2015,2015,4,13,26,away,2,ARI,164,334,66,51,24,22,Win,164,113,1,4,3,LAR,46,328,447,0
0.181818182,0.384615385,33.21666667,10/4/2015,2015,4,26,13,home,-2,LAR,334,164,20,71,22,24,Loss,113,164,4,1,0,ARI,46,447,328,3
0.375,0.222222222,33.9,10/4/2015,2015,4,19,18,away,-3,DEN,212,200,63,69,20,23,Loss,113,144,7,2,2,MIN,43,325,344,1
0.222222222,0.375,26.1,10/4/2015,2015,4,18,19,home,3,MIN,200,212,40,53,23,20,Win,144,113,2,7,1,DEN,43,344,325,2
0.25,0.461538462,29.33333333,10/4/2015,2015,4,21,27,away,-6,NOS,220,335,30,57,0,6,Loss,115,103,3,3,0,DAL,6,335,438,0
0.461538462,0.25,30.88333333,10/4/2015,2015,4,27,21,home,6,DAL,335,220,64,69,6,0,Win,103,115,3,3,0,NOS,6,438,335,0
0.230769231,0.461538462,27.93333333,10/5/2015,2015,4,12,18,away,-3,SEA,203,235,37,53,10,13,Loss,53,110,0,6,3,DET,23,256,345,1
0.461538462,0.230769231,32.06666667,10/5/2015,2015,4,18,12,home,3,DET,235,203,30,63,13,10,Win,110,53,6,0,1,SEA,23,345,256,3
0.272727273,0.5,27.55,10/8/2015,2015,5,22,24,away,7,HOU,213,362,65,59,27,20,Win,110,82,0,1,2,IND,47,323,444,0
0.5,0.272727273,32.45,10/8/2015,2015,5,24,22,home,-7,IND,362,213,125,70,20,27,Loss,82,110,1,0,0,HOU,47,444,323,2
0.428571429,0.357142857,33.61666667,10/11/2015,2015,5,21,16,away,1,KCC,241,170,49,73,18,17,Win,87,117,2,3,0,CHI,35,328,287,1
0.357142857,0.428571429,26.38333333,10/11/2015,2015,5,16,21,home,-1,CHI,170,241,49,58,17,18,Loss,117,87,3,2,1,KCC,35,287,328,0
0.384615385,0.4,30.58333333,10/11/2015,2015,5,16,27,away,-3,CIN,197,310,112,57,0,3,Loss,200,109,4,4,2,SEA,3,397,419,1
0.4,0.384615385,40.81666667,10/11/2015,2015,5,27,16,home,3,SEA,310,197,50,79,3,0,Win,109,200,4,4,1,CIN,3,419,397,2
0.333333333,0.4,27.81666667,10/11/2015,2015,5,18,29,away,-6,ATL,219,242,51,57,0,6,Loss,51,176,1,3,3,WAS,6,270,418,2
0.4,0.333333333,34.93333333,10/11/2015,2015,5,29,18,home,6,WAS,242,219,62,77,6,0,Win,176,51,3,1,2,ATL,6,418,270,3
0.25,0.454545455,25.31666667,10/11/2015,2015,5,21,20,away,-7,TBB,270,186,12,56,31,38,Loss,55,183,6,2,0,JAX,69,325,369,2
0.454545455,0.25,34.68333333,10/11/2015,2015,5,20,21,home,7,JAX,186,270,72,61,38,31,Win,183,55,2,6,2,TBB,69,369,325,0
0.5,0.363636364,25.96666667,10/11/2015,2015,5,19,34,away,-22,PHI,292,333,78,69,17,39,Loss,96,186,5,0,2,NOS,56,388,519,4
0.363636364,0.5,34.03333333,10/11/2015,2015,5,34,19,home,22,NOS,333,292,35,79,39,17,Win,186,96,0,5,4,PHI,56,519,388,2
0.631578947,0.357142857,39.26666667,10/11/2015,2015,5,25,22,away,3,BAL,422,196,74,80,3,0,Win,83,181,4,1,0,CLE,3,505,377,0
0.357142857,0.631578947,29.01666667,10/11/2015,2015,5,22,25,home,-3,CLE,196,422,98,67,0,3,Loss,181,83,1,4,0,BAL,3,377,505,0
0.277777778,0.307692308,33.71666667,10/11/2015,2015,5,17,14,away,-14,GBP,143,236,40,70,10,24,Loss,191,86,3,2,3,LAR,34,334,322,4
0.307692308,0.277777778,26.28333333,10/11/2015,2015,5,14,17,home,14,LAR,236,143,67,59,24,10,Win,86,191,2,3,4,GBP,34,322,334,3
0.333333333,0.384615385,24.48333333,10/11/2015,2015,5,13,17,away,1,TEN,82,179,62,50,14,13,Win,127,97,4,2,1,BUF,27,209,276,1
0.384615385,0.333333333,35.51666667,10/11/2015,2015,5,17,13,home,-1,BUF,179,82,74,62,13,14,Loss,97,127,2,4,1,TEN,27,276,209,1
0.125,0.470588235,23.46666667,10/11/2015,2015,5,15,29,away,25,DET,158,379,70,45,42,17,Win,187,56,2,1,6,ARI,59,345,435,0
0.470588235,0.125,36.53333333,10/11/2015,2015,5,29,15,home,-25,ARI,379,158,85,89,17,42,Loss,56,187,1,2,0,DET,59,435,345,6
0.3,0.285714286,26.8,10/11/2015,2015,5,20,18,away,24,DAL,247,163,64,55,30,6,Win,109,102,5,3,2,NEP,36,356,265,0
0.285714286,0.3,33.2,10/11/2015,2015,5,18,20,home,-24,NEP,163,247,50,66,6,30,Loss,102,109,3,5,0,DAL,36,265,356,2
0.153846154,0.4375,25.85,10/11/2015,2015,5,15,20,away,6,OAK,254,223,103,55,16,10,Win,43,65,2,4,3,DEN,26,297,288,2
0.4375,0.153846154,34.15,10/11/2015,2015,5,20,15,home,-6,DEN,223,254,41,68,10,16,Loss,65,43,4,2,2,OAK,26,288,297,3
0.571428571,0.642857143,28.03333333,10/11/2015,2015,5,22,30,away,-3,NYG,256,441,28,64,27,30,Loss,124,84,2,0,1,SFO,57,380,525,0
0.642857143,0.571428571,31.96666667,10/11/2015,2015,5,30,22,home,3,SFO,441,256,65,75,30,27,Win,84,124,0,2,0,NYG,57,525,380,1
0.357142857,0.285714286,26.28333333,10/12/2015,2015,5,14,24,away,4,LAC,194,354,86,56,24,20,Win,155,52,3,2,2,PIT,44,349,406,1
0.285714286,0.357142857,33.71666667,10/12/2015,2015,5,24,14,home,-4,PIT,354,194,54,69,20,24,Loss,52,155,2,3,1,LAC,44,406,349,2
0.25,0.5,27.5,10/15/2015,2015,6,23,25,away,-10,NOS,263,304,41,70,21,31,Loss,150,81,5,1,0,ATL,52,413,385,3
0.5,0.25,32.5,10/15/2015,2015,6,25,23,home,10,ATL,304,263,15,72,31,21,Win,81,150,1,5,3,NOS,52,385,413,0
0.333333333,0.5,27.35,10/18/2015,2015,6,14,22,away,-14,NYJ,191,253,15,62,20,34,Loss,34,221,1,0,3,WAS,54,225,474,2
0.5,0.333333333,32.65,10/18/2015,2015,6,22,14,home,14,WAS,253,191,5,67,34,20,Win,221,34,0,1,2,NYJ,54,474,225,3
0.416666667,0.25,31.15,10/18/2015,2015,6,21,14,away,-12,PIT,414,169,111,66,13,25,Loss,55,141,1,1,0,ARI,38,469,310,3
0.25,0.416666667,28.85,10/18/2015,2015,6,14,21,home,12,ARI,169,414,48,53,25,13,Win,141,55,1,1,3,PIT,38,310,469,0
0.25,0.352941176,26.88333333,10/18/2015,2015,6,16,16,away,-6,MIN,271,237,95,57,10,16,Loss,57,84,2,2,2,KCC,26,328,321,1
0.352941176,0.25,33.11666667,10/18/2015,2015,6,16,16,home,6,KCC,237,271,50,68,16,10,Win,84,57,2,2,1,MIN,26,321,328,2
0.583333333,0.384615385,30,10/18/2015,2015,6,21,22,away,13,BUF,243,256,20,61,34,21,Win,112,112,0,2,1,CIN,55,355,368,0
0.384615385,0.583333333,30,10/18/2015,2015,6,22,21,home,-13,CIN,256,243,93,67,21,34,Loss,112,112,2,0,0,BUF,55,368,355,1
0.428571429,0.529411765,33.56666667,10/18/2015,2015,6,24,26,away,-3,DET,353,391,76,73,0,3,Loss,91,155,1,2,3,CHI,3,444,546,1
0.529411765,0.428571429,38.95,10/18/2015,2015,6,26,24,home,3,CHI,391,353,98,76,3,0,Win,155,91,2,1,1,DET,3,546,444,3
0.222222222,0.4,36.9,10/18/2015,2015,6,21,20,away,3,CLE,290,189,81,81,3,0,Win,152,109,0,4,3,DEN,3,442,298,3
0.4,0.222222222,33.16666667,10/18/2015,2015,6,20,21,home,-3,DEN,189,290,30,76,0,3,Loss,109,152,4,0,3,CLE,3,298,442,3
0.5,0.333333333,30.03333333,10/18/2015,2015,6,24,26,away,11,JAX,287,311,69,68,31,20,Win,95,83,1,3,3,HOU,51,382,394,0
0.333333333,0.5,29.96666667,10/18/2015,2015,6,26,24,home,-11,HOU,311,287,64,77,20,31,Loss,83,95,3,1,0,JAX,51,394,382,3
0.555555556,0.2,31.88333333,10/18/2015,2015,6,26,22,away,28,TEN,254,236,97,63,38,10,Win,180,63,2,6,4,MIA,48,434,299,2
0.2,0.555555556,28.11666667,10/18/2015,2015,6,22,26,home,-28,MIA,236,254,50,65,10,38,Loss,63,180,6,2,2,TEN,48,299,434,4
0.363636364,0.285714286,32.2,10/18/2015,2015,6,25,14,away,4,SEA,248,219,25,72,27,23,Win,135,115,3,4,0,CAR,50,383,334,2
0.285714286,0.363636364,27.8,10/18/2015,2015,6,14,25,home,-4,CAR,219,248,48,60,23,27,Loss,115,135,4,3,2,SEA,50,334,383,0
0.5,0.333333333,37.98333333,10/18/2015,2015,6,32,17,away,-7,GBP,488,237,76,89,20,27,Loss,60,133,3,3,0,LAC,47,548,370,1
0.333333333,0.5,22.01666667,10/18/2015,2015,6,17,32,home,7,LAC,237,488,50,49,27,20,Win,133,60,3,3,1,GBP,47,370,548,0
0.307692308,0.384615385,33.11666667,10/18/2015,2015,6,25,15,away,-5,SFO,343,326,15,75,20,25,Loss,77,65,0,3,0,BAL,45,420,391,2
0.384615385,0.307692308,26.88333333,10/18/2015,2015,6,15,25,home,5,BAL,326,343,25,55,25,20,Win,65,77,3,0,2,SFO,45,391,420,0
0.416666667,0.4375,27.46666667,10/18/2015,2015,6,22,24,away,7,IND,301,289,72,64,34,27,Win,116,120,2,3,0,NEP,61,417,409,1
0.4375,0.416666667,32.53333333,10/18/2015,2015,6,24,22,home,-7,NEP,289,301,103,75,27,34,Loss,120,116,3,2,1,IND,61,409,417,0
0.307692308,0.375,29.6,10/19/2015,2015,6,18,24,away,-20,PHI,166,270,94,64,7,27,Loss,81,158,3,1,4,NYG,34,247,428,3
0.375,0.307692308,30.4,10/19/2015,2015,6,24,18,home,20,NYG,270,166,72,76,27,7,Win,158,81,1,3,3,PHI,34,428,247,4
0.384615385,0.090909091,38.08333333,10/22/2015,2015,7,21,8,away,17,SFO,212,81,50,70,20,3,Win,176,61,5,6,0,SEA,23,388,142,2
0.090909091,0.384615385,21.91666667,10/22/2015,2015,7,8,21,home,-17,SEA,81,212,33,45,3,20,Loss,61,176,6,5,2,SFO,23,142,388,0
0.25,0.357142857,31.36666667,10/25/2015,2015,7,26,17,away,-3,JAX,260,175,87,74,31,34,Loss,115,120,4,2,1,BUF,65,375,295,4
0.357142857,0.25,28.63333333,10/25/2015,2015,7,17,26,home,3,BUF,175,260,66,63,34,31,Win,120,115,2,4,4,JAX,65,295,375,1
0.583333333,0.454545455,31.3,10/25/2015,2015,7,21,27,away,-1,WAS,289,305,142,60,30,31,Loss,190,50,1,1,1,TBB,61,479,355,1
0.454545455,0.583333333,28.7,10/25/2015,2015,7,27,21,home,1,TBB,305,289,20,60,31,30,Win,50,190,1,1,1,WAS,61,355,479,1
0.357142857,0.111111111,34.75,10/25/2015,2015,7,21,15,away,3,TEN,251,179,53,69,10,7,Win,127,77,0,1,2,ATL,17,378,256,2
0.111111111,0.357142857,25.25,10/25/2015,2015,7,15,21,home,-3,ATL,179,251,45,52,7,10,Loss,77,127,1,0,2,TEN,17,256,378,2
0.35,0.230769231,38.38333333,10/25/2015,2015,7,22,15,away,6,IND,266,301,100,83,27,21,Win,183,75,2,4,3,NOS,48,449,376,1
0.230769231,0.35,21.61666667,10/25/2015,2015,7,15,22,home,-6,NOS,301,266,42,61,21,27,Loss,75,183,4,2,1,IND,48,376,449,3
0.384615385,0.1,36.45,10/25/2015,2015,7,25,14,away,9,DET,285,197,31,74,28,19,Win,140,77,4,7,0,MIN,47,425,274,1
0.1,0.384615385,23.55,10/25/2015,2015,7,14,25,home,-9,MIN,197,285,30,50,19,28,Loss,77,140,7,4,1,DET,47,274,425,0
0.2,0.5625,27.56666667,10/25/2015,2015,7,18,18,away,-10,KCC,192,239,5,55,13,23,Loss,147,138,2,2,0,PIT,36,339,377,3
0.5625,0.2,32.43333333,10/25/2015,2015,7,18,18,home,10,PIT,239,192,66,63,23,13,Win,138,147,2,2,3,KCC,36,377,339,0
0.25,0.111111111,35.55,10/25/2015,2015,7,19,16,away,-18,LAR,282,150,98,65,6,24,Loss,82,158,4,2,1,CLE,30,364,308,4
0.111111111,0.25,24.45,10/25/2015,2015,7,16,19,home,18,CLE,150,282,75,51,24,6,Win,158,82,2,4,4,LAR,30,308,364,1
0.4,0.111111111,27.91666667,10/25/2015,2015,7,24,21,away,-18,MIA,251,255,25,78,26,44,Loss,71,248,4,4,1,HOU,70,322,503,1
0.111111111,0.4,32.08333333,10/25/2015,2015,7,21,24,home,18,HOU,255,251,52,59,44,26,Win,248,71,4,4,1,MIA,70,503,322,1
0.571428571,0.5,33.05,10/25/2015,2015,7,25,20,away,-7,NEP,283,337,29,70,23,30,Loss,89,16,2,3,0,NYJ,53,372,353,1
0.5,0.571428571,26.95,10/25/2015,2015,7,20,25,home,7,NYJ,337,283,38,66,30,23,Win,16,89,3,2,1,NEP,53,353,372,0
0.416666667,0.5,30.81666667,10/25/2015,2015,7,19,28,away,8,LAC,282,327,136,58,37,29,Win,130,90,1,1,2,OAK,66,412,417,0
0.5,0.416666667,29.18333333,10/25/2015,2015,7,28,19,home,-8,OAK,327,282,86,80,29,37,Loss,90,130,1,1,0,LAC,66,417,412,2
0.545454545,0.272727273,38.06666667,10/25/2015,2015,7,27,13,away,-7,NYG,227,157,46,69,20,27,Loss,233,132,1,2,0,DAL,47,460,289,4
0.272727273,0.545454545,21.93333333,10/25/2015,2015,7,13,27,home,7,DAL,157,227,13,51,27,20,Win,132,233,2,1,4,NYG,47,289,460,0
0.388888889,0.222222222,31.1,10/25/2015,2015,7,20,21,away,-11,CAR,172,190,46,81,16,27,Loss,177,204,5,1,3,PHI,43,349,394,1
0.222222222,0.388888889,28.9,10/25/2015,2015,7,21,20,home,11,PHI,190,172,43,58,27,16,Win,204,177,1,5,1,CAR,43,394,349,3
0.384615385,0.416666667,30.4,10/26/2015,2015,7,18,21,away,-8,ARI,221,264,64,59,18,26,Loss,55,150,3,2,0,BAL,44,276,414,2
0.416666667,0.384615385,29.6,10/26/2015,2015,7,21,18,home,8,BAL,264,221,40,59,26,18,Win,150,55,2,3,2,ARI,44,414,276,0
0.181818182,0.25,27.38333333,10/29/2015,2015,8,18,24,away,-29,NEP,255,342,40,62,7,36,Loss,15,95,5,2,0,MIA,43,270,437,2
0.25,0.181818182,32.61666667,10/29/2015,2015,8,24,18,home,29,MIA,342,255,69,66,36,7,Win,95,15,2,5,2,NEP,43,437,270,0
0.166666667,0.615384615,25.76666667,11/1/2015,2015,8,16,24,away,-35,KCC,195,134,81,58,10,45,Loss,81,206,6,3,0,DET,55,276,340,2
0.615384615,0.166666667,34.23333333,11/1/2015,2015,8,24,16,home,35,DET,134,195,20,63,45,10,Win,206,81,3,6,2,KCC,55,340,276,0
0.461538462,0.5,30.18333333,11/1/2015,2015,8,21,28,away,3,ATL,173,395,43,63,3,0,Win,117,101,2,1,4,TBB,3,290,496,0
0.5,0.461538462,39.08333333,11/1/2015,2015,8,28,21,home,-3,TBB,395,173,124,73,0,3,Loss,101,117,1,2,0,ATL,3,496,290,4
0.8125,0.5625,34.38333333,11/1/2015,2015,8,25,16,away,14,CLE,372,215,25,77,34,20,Win,119,39,1,1,2,ARI,54,491,254,4
0.5625,0.8125,25.61666667,11/1/2015,2015,8,16,25,home,-14,ARI,215,372,35,61,20,34,Loss,39,119,1,1,4,CLE,54,254,491,2
0.176470588,0.083333333,28.03333333,11/1/2015,2015,8,11,16,away,-21,LAR,151,191,93,65,6,27,Loss,38,197,3,0,1,SFO,33,189,388,0
0.083333333,0.176470588,31.96666667,11/1/2015,2015,8,16,11,home,21,SFO,191,151,93,64,27,6,Win,197,38,0,3,0,LAR,33,388,189,1
0.125,0.636363636,25.08333333,11/1/2015,2015,8,28,35,away,-3,NOS,329,505,53,65,49,52,Loss,87,103,3,0,2,NYG,101,416,608,1
0.636363636,0.125,34.91666667,11/1/2015,2015,8,35,28,home,3,NYG,505,329,93,76,52,49,Win,103,87,0,3,1,NOS,101,608,416,2
0.416666667,0.25,27.3,11/1/2015,2015,8,17,18,away,3,CHI,180,208,35,56,23,20,Win,147,97,1,1,0,MIN,43,327,305,1
0.25,0.416666667,32.7,11/1/2015,2015,8,18,17,home,-3,MIN,208,180,38,59,20,23,Loss,97,147,1,1,1,CHI,43,305,327,0
0.538461538,0.416666667,30.1,11/1/2015,2015,8,22,23,away,-3,BAL,290,293,66,64,26,29,Loss,81,72,1,3,0,LAC,55,371,365,0
0.416666667,0.538461538,29.9,11/1/2015,2015,8,23,22,home,3,LAC,293,290,46,65,29,26,Win,72,81,3,1,0,BAL,55,365,371,0
0.266666667,0.272727273,29.85,11/1/2015,2015,8,16,21,away,6,PIT,218,240,94,64,16,10,Win,78,116,3,3,3,CIN,26,296,356,2
0.272727273,0.266666667,30.15,11/1/2015,2015,8,21,16,home,-6,CIN,240,218,91,67,10,16,Loss,116,78,3,3,2,PIT,26,356,296,3
0.083333333,0.266666667,31.13333333,11/1/2015,2015,8,15,14,away,-14,HOU,125,214,45,58,6,20,Loss,86,56,7,3,0,TEN,26,211,270,3
0.266666667,0.083333333,28.86666667,11/1/2015,2015,8,14,15,home,14,TEN,214,125,85,61,20,6,Win,56,86,3,7,3,HOU,26,270,211,0
0.4375,0.4,29.36666667,11/1/2015,2015,8,22,21,away,-14,OAK,292,333,40,71,20,34,Loss,74,118,3,0,0,NYJ,54,366,451,1
0.4,0.4375,30.63333333,11/1/2015,2015,8,21,22,home,14,NYJ,333,292,61,61,34,20,Win,118,74,0,3,1,OAK,54,451,366,0
0.416666667,0.285714286,29.63333333,11/1/2015,2015,8,19,14,away,1,DAL,210,91,40,61,13,12,Win,113,129,0,1,0,SEA,25,323,220,1
0.285714286,0.416666667,30.36666667,11/1/2015,2015,8,14,19,home,-1,SEA,91,210,40,57,12,13,Loss,129,113,1,0,1,DAL,25,220,323,0
0.25,0.5,26.55,11/1/2015,2015,8,14,24,away,-19,DEN,50,340,15,46,10,29,Loss,90,160,3,0,1,GBP,39,140,500,0
0.5,0.25,33.45,11/1/2015,2015,8,24,14,home,19,GBP,340,50,93,63,29,10,Win,160,90,0,3,0,DEN,39,500,140,1
0.333333333,0.25,36,11/2/2015,2015,8,19,17,away,-3,CAR,223,239,15,84,3,6,Loss,136,140,2,2,3,IND,9,359,379,4
0.25,0.333333333,33.63333333,11/2/2015,2015,8,17,19,home,3,IND,239,223,55,73,6,3,Win,140,136,2,2,4,CAR,9,379,359,3
0.307692308,0.571428571,23.95,11/5/2015,2015,9,13,23,away,-21,CIN,144,219,28,53,10,31,Loss,69,152,3,2,0,CLE,41,213,371,0
0.571428571,0.307692308,36.05,11/5/2015,2015,9,23,13,home,21,CLE,219,144,20,66,31,10,Win,152,69,2,3,0,CIN,41,371,213,0
0.214285714,0.333333333,27.8,11/8/2015,2015,9,21,20,away,-8,CAR,331,297,87,72,29,37,Loss,71,130,5,0,1,GBP,66,402,427,2
0.333333333,0.214285714,32.2,11/8/2015,2015,9,20,21,home,8,GBP,297,331,45,66,37,29,Win,130,71,0,5,2,CAR,66,427,402,1
0.5,0.5625,22.91666667,11/8/2015,2015,9,16,27,away,-17,NEP,213,299,27,56,10,27,Loss,37,161,1,0,2,WAS,37,250,460,2
0.5625,0.5,37.08333333,11/8/2015,2015,9,27,16,home,17,WAS,299,213,43,76,27,10,Win,161,37,0,1,2,NEP,37,460,250,2
0.384615385,0.545454545,32.35,11/8/2015,2015,9,25,30,away,6,NOS,371,355,66,67,6,0,Win,112,61,0,4,2,TEN,6,483,416,1
0.545454545,0.384615385,32.81666667,11/8/2015,2015,9,30,25,home,-6,TEN,355,371,75,70,0,6,Loss,61,112,4,0,1,NOS,6,416,483,2
0.444444444,0.615384615,28.78333333,11/8/2015,2015,9,29,18,away,-16,BUF,289,154,62,62,17,33,Loss,108,266,2,3,0,MIA,50,397,420,1
0.615384615,0.444444444,31.21666667,11/8/2015,2015,9,18,29,home,16,MIA,154,289,94,51,33,17,Win,266,108,3,2,1,BUF,50,420,397,0
0.125,0.230769231,32.45,11/8/2015,2015,9,18,21,away,-3,MIN,160,148,87,70,0,3,Loss,160,145,1,1,1,LAR,3,320,293,0
0.230769231,0.125,33.21666667,11/8/2015,2015,9,21,18,home,3,LAR,148,160,67,63,3,0,Win,145,160,1,1,0,MIN,3,293,320,1
0.4375,0.333333333,29.26666667,11/8/2015,2015,9,19,14,away,-5,NYJ,338,261,30,65,23,28,Loss,98,29,6,2,0,JAX,51,436,290,4
0.333333333,0.4375,30.73333333,11/8/2015,2015,9,14,19,home,5,JAX,261,338,41,64,28,23,Win,29,98,2,6,4,NYJ,51,290,436,0
0.428571429,0.352941176,27.93333333,11/8/2015,2015,9,24,27,away,-3,PIT,301,402,21,69,35,38,Loss,139,195,0,1,2,OAK,73,440,597,4
0.352941176,0.428571429,32.06666667,11/8/2015,2015,9,27,24,home,3,OAK,402,301,42,81,38,35,Win,195,139,1,0,4,PIT,73,597,440,2
0.5625,0.461538462,34.91666667,11/8/2015,2015,9,24,19,away,14,TBB,213,247,49,73,32,18,Win,114,136,0,0,3,NYG,50,327,383,2
0.461538462,0.5625,25.08333333,11/8/2015,2015,9,19,24,home,-14,NYG,247,213,79,59,18,32,Loss,136,114,0,0,2,TBB,50,383,327,3
0.333333333,0.428571429,32.13333333,11/8/2015,2015,9,17,18,away,-1,SFO,285,185,63,61,16,17,Loss,17,133,2,0,2,ATL,33,302,318,0
0.428571429,0.333333333,27.86666667,11/8/2015,2015,9,18,17,home,1,ATL,185,285,30,64,17,16,Win,133,17,0,2,0,SFO,33,318,302,2
0.5,0.6,21.35,11/8/2015,2015,9,16,27,away,-3,IND,274,245,56,51,24,27,Loss,35,120,1,1,0,DEN,51,309,365,2
0.6,0.5,38.65,11/8/2015,2015,9,27,16,home,3,DEN,245,274,30,77,27,24,Win,120,35,1,1,2,IND,51,365,309,0
0.230769231,0.5,25.7,11/8/2015,2015,9,25,25,away,6,DAL,287,277,70,72,6,0,Win,172,134,1,4,1,PHI,6,459,411,0
0.5,0.230769231,38.31666667,11/8/2015,2015,9,25,25,home,-6,PHI,277,287,58,71,0,6,Loss,134,172,4,1,0,DAL,6,411,459,1
0.6,0.538461538,33.58333333,11/9/2015,2015,9,25,19,away,3,LAC,337,262,55,70,22,19,Win,109,77,1,2,1,CHI,41,446,339,2
0.538461538,0.6,26.41666667,11/9/2015,2015,9,19,25,home,-3,CHI,262,337,54,63,19,22,Loss,77,109,2,1,2,LAC,41,339,446,1
0.3125,0.230769231,33.26666667,11/12/2015,2015,10,13,15,away,5,NYJ,132,190,44,64,22,17,Win,148,128,4,1,4,BUF,39,280,318,0
0.230769231,0.3125,26.73333333,11/12/2015,2015,10,15,13,home,-5,BUF,190,132,20,59,17,22,Loss,128,148,1,4,0,NYJ,39,318,280,4
0.3125,0.473684211,30.66666667,11/15/2015,2015,10,16,22,away,2,GBP,242,325,35,64,18,16,Win,45,47,0,3,0,DET,34,287,372,1
0.473684211,0.3125,29.33333333,11/15/2015,2015,10,22,16,home,-2,DET,325,242,55,82,16,18,Loss,47,45,3,0,1,GBP,34,372,287,0
0.307692308,0.333333333,30.06666667,11/15/2015,2015,10,12,23,away,-4,TBB,174,246,65,53,6,10,Loss,42,84,3,2,2,DAL,16,216,330,1
0.333333333,0.307692308,29.93333333,11/15/2015,2015,10,23,12,home,4,DAL,246,174,62,67,10,6,Win,84,42,2,3,1,TBB,16,330,216,2
0.538461538,0.416666667,35.91666667,11/15/2015,2015,10,24,11,away,17,TEN,184,178,45,64,27,10,Win,119,64,5,1,2,CAR,37,303,242,0
0.416666667,0.538461538,24.08333333,11/15/2015,2015,10,11,24,home,-17,CAR,178,184,30,46,10,27,Loss,64,119,1,5,0,TEN,37,242,303,2
0.25,0.285714286,34.36666667,11/15/2015,2015,10,17,12,away,24,LAR,244,191,44,63,37,13,Win,153,94,2,1,2,CHI,50,397,285,2
0.285714286,0.25,25.63333333,11/15/2015,2015,10,12,17,home,-24,CHI,191,244,57,59,13,37,Loss,94,153,1,2,2,LAR,50,285,397,2
0.363636364,0.545454545,26.43333333,11/15/2015,2015,10,16,23,away,-33,WAS,192,301,50,55,14,47,Loss,158,209,2,3,0,NOS,61,350,510,2
0.545454545,0.363636364,33.56666667,11/15/2015,2015,10,23,16,home,33,NOS,301,192,26,59,47,14,Win,209,158,3,2,2,WAS,61,510,350,0
0.333333333,0.388888889,28.88333333,11/15/2015,2015,10,15,29,away,1,PHI,190,353,84,66,20,19,Win,99,83,4,4,1,MIA,39,289,436,0
0.388888889,0.333333333,31.11666667,11/15/2015,2015,10,29,15,home,-1,MIA,353,190,54,87,19,20,Loss,83,99,4,4,0,PHI,39,436,289,1
0.384615385,0.3,32.71666667,11/15/2015,2015,10,20,22,away,-21,PIT,327,399,188,65,9,30,Loss,15,60,6,1,2,CLE,39,342,459,3
0.3,0.384615385,27.28333333,11/15/2015,2015,10,22,20,home,21,CLE,399,327,50,59,30,9,Win,60,15,1,6,3,PIT,39,459,342,2
0.25,0.571428571,30.53333333,11/15/2015,2015,10,22,22,away,2,BAL,168,308,30,70,22,20,Win,90,89,3,1,4,JAX,42,258,397,1
0.571428571,0.25,29.46666667,11/15/2015,2015,10,22,22,home,-2,JAX,308,168,121,67,20,22,Loss,89,90,1,3,1,BAL,42,397,258,4
0.363636364,0.5,33.01666667,11/15/2015,2015,10,21,20,away,16,OAK,122,287,15,59,30,14,Win,263,84,4,2,2,MIN,44,385,371,0
0.5,0.363636364,26.98333333,11/15/2015,2015,10,20,21,home,-16,MIN,287,122,82,64,14,30,Loss,84,263,2,4,0,OAK,44,371,385,2
0.5,0.466666667,31.6,11/15/2015,2015,10,22,21,away,1,NYG,329,342,93,68,27,26,Win,77,80,3,3,1,NEP,53,406,422,2
0.466666667,0.5,28.4,11/15/2015,2015,10,21,22,home,-1,NEP,342,329,49,70,26,27,Loss,80,77,3,3,2,NYG,53,422,406,1
0.25,0.214285714,33.45,11/15/2015,2015,10,13,18,away,16,DEN,197,152,102,65,29,13,Win,106,69,2,5,5,KCC,42,303,221,0
0.214285714,0.25,26.55,11/15/2015,2015,10,18,13,home,-16,KCC,152,197,55,65,13,29,Loss,69,106,5,2,0,DEN,42,221,303,5
0.470588235,0.125,38.86666667,11/15/2015,2015,10,30,18,away,7,SEA,334,228,66,83,39,32,Win,117,115,3,2,1,ARI,71,451,343,3
0.125,0.470588235,21.13333333,11/15/2015,2015,10,18,30,home,-7,ARI,228,334,131,52,32,39,Loss,115,117,2,3,3,SEA,71,343,451,1
0.333333333,0.285714286,28.56666667,11/16/2015,2015,10,16,16,away,4,CIN,174,182,54,61,10,6,Win,82,74,3,4,2,HOU,16,256,256,1
0.285714286,0.333333333,31.43333333,11/16/2015,2015,10,16,16,home,-4,HOU,182,174,70,62,6,10,Loss,74,82,4,3,1,CIN,16,256,256,2
0.384615385,0.307692308,31.58333333,11/19/2015,2015,11,22,18,away,-6,JAX,212,218,59,65,13,19,Loss,104,90,4,4,2,TEN,32,316,308,1
0.307692308,0.384615385,28.41666667,11/19/2015,2015,11,18,22,home,6,TEN,218,212,88,58,19,13,Win,90,104,4,4,1,JAX,32,308,316,2
0.363636364,0.428571429,23.96666667,11/22/2015,2015,11,13,22,away,-5,DET,164,266,31,47,13,18,Loss,52,109,1,4,0,OAK,31,216,375,0
0.428571429,0.363636364,36.03333333,11/22/2015,2015,11,22,13,home,5,OAK,266,164,55,70,18,13,Win,109,52,4,1,0,DET,31,375,216,0
0.5,0.5,32.65,11/22/2015,2015,11,17,21,away,3,ATL,202,275,42,61,24,21,Win,74,100,2,1,4,IND,45,276,375,3
0.5,0.5,27.35,11/22/2015,2015,11,21,17,home,-3,IND,275,202,69,71,21,24,Loss,100,74,1,2,3,ATL,45,375,276,4
0.214285714,0.388888889,26.68333333,11/22/2015,2015,11,16,19,away,-7,HOU,197,241,54,63,17,24,Loss,70,123,3,1,1,NYJ,41,267,364,2
0.388888889,0.214285714,33.31666667,11/22/2015,2015,11,19,16,home,7,NYJ,241,197,54,73,24,17,Win,123,70,1,3,2,HOU,41,364,267,1
0.625,0.466666667,35.9,11/22/2015,2015,11,25,21,away,28,PHI,238,247,82,72,45,17,Win,283,136,1,3,4,TBB,62,521,383,1
0.466666667,0.625,24.1,11/22/2015,2015,11,21,25,home,-28,TBB,247,238,25,72,17,45,Loss,136,283,3,1,1,PHI,62,383,521,4
0.428571429,0.333333333,33.21666667,11/22/2015,2015,11,21,19,away,2,CHI,219,261,118,68,17,15,Win,170,86,5,2,2,DEN,32,389,347,0
0.333333333,0.428571429,26.78333333,11/22/2015,2015,11,19,21,home,-2,DEN,261,219,0,59,15,17,Loss,86,170,2,5,0,CHI,32,347,389,2
0.230769231,0.25,27.13333333,11/22/2015,2015,11,13,16,away,-3,BAL,131,292,35,56,13,16,Loss,82,96,1,1,2,LAR,29,213,388,4
0.25,0.230769231,32.86666667,11/22/2015,2015,11,16,13,home,3,LAR,292,131,137,73,16,13,Win,96,82,1,1,4,BAL,29,388,213,2
0.5,0.1,38.83333333,11/22/2015,2015,11,22,9,away,10,MIA,220,140,79,68,24,14,Win,166,70,2,3,1,DAL,38,386,210,2
0.1,0.5,21.16666667,11/22/2015,2015,11,9,22,home,-10,DAL,140,220,74,41,14,24,Loss,70,166,3,2,2,MIA,38,210,386,1
0.222222222,0.5,21.88333333,11/22/2015,2015,11,9,27,away,-28,CAR,172,226,68,47,16,44,Loss,14,142,5,2,0,WAS,60,186,368,5
0.5,0.222222222,38.11666667,11/22/2015,2015,11,27,9,home,28,WAS,226,172,66,75,44,16,Win,142,14,2,5,5,CAR,60,368,186,0
0.416666667,0.307692308,33.46666667,11/22/2015,2015,11,22,14,away,30,LAC,232,149,35,59,33,3,Win,153,52,3,3,2,KCC,36,385,201,0
0.307692308,0.416666667,26.53333333,11/22/2015,2015,11,14,22,home,-30,KCC,149,232,39,58,3,33,Loss,52,153,3,3,0,LAC,36,201,385,2
0.375,0.384615385,30.36666667,11/22/2015,2015,11,19,16,away,17,MIN,196,248,19,70,30,13,Win,124,94,2,6,1,GBP,43,320,342,0
0.384615385,0.375,29.63333333,11/22/2015,2015,11,16,19,home,-17,GBP,248,196,110,62,13,30,Loss,94,124,6,2,0,MIN,43,342,320,1
0.181818182,0.571428571,22.35,11/22/2015,2015,11,14,28,away,-16,SEA,247,253,42,52,13,29,Loss,59,255,2,2,0,SFO,42,306,508,0
0.571428571,0.181818182,37.65,11/22/2015,2015,11,28,14,home,16,SFO,253,247,51,75,29,13,Win,255,59,2,2,0,SEA,42,508,306,0
0.384615385,0.454545455,31.25,11/22/2015,2015,11,24,21,away,-3,ARI,278,301,108,71,31,34,Loss,99,82,4,2,2,CIN,65,377,383,1
0.454545455,0.384615385,28.75,11/22/2015,2015,11,21,24,home,3,CIN,301,278,40,58,34,31,Win,82,99,2,4,1,ARI,65,383,377,2
0.2,0.285714286,32.91666667,11/23/2015,2015,11,16,18,away,-7,NEP,225,271,44,68,13,20,Loss,94,85,2,1,1,BUF,33,319,356,1
0.285714286,0.2,27.08333333,11/23/2015,2015,11,18,16,home,7,BUF,271,225,61,62,20,13,Win,85,94,1,2,1,NEP,33,356,319,1
0.428571429,0.5,22.81666667,11/26/2015,2015,12,14,28,away,-31,DET,159,322,30,58,14,45,Loss,68,108,6,2,0,PHI,59,227,430,1
0.5,0.428571429,37.18333333,11/26/2015,2015,12,28,14,home,31,PHI,322,159,29,70,45,14,Win,108,68,2,6,1,DET,59,430,227,0
0.5,0.461538462,35.23333333,11/26/2015,2015,12,18,14,away,19,DAL,165,179,53,65,33,14,Win,129,31,1,2,3,CAR,47,294,210,0
0.461538462,0.5,24.76666667,11/26/2015,2015,12,14,18,home,-19,CAR,179,165,40,56,14,33,Loss,31,129,2,1,0,DAL,47,210,294,3
0.357142857,0.272727273,31.2,11/26/2015,2015,12,17,23,away,4,GBP,189,188,95,63,17,13,Win,101,177,1,2,2,CHI,30,290,365,0
0.272727273,0.357142857,28.8,11/26/2015,2015,12,23,17,home,-4,CHI,188,189,38,73,13,17,Loss,177,101,2,1,0,GBP,30,365,290,2
0.25,0.461538462,23.61666667,11/29/2015,2015,12,14,23,away,-18,HOU,218,195,82,56,6,24,Loss,50,167,2,1,1,NOS,30,268,362,1
0.461538462,0.25,36.38333333,11/29/2015,2015,12,23,14,home,18,NOS,195,218,40,66,24,6,Win,167,50,1,2,1,HOU,30,362,268,1
0.4,0.3,29.88333333,11/29/2015,2015,12,19,19,away,-24,CIN,251,236,45,71,7,31,Loss,94,140,1,0,1,LAR,38,345,376,3
0.3,0.4,30.11666667,11/29/2015,2015,12,19,19,home,24,LAR,236,251,35,59,31,7,Win,140,94,0,1,3,CIN,38,376,345,1
0.583333333,0.454545455,33.46666667,11/29/2015,2015,12,24,22,away,10,ATL,174,210,53,67,20,10,Win,191,116,0,2,3,MIN,30,365,326,1
0.454545455,0.583333333,26.53333333,11/29/2015,2015,12,22,24,home,-10,MIN,210,174,78,57,10,20,Loss,116,191,2,0,1,ATL,30,326,365,3
0.2,0.266666667,24,11/29/2015,2015,12,17,18,away,-6,WAS,299,302,35,67,14,20,Loss,33,105,3,0,0,NYG,34,332,407,3
0.266666667,0.2,36,11/29/2015,2015,12,18,17,home,6,NYG,302,299,80,66,20,14,Win,105,33,0,3,3,WAS,34,407,332,0
0.461538462,0.4375,27.58333333,11/29/2015,2015,12,21,23,away,-13,IND,212,309,95,62,12,25,Loss,132,27,5,3,0,TBB,37,344,336,1
0.4375,0.461538462,32.41666667,11/29/2015,2015,12,23,21,home,13,TBB,309,212,45,71,25,12,Win,27,132,3,5,1,IND,37,336,344,0
0.416666667,0.461538462,30.53333333,11/29/2015,2015,12,25,21,away,-8,KCC,286,255,91,67,22,30,Loss,129,158,1,1,0,BUF,52,415,413,2
0.461538462,0.416666667,29.46666667,11/29/2015,2015,12,21,25,home,8,BUF,255,286,58,58,30,22,Win,158,129,1,1,2,KCC,52,413,415,0
0.533333333,0.25,34.91666667,11/29/2015,2015,12,22,19,away,3,TEN,323,205,94,69,24,21,Win,84,44,1,2,2,OAK,45,407,249,2
0.25,0.533333333,25.08333333,11/29/2015,2015,12,19,22,home,-3,OAK,205,323,25,57,21,24,Loss,44,84,2,1,2,TEN,45,249,407,2
0.428571429,0.333333333,31.4,11/29/2015,2015,12,24,20,away,6,JAX,290,318,70,71,31,25,Win,79,102,2,2,1,LAC,56,369,420,0
0.333333333,0.428571429,28.6,11/29/2015,2015,12,20,24,home,-6,LAC,318,290,35,70,25,31,Loss,102,79,2,2,0,JAX,56,420,369,1
0.266666667,0.588235294,28.73333333,11/29/2015,2015,12,20,24,away,-18,NYJ,321,274,45,70,20,38,Loss,12,137,3,1,0,MIA,58,333,411,2
0.588235294,0.266666667,31.26666667,11/29/2015,2015,12,24,20,home,18,MIA,274,321,40,72,38,20,Win,137,12,1,3,2,NYJ,58,411,333,0
0.5,0,37.45,11/29/2015,2015,12,26,17,away,6,SFO,267,301,47,70,19,13,Win,70,67,1,2,2,ARI,32,337,368,0
0,0.5,22.55,11/29/2015,2015,12,17,26,home,-6,ARI,301,267,81,55,13,19,Loss,67,70,2,1,0,SFO,32,368,337,2
0.454545455,0.538461538,32,11/29/2015,2015,12,26,21,away,-9,SEA,480,336,65,75,30,39,Loss,58,100,2,2,0,PIT,69,538,436,4
0.538461538,0.454545455,28,11/29/2015,2015,12,21,26,home,9,PIT,336,480,76,59,39,30,Win,100,58,2,2,4,SEA,69,436,538,0
0.153846154,0.25,25.95,11/29/2015,2015,12,16,23,away,-6,DEN,262,254,47,61,0,6,Loss,39,179,3,3,1,NEP,6,301,433,1
0.25,0.153846154,36.51666667,11/29/2015,2015,12,23,16,home,6,NEP,254,262,46,77,6,0,Win,179,39,3,3,1,DEN,6,433,301,1
0.181818182,0.266666667,29.5,11/30/2015,2015,12,16,21,away,6,CLE,232,275,50,57,33,27,Win,104,63,0,2,0,BAL,60,336,338,2
0.266666667,0.181818182,30.5,11/30/2015,2015,12,21,16,home,-6,BAL,275,232,15,68,27,33,Loss,63,104,2,0,2,CLE,60,338,336,0
0.25,0.375,26.93333333,12/3/2015,2015,13,19,17,away,4,DET,246,205,55,63,27,23,Win,67,101,3,3,1,GBP,50,313,306,1
0.375,0.25,33.06666667,12/3/2015,2015,13,17,19,home,-4,GBP,205,246,108,63,23,27,Loss,101,67,3,3,1,DET,50,306,313,1
0.4,0.266666667,38.51666667,12/6/2015,2015,13,28,14,away,3,NYG,373,281,61,77,3,0,Win,90,74,3,3,1,NYJ,3,463,355,1
0.266666667,0.4,29.93333333,12/6/2015,2015,13,14,28,home,-3,NYJ,281,373,60,61,0,3,Loss,74,90,3,3,1,NYG,3,355,463,1
0.4375,0.083333333,39.78333333,12/6/2015,2015,13,29,9,away,24,LAR,349,146,25,79,27,3,Win,175,66,2,0,1,ARI,30,524,212,0
0.083333333,0.4375,20.21666667,12/6/2015,2015,13,9,29,home,-24,ARI,146,349,104,50,3,27,Loss,66,175,0,2,0,LAR,30,212,524,1
0.5,0.545454545,28.75,12/6/2015,2015,13,21,25,away,-4,TBB,255,222,58,66,19,23,Loss,64,166,3,1,2,ATL,42,319,388,1
0.545454545,0.5,31.25,12/6/2015,2015,13,25,21,home,4,ATL,222,255,53,65,23,19,Win,166,64,1,3,1,TBB,42,388,319,2
0.692307692,0.2,35.16666667,12/6/2015,2015,13,25,9,away,31,MIN,260,94,65,66,38,7,Win,173,31,2,4,1,SEA,45,433,125,1
0.2,0.692307692,24.83333333,12/6/2015,2015,13,9,25,home,-31,SEA,94,260,95,48,7,38,Loss,31,173,4,2,1,MIN,45,125,433,1
0.466666667,0.5,31.88333333,12/6/2015,2015,13,21,15,away,-9,BUF,275,203,89,71,21,30,Loss,126,187,2,1,0,HOU,51,401,390,1
0.5,0.466666667,28.11666667,12/6/2015,2015,13,15,21,home,9,HOU,203,275,42,58,30,21,Win,187,126,1,2,1,BUF,51,390,401,0
0.357142857,0.307692308,38.15,12/6/2015,2015,13,22,8,away,-2,MIA,281,82,36,75,13,15,Loss,94,137,3,1,1,BAL,28,375,219,2
0.307692308,0.357142857,21.85,12/6/2015,2015,13,8,22,home,2,BAL,82,281,31,46,15,13,Win,137,94,1,3,2,MIA,28,219,375,1
0.416666667,0.461538462,30.96666667,12/6/2015,2015,13,20,18,away,34,CLE,233,205,55,56,37,3,Win,144,68,1,3,2,CIN,40,377,273,0
0.461538462,0.416666667,29.03333333,12/6/2015,2015,13,18,20,home,-34,CIN,205,233,84,60,3,37,Loss,68,144,3,1,0,CLE,40,273,377,2
0.714285714,0.615384615,26.43333333,12/6/2015,2015,13,20,26,away,-3,TEN,302,257,21,59,39,42,Loss,81,210,2,4,2,JAX,81,383,467,1
0.615384615,0.714285714,33.56666667,12/6/2015,2015,13,26,20,home,3,JAX,257,302,38,68,42,39,Win,210,81,4,2,1,TEN,81,467,383,2
0.4375,0.470588235,24.76666667,12/6/2015,2015,13,13,20,away,6,CHI,170,194,50,59,6,0,Win,121,170,4,1,1,SFO,6,291,364,0
0.470588235,0.4375,37.4,12/6/2015,2015,13,20,13,home,-6,SFO,194,170,72,74,0,6,Loss,170,121,1,4,0,CHI,6,364,291,1
0.461538462,0.357142857,32.95,12/6/2015,2015,13,19,15,away,14,LAC,159,179,18,66,17,3,Win,134,93,1,4,3,DEN,20,293,272,1
0.357142857,0.461538462,27.05,12/6/2015,2015,13,15,19,home,-14,DEN,179,159,72,62,3,17,Loss,93,134,4,1,1,LAC,20,272,293,3
0.375,0.428571429,25.53333333,12/6/2015,2015,13,15,27,away,14,OAK,143,262,88,48,34,20,Win,89,99,4,4,3,KCC,54,232,361,2
0.428571429,0.375,34.46666667,12/6/2015,2015,13,27,15,home,-14,KCC,262,143,21,76,20,34,Loss,99,89,4,4,2,OAK,54,361,232,3
0.375,0.3,36.56666667,12/6/2015,2015,13,33,21,away,3,NOS,322,264,87,76,41,38,Win,175,70,1,2,1,CAR,79,497,334,3
0.3,0.375,23.43333333,12/6/2015,2015,13,21,33,home,-3,CAR,264,322,104,58,38,41,Loss,70,175,2,1,3,NOS,79,334,497,1
0.428571429,0.411764706,25.73333333,12/6/2015,2015,13,15,27,away,7,NEP,120,324,97,58,35,28,Win,128,103,1,4,2,PHI,63,248,427,1
0.411764706,0.428571429,34.26666667,12/6/2015,2015,13,27,15,home,-7,PHI,324,120,30,86,28,35,Loss,103,128,4,1,1,NEP,63,427,248,2
0.214285714,0.615384615,27.16666667,12/6/2015,2015,13,11,24,away,-35,PIT,186,364,30,57,10,45,Loss,54,158,5,0,2,IND,55,240,522,3
0.615384615,0.214285714,32.83333333,12/6/2015,2015,13,24,11,home,35,IND,364,186,48,71,45,10,Win,158,54,0,5,3,PIT,55,522,240,2
0.111111111,0.375,27.21666667,12/7/2015,2015,13,16,15,away,3,WAS,221,193,70,54,19,16,Win,97,73,1,3,1,DAL,35,318,266,3
0.375,0.111111111,32.78333333,12/7/2015,2015,13,15,16,home,-3,DAL,193,221,72,60,16,19,Loss,73,97,3,1,3,WAS,35,266,318,1
0.545454545,0.461538462,28.01666667,12/10/2015,2015,14,23,22,away,-3,ARI,317,296,25,63,20,23,Loss,72,97,3,2,0,MIN,43,389,393,3
0.461538462,0.545454545,31.98333333,12/10/2015,2015,14,22,23,home,3,MIN,296,317,30,66,23,20,Win,97,72,2,3,3,ARI,43,393,389,0
0.375,0.5,35.03333333,12/13/2015,2015,14,18,20,away,-3,PHI,260,232,101,69,20,23,Loss,152,116,1,1,1,BUF,43,412,348,2
0.5,0.375,24.96666667,12/13/2015,2015,14,20,18,home,3,BUF,232,260,55,73,23,20,Win,116,152,1,1,2,PHI,43,348,412,1
0.153846154,0.5,22.35,12/13/2015,2015,14,15,28,away,-14,CLE,150,251,40,54,10,24,Loss,71,230,9,2,2,SFO,34,221,481,0
0.5,0.153846154,37.65,12/13/2015,2015,14,28,15,home,14,SFO,251,150,71,74,24,10,Win,230,71,2,9,0,CLE,34,481,221,2
0.384615385,0.363636364,33.83333333,12/13/2015,2015,14,22,15,away,-7,LAR,220,114,45,70,14,21,Loss,111,203,4,1,1,DET,35,331,317,1
0.363636364,0.384615385,26.16666667,12/13/2015,2015,14,15,22,home,7,DET,114,220,48,52,21,14,Win,203,111,1,4,1,LAR,35,317,331,1
0.705882353,0.363636364,37.23333333,12/13/2015,2015,14,26,18,away,7,TBB,301,176,95,78,24,17,Win,87,115,2,1,0,NOS,41,388,291,0
0.363636364,0.705882353,22.76666667,12/13/2015,2015,14,18,26,home,-7,NOS,176,301,80,52,17,24,Loss,115,87,1,2,0,TBB,41,291,388,0
0.214285714,0.466666667,24.06666667,12/13/2015,2015,14,15,24,away,-22,NYJ,268,256,20,58,8,30,Loss,24,183,5,1,0,TEN,38,292,439,1
0.466666667,0.214285714,35.93333333,12/13/2015,2015,14,24,15,home,22,TEN,256,268,20,71,30,8,Win,183,24,1,5,1,NYJ,38,439,292,0
0.571428571,0.375,35.78333333,12/13/2015,2015,14,22,22,away,13,CIN,270,321,82,69,33,20,Win,84,64,2,3,3,PIT,53,354,385,1
0.375,0.571428571,24.21666667,12/13/2015,2015,14,22,22,home,-13,PIT,321,270,27,56,20,33,Loss,64,84,3,2,1,CIN,53,385,354,3
0.25,0.222222222,30.8,12/13/2015,2015,14,17,24,away,-35,JAX,227,226,85,69,16,51,Loss,95,154,3,3,2,IND,67,322,380,2
0.222222222,0.25,29.2,12/13/2015,2015,14,24,17,home,35,IND,226,227,40,62,51,16,Win,154,95,3,3,2,JAX,67,380,322,2
0.333333333,0.545454545,31.13333333,12/13/2015,2015,14,15,18,away,-7,KCC,236,179,48,66,3,10,Loss,44,150,5,2,2,LAC,13,280,329,1
0.545454545,0.333333333,28.86666667,12/13/2015,2015,14,18,15,home,7,LAC,179,236,53,50,10,3,Win,150,44,2,5,1,KCC,13,329,280,2
0.583333333,0.454545455,34.36666667,12/13/2015,2015,14,24,20,away,3,CHI,275,290,63,67,24,21,Win,99,87,3,3,1,WAS,45,374,377,1
0.454545455,0.583333333,25.63333333,12/13/2015,2015,14,20,24,home,-3,WAS,290,275,79,56,21,24,Loss,87,99,3,3,1,CHI,45,377,374,1
0.285714286,0.5,28.5,12/13/2015,2015,14,15,20,away,-38,CAR,176,282,54,62,0,38,Loss,54,142,5,2,0,ATL,38,230,424,4
0.5,0.285714286,31.5,12/13/2015,2015,14,20,15,home,38,ATL,282,176,60,61,38,0,Win,142,54,2,5,4,CAR,38,424,230,0
0.666666667,0.272727273,35.71666667,12/13/2015,2015,14,28,16,away,29,BAL,301,274,42,69,35,6,Win,123,28,0,1,2,SEA,41,424,302,1
0.272727273,0.666666667,24.28333333,12/13/2015,2015,14,16,28,home,-29,SEA,274,301,94,55,6,35,Loss,28,123,1,0,1,BAL,41,302,424,2
0.2,0.222222222,24.03333333,12/13/2015,2015,14,8,20,away,3,DEN,99,276,70,55,15,12,Win,27,34,3,5,2,OAK,27,126,310,0
0.222222222,0.2,35.96666667,12/13/2015,2015,14,20,8,home,-3,OAK,276,99,27,77,12,15,Loss,34,27,5,3,0,DEN,27,310,126,2
0.090909091,0.5,22.2,12/13/2015,2015,14,11,29,away,-21,GBP,99,205,30,51,7,28,Loss,171,230,2,2,0,DAL,35,270,435,1
0.5,0.090909091,37.8,12/13/2015,2015,14,29,11,home,21,DAL,205,99,69,81,28,7,Win,230,171,2,2,1,GBP,35,435,270,0
0.4375,0.214285714,35.23333333,12/13/2015,2015,14,18,7,away,21,HOU,197,102,46,64,27,6,Win,116,87,3,6,1,NEP,33,313,189,1
0.214285714,0.4375,24.76666667,12/13/2015,2015,14,7,18,home,-21,NEP,102,197,36,52,6,27,Loss,87,116,6,3,1,HOU,33,189,313,1
0.454545455,0.4375,30.51666667,12/14/2015,2015,14,25,16,away,7,MIA,337,235,25,62,31,24,Win,92,128,0,1,1,NYG,55,429,363,1
0.4375,0.454545455,29.48333333,12/14/2015,2015,14,16,25,home,-7,NYG,235,337,123,64,24,31,Loss,128,92,1,0,1,MIA,55,363,429,1
0.3,0.2,31.33333333,12/17/2015,2015,15,30,16,away,-8,LAR,363,221,56,77,23,31,Loss,146,98,0,2,0,TBB,54,509,319,2
0.2,0.3,28.66666667,12/17/2015,2015,15,16,30,home,8,TBB,221,363,35,52,31,23,Win,98,146,2,0,2,LAR,54,319,509,0
0.357142857,0.181818182,32.28333333,12/19/2015,2015,15,20,15,away,3,DAL,299,176,61,67,19,16,Win,73,133,2,2,4,NYJ,35,372,309,1
0.181818182,0.357142857,27.71666667,12/19/2015,2015,15,15,20,home,-3,NYJ,176,299,54,56,16,19,Loss,133,73,2,2,1,DAL,35,309,372,4
0.416666667,0.666666667,27.83333333,12/20/2015,2015,15,21,20,away,-21,MIN,199,221,39,62,17,38,Loss,94,129,5,1,0,CHI,55,293,350,2
0.666666667,0.416666667,32.16666667,12/20/2015,2015,15,20,21,home,21,CHI,221,199,45,57,38,17,Win,129,94,1,5,2,MIN,55,350,293,0
0.5,0,34.53333333,12/20/2015,2015,15,22,21,away,6,JAX,245,285,43,69,23,17,Win,83,85,1,2,1,ATL,40,328,370,1
0,0.5,25.46666667,12/20/2015,2015,15,21,22,home,-6,ATL,285,245,62,60,17,23,Loss,85,83,2,1,1,JAX,40,370,328,1
0.333333333,0.307692308,33.93333333,12/20/2015,2015,15,20,14,away,6,IND,150,140,48,68,16,10,Win,155,50,3,3,2,HOU,26,305,190,2
0.307692308,0.333333333,26.06666667,12/20/2015,2015,15,14,20,home,-6,HOU,140,150,94,54,10,16,Loss,50,155,3,3,2,IND,26,190,305,2
0.529411765,0.4,30.86666667,12/20/2015,2015,15,28,21,away,3,NYG,309,245,88,77,38,35,Win,171,161,3,0,2,CAR,73,480,406,1
0.4,0.529411765,29.13333333,12/20/2015,2015,15,21,28,home,-3,CAR,245,309,47,73,35,38,Loss,161,171,0,3,1,NYG,73,406,480,2
0.25,0.4375,30.38333333,12/20/2015,2015,15,15,17,away,-17,NEP,223,253,29,60,16,33,Loss,59,93,5,2,1,TEN,49,282,346,3
0.4375,0.25,29.61666667,12/20/2015,2015,15,17,15,home,17,TEN,253,223,35,63,33,16,Win,93,59,2,5,3,NEP,49,346,282,1
0.384615385,0.636363636,30.93333333,12/20/2015,2015,15,21,23,away,-10,WAS,212,308,56,63,25,35,Loss,240,123,5,1,1,BUF,60,452,431,0
0.636363636,0.384615385,29.06666667,12/20/2015,2015,15,23,21,home,10,BUF,308,212,6,56,35,25,Win,123,240,1,5,0,WAS,60,431,452,1
0.384615385,0.307692308,32.31666667,12/20/2015,2015,15,15,19,away,20,BAL,164,273,55,56,34,14,Win,113,93,3,2,3,KCC,48,277,366,0
0.307692308,0.384615385,27.68333333,12/20/2015,2015,15,19,15,home,-20,KCC,273,164,63,67,14,34,Loss,93,113,2,3,0,BAL,48,366,277,3
0.5,0.75,25.45,12/20/2015,2015,15,15,28,away,-17,SEA,136,241,40,52,13,30,Loss,94,182,3,2,0,CLE,43,230,423,1
0.75,0.5,34.55,12/20/2015,2015,15,28,15,home,17,CLE,241,136,30,68,30,13,Win,182,94,2,3,1,SEA,43,423,230,0
0.307692308,0.294117647,29.43333333,12/20/2015,2015,15,18,20,away,10,OAK,190,252,75,69,30,20,Win,103,120,2,3,2,GBP,50,293,372,2
0.294117647,0.307692308,30.56666667,12/20/2015,2015,15,20,18,home,-10,GBP,252,190,95,75,20,30,Loss,120,103,3,2,2,OAK,50,372,293,2
0.529411765,0.466666667,28.73333333,12/20/2015,2015,15,20,28,away,-7,PIT,281,354,127,71,27,34,Loss,104,23,2,3,2,DEN,61,385,377,2
0.466666667,0.529411765,31.26666667,12/20/2015,2015,15,28,20,home,7,DEN,354,281,63,75,34,27,Win,23,104,3,2,2,PIT,61,377,385,2
0.142857143,0.642857143,21.11666667,12/20/2015,2015,15,13,26,away,-16,LAC,187,302,72,56,14,30,Loss,44,140,3,1,2,MIA,44,231,442,1
0.642857143,0.142857143,38.88333333,12/20/2015,2015,15,26,13,home,16,MIA,302,187,48,73,30,14,Win,140,44,1,3,1,LAC,44,442,231,2
0.285714286,0.142857143,30.98333333,12/20/2015,2015,15,14,17,away,10,SFO,174,263,45,61,24,14,Win,68,55,4,4,4,CIN,38,242,318,1
0.142857143,0.285714286,29.01666667,12/20/2015,2015,15,17,14,home,-10,CIN,263,174,98,71,14,24,Loss,55,68,4,4,1,SFO,38,318,242,4
0.571428571,0.5,37.46666667,12/20/2015,2015,15,28,19,away,23,PHI,263,350,10,74,40,17,Win,230,74,2,2,4,ARI,57,493,424,0
0.5,0.571428571,22.53333333,12/20/2015,2015,15,19,28,home,-23,ARI,350,263,38,63,17,40,Loss,74,230,2,2,0,PHI,57,424,493,4
0.5,0.357142857,29.6,12/21/2015,2015,15,24,27,away,8,NOS,246,330,92,51,35,27,Win,150,69,3,1,0,DET,62,396,399,1
0.357142857,0.5,30.4,12/21/2015,2015,15,27,24,home,-8,DET,330,246,28,71,27,35,Loss,69,150,1,3,1,NOS,62,399,396,0
0.3125,0.266666667,35.06666667,12/24/2015,2015,16,19,14,away,-3,OAK,271,175,75,75,0,3,Loss,72,106,1,3,1,LAC,3,343,281,1
0.266666667,0.3125,33.35,12/24/2015,2015,16,14,19,home,3,LAC,175,271,121,65,3,0,Win,106,72,3,1,1,OAK,3,281,343,1
0.357142857,0.368421053,34.25,12/26/2015,2015,16,25,23,away,14,PHI,351,353,70,74,38,24,Win,67,45,2,5,2,WAS,62,418,398,0
0.368421053,0.357142857,25.75,12/26/2015,2015,16,23,25,home,-14,WAS,353,351,45,77,24,38,Loss,45,67,5,2,0,PHI,62,398,418,2
0.1,0.384615385,28.55,12/27/2015,2015,16,16,24,away,-6,NYJ,221,285,7,55,0,6,Loss,63,143,2,1,1,NEP,6,284,428,1
0.384615385,0.1,34.06666667,12/27/2015,2015,16,24,16,home,6,NEP,285,221,39,69,6,0,Win,143,63,1,2,1,NYJ,6,428,284,1
0.4375,0.25,36.21666667,12/27/2015,2015,16,19,13,away,28,TEN,202,227,28,69,34,6,Win,128,30,1,1,4,HOU,40,330,257,1
0.25,0.4375,23.78333333,12/27/2015,2015,16,13,19,home,-28,HOU,227,202,43,63,6,34,Loss,30,128,1,1,1,TEN,40,257,330,4
0.4,0.333333333,31.06666667,12/27/2015,2015,16,21,16,away,-4,KCC,136,122,83,68,13,17,Loss,232,136,0,1,1,CLE,30,368,258,1
0.333333333,0.4,28.93333333,12/27/2015,2015,16,16,21,home,4,CLE,122,136,33,50,17,13,Win,136,232,1,0,1,KCC,30,258,368,1
0.5,0.4,27.18333333,12/27/2015,2015,16,20,22,away,6,MIA,168,279,60,54,18,12,Win,100,82,2,6,1,IND,30,268,361,0
0.4,0.5,32.81666667,12/27/2015,2015,16,22,20,home,-6,IND,279,168,50,69,12,18,Loss,82,100,6,2,0,MIA,30,361,268,1
0.111111111,0.333333333,23.5,12/27/2015,2015,16,20,26,away,-15,DET,201,284,65,59,17,32,Loss,121,87,3,2,0,SFO,49,322,371,1
0.333333333,0.111111111,36.5,12/27/2015,2015,16,26,20,home,15,SFO,284,201,71,67,32,17,Win,87,121,2,3,1,DET,49,371,322,0
0.5,0.428571429,28.5,12/27/2015,2015,16,14,19,away,-10,BUF,186,172,65,56,6,16,Loss,121,236,0,3,2,DAL,22,307,408,2
0.428571429,0.5,31.5,12/27/2015,2015,16,19,14,home,10,DAL,172,186,62,61,16,6,Win,236,121,3,0,2,BUF,22,408,307,2
0.4,0.25,37.05,12/27/2015,2015,16,21,19,away,5,TBB,153,285,25,67,26,21,Win,174,104,1,1,3,CHI,47,327,389,0
0.25,0.4,22.95,12/27/2015,2015,16,19,21,home,-5,CHI,285,153,47,55,21,26,Loss,104,174,1,1,0,TBB,47,389,327,3
0.4,0.6,24.36666667,12/27/2015,2015,16,18,21,away,-7,ATL,113,296,40,52,13,20,Loss,155,77,2,2,1,CAR,33,268,373,1
0.6,0.4,35.63333333,12/27/2015,2015,16,21,18,home,7,CAR,296,113,20,62,20,13,Win,77,155,2,2,1,ATL,33,373,268,1
0.25,0.5,25.66666667,12/27/2015,2015,16,21,22,away,-3,BAL,198,265,25,57,17,20,Loss,110,121,3,1,0,PIT,37,308,386,3
0.5,0.25,34.33333333,12/27/2015,2015,16,22,21,home,3,PIT,265,198,121,73,20,17,Win,121,110,1,3,3,BAL,37,386,308,0
0.666666667,0.615384615,22.11666667,12/27/2015,2015,16,21,29,away,-11,NOS,347,402,55,52,27,38,Loss,65,135,2,1,0,JAX,65,412,537,2
0.615384615,0.666666667,37.88333333,12/27/2015,2015,16,29,21,home,11,JAX,402,347,40,72,38,27,Win,135,65,1,2,2,NOS,65,537,412,0
0.416666667,0.470588235,27.9,12/27/2015,2015,16,14,18,away,6,SEA,103,253,60,53,23,17,Win,102,59,0,4,3,LAR,40,205,312,0
0.470588235,0.416666667,32.1,12/27/2015,2015,16,18,14,home,-6,LAR,253,103,83,67,17,23,Loss,59,102,4,0,0,SEA,40,312,205,3
0.294117647,0.5,29.73333333,12/27/2015,2015,16,16,19,away,-30,ARI,77,260,59,64,8,38,Loss,101,121,9,2,2,GBP,46,178,381,4
0.5,0.294117647,30.26666667,12/27/2015,2015,16,19,16,home,30,GBP,260,77,119,56,38,8,Win,121,101,2,9,4,ARI,46,381,178,2
0.090909091,0.375,25.05,12/27/2015,2015,16,15,17,away,-32,MIN,272,150,48,58,17,49,Loss,91,218,4,3,0,NYG,66,363,368,3
0.375,0.090909091,34.95,12/27/2015,2015,16,17,15,home,32,NYG,150,272,10,68,49,17,Win,218,91,3,4,3,MIN,66,368,363,0
0.588235294,0.363636364,37.46666667,12/28/2015,2015,16,22,22,away,-3,DEN,186,277,45,70,0,3,Loss,108,113,2,3,1,CIN,3,294,390,1
0.363636364,0.588235294,27.83333333,12/28/2015,2015,16,22,22,home,3,CIN,277,186,40,63,3,0,Win,113,108,3,2,1,DEN,3,390,294,1
0.272727273,0.45,20.78333333,1/3/2016,2015,17,15,18,away,-5,BUF,178,182,41,55,17,22,Loss,122,113,1,2,1,NYJ,39,300,295,3
0.45,0.272727273,39.21666667,1/3/2016,2015,17,18,15,home,5,NYJ,182,178,45,73,22,17,Win,113,122,2,1,3,BUF,39,295,300,1
0.285714286,0.470588235,28.91666667,1/3/2016,2015,17,12,20,away,-10,MIA,126,342,41,54,10,20,Loss,70,96,2,1,0,NEP,30,196,438,0
0.470588235,0.285714286,31.08333333,1/3/2016,2015,17,20,12,home,10,NEP,342,126,93,73,20,10,Win,96,70,1,2,0,MIA,30,438,196,0
0.6,0.666666667,29.56666667,1/3/2016,2015,17,24,25,away,3,ATL,323,327,45,65,20,17,Win,67,87,0,1,2,NOS,37,390,414,1
0.666666667,0.6,30.43333333,1/3/2016,2015,17,25,24,home,-3,NOS,327,323,32,63,17,20,Loss,87,67,1,0,1,ATL,37,414,390,2
0.6,0,29.21666667,1/3/2016,2015,17,22,17,away,-8,CIN,282,147,38,78,16,24,Loss,59,145,1,3,0,BAL,40,341,292,2
0,0.6,30.78333333,1/3/2016,2015,17,17,22,home,8,BAL,147,282,72,57,24,16,Win,145,59,3,1,2,CIN,40,292,341,0
0.25,0.25,26.05,1/3/2016,2015,17,16,22,away,16,CLE,349,177,45,55,28,12,Win,30,86,0,7,4,PIT,40,379,263,3
0.25,0.25,33.95,1/3/2016,2015,17,22,16,home,-16,PIT,177,349,47,76,12,28,Loss,86,30,7,0,3,CLE,40,263,379,4
0.083333333,0.470588235,24.38333333,1/3/2016,2015,17,11,25,away,-24,HOU,183,242,53,54,6,30,Loss,32,160,8,2,1,JAX,36,215,402,4
0.470588235,0.083333333,35.61666667,1/3/2016,2015,17,25,11,home,24,JAX,242,183,55,74,30,6,Win,160,32,2,8,4,HOU,36,402,215,1
0.285714286,0.411764706,26.71666667,1/3/2016,2015,17,14,20,away,-6,IND,94,200,60,58,24,30,Loss,137,127,4,1,1,TEN,54,231,327,1
0.411764706,0.285714286,33.28333333,1/3/2016,2015,17,20,14,home,6,TEN,200,94,71,71,30,24,Win,127,137,1,4,1,IND,54,327,231,1
0.5,0.2,33.96666667,1/3/2016,2015,17,19,27,away,11,DAL,291,412,20,63,34,23,Win,146,100,1,4,4,WAS,57,437,512,0
0.2,0.5,26.03333333,1/3/2016,2015,17,27,19,home,-11,WAS,412,291,44,68,23,34,Loss,100,146,4,1,0,DAL,57,512,437,4
0.769230769,0.466666667,28.1,1/3/2016,2015,17,23,30,away,5,NYG,315,294,11,65,35,30,Win,120,208,1,2,1,PHI,65,435,502,2
0.466666667,0.769230769,31.9,1/3/2016,2015,17,30,23,home,-5,PHI,294,315,10,81,30,35,Loss,208,120,2,1,2,NYG,65,502,435,1
0.4,0.583333333,32.5,1/3/2016,2015,17,22,16,away,4,CHI,282,231,21,64,24,20,Win,67,111,4,5,3,DET,44,349,342,0
0.583333333,0.4,27.5,1/3/2016,2015,17,16,22,home,-4,DET,231,282,15,52,20,24,Loss,111,67,5,4,0,CHI,44,342,349,3
0.5,0.7,28.16666667,1/3/2016,2015,17,21,23,away,-28,CAR,309,255,65,71,10,38,Loss,77,111,2,4,2,TBB,48,386,366,3
0.7,0.5,31.83333333,1/3/2016,2015,17,23,21,home,28,TBB,255,309,33,62,38,10,Win,111,77,4,2,3,CAR,48,366,386,2
0.214285714,0.461538462,25.08333333,1/3/2016,2015,17,14,23,away,-6,KCC,157,150,59,55,17,23,Loss,48,189,6,1,2,OAK,40,205,339,1
0.461538462,0.214285714,34.91666667,1/3/2016,2015,17,23,14,home,6,OAK,150,157,55,65,23,17,Win,189,48,1,6,1,KCC,40,339,205,2
0.333333333,0.454545455,34.53333333,1/3/2016,2015,17,15,21,away,-7,DEN,207,293,45,67,20,27,Loss,110,210,3,2,5,LAC,47,317,503,1
0.454545455,0.333333333,25.46666667,1/3/2016,2015,17,21,15,home,7,LAC,293,207,35,65,27,20,Win,210,110,2,3,1,DEN,47,503,317,5
0.533333333,0.416666667,36.61666667,1/3/2016,2015,17,22,16,away,30,ARI,209,205,70,69,36,6,Win,145,27,1,2,3,SEA,42,354,232,0
0.416666667,0.533333333,23.38333333,1/3/2016,2015,17,16,22,home,-30,SEA,205,209,43,58,6,36,Loss,27,145,2,1,0,ARI,42,232,354,3
0.230769231,0.444444444,38.5,1/3/2016,2015,17,21,21,away,-3,SFO,231,350,105,71,0,3,Loss,133,108,0,1,1,LAR,3,364,458,0
0.444444444,0.230769231,33.05,1/3/2016,2015,17,21,21,home,3,LAR,350,231,60,78,3,0,Win,108,133,1,0,0,SFO,3,458,364,1
0.181818182,0.133333333,24.3,1/3/2016,2015,17,14,19,away,7,GBP,91,274,37,49,20,13,Win,151,76,3,5,2,MIN,33,242,350,2
0.133333333,0.181818182,35.7,1/3/2016,2015,17,19,14,home,-7,MIN,274,91,54,75,13,20,Loss,76,151,5,3,2,GBP,33,350,242,2
0.363636364,0.428571429,34.41666667,1/9/2016,2015,PF,18,14,away,30,HOU,173,112,52,62,30,0,Win,141,114,3,3,5,KCC,30,314,226,1
0.428571429,0.363636364,25.58333333,1/9/2016,2015,PF,14,18,home,-30,KCC,112,173,29,62,0,30,Loss,114,141,3,3,1,HOU,30,226,314,5
0.153846154,0.333333333,30.61666667,1/9/2016,2015,PF,21,19,away,2,CIN,202,188,142,69,18,16,Win,167,91,4,3,4,PIT,34,369,279,2
0.333333333,0.153846154,29.38333333,1/9/2016,2015,PF,19,21,home,-2,PIT,188,202,79,68,16,18,Loss,91,167,3,4,2,CIN,34,279,369,4
0.357142857,0.230769231,27.56666667,1/10/2016,2015,PF,13,14,away,1,MIN,129,125,65,56,10,9,Win,97,58,2,3,1,SEA,19,226,183,1
0.230769231,0.357142857,32.43333333,1/10/2016,2015,PF,14,13,home,-1,SEA,125,129,46,56,9,10,Loss,58,97,3,2,1,MIN,19,183,226,1
0.272727273,0.333333333,29.55,1/10/2016,2015,PF,24,20,away,17,WAS,205,270,23,69,35,18,Win,141,84,1,6,1,GBP,53,346,354,1
0.333333333,0.272727273,30.45,1/10/2016,2015,PF,20,24,home,-17,GBP,270,205,55,70,18,35,Loss,84,141,6,1,1,WAS,53,354,346,1
0.6,0.5,37.85,1/16/2016,2015,PF,27,21,away,-7,NEP,243,302,40,83,20,27,Loss,135,38,1,0,0,KCC,47,378,340,1
0.5,0.6,22.15,1/16/2016,2015,PF,21,27,home,7,KCC,302,243,24,56,27,20,Win,38,135,0,1,1,NEP,47,340,378,0
0.466666667,0.384615385,30.23333333,1/16/2016,2015,PF,18,20,away,-6,ARI,251,328,55,67,0,6,Loss,135,40,1,3,2,GBP,6,386,368,1
0.384615385,0.466666667,30.85,1/16/2016,2015,PF,20,18,home,6,GBP,328,251,26,63,6,0,Win,40,135,3,1,1,ARI,6,368,386,2
0.454545455,0.533333333,24.36666667,1/17/2016,2015,PF,23,19,away,-7,CAR,325,151,20,65,24,31,Loss,78,144,5,1,0,SEA,55,403,295,2
0.533333333,0.454545455,35.63333333,1/17/2016,2015,PF,19,23,home,7,SEA,151,325,25,64,31,24,Win,144,78,1,5,2,CAR,55,295,403,0
0.166666667,0.2,28.45,1/17/2016,2015,PF,16,19,away,-7,DEN,311,215,38,59,16,23,Loss,85,109,3,1,0,PIT,39,396,324,1
0.2,0.166666667,31.55,1/17/2016,2015,PF,19,16,home,7,PIT,215,311,49,71,23,16,Win,109,85,1,3,1,DEN,39,324,396,0
0.133333333,0.352941176,30.2,1/24/2016,2015,PF,20,12,away,-2,DEN,292,145,53,77,18,20,Loss,44,99,4,3,1,NEP,38,336,244,2
0.352941176,0.133333333,29.8,1/24/2016,2015,PF,12,20,home,2,NEP,145,292,51,65,20,18,Win,99,44,3,4,2,DEN,38,244,336,1
0.3,0.571428571,23.35,1/24/2016,2015,PF,21,21,away,-34,CAR,227,324,51,60,15,49,Loss,60,152,3,1,1,ARI,64,287,476,7
0.571428571,0.3,36.65,1/24/2016,2015,PF,21,21,home,34,ARI,324,227,45,66,49,15,Win,152,60,1,3,7,CAR,64,476,287,1
0.2,0.071428571,32.78333333,2/7/2016,2015,PF,21,11,away,-14,DEN,197,104,102,75,10,24,Loss,118,90,7,5,2,CAR,34,315,194,4
0.071428571,0.2,27.21666667,2/7/2016,2015,PF,11,21,home,14,CAR,104,197,51,56,24,10,Win,90,118,5,7,4,DEN,34,194,315,2
0.6,0.5,32.31666667,9/8/2016,2016,1,21,21,away,-1,DEN,176,159,85,68,20,21,Loss,157,148,3,2,3,CAR,41,333,307,1
0.5,0.6,27.68333333,9/8/2016,2016,1,21,21,home,1,CAR,159,176,22,57,21,20,Win,148,157,2,3,1,DEN,41,307,333,3
0.333333333,0.230769231,27.61666667,9/11/2016,2016,1,20,19,away,7,ATL,281,322,48,60,31,24,Win,90,52,0,3,0,TBB,55,371,374,1
0.230769231,0.333333333,32.38333333,9/11/2016,2016,1,19,20,home,-7,TBB,322,281,74,64,24,31,Loss,52,90,3,0,1,ATL,55,374,371,0
0.428571429,0.571428571,29.58333333,9/11/2016,2016,1,15,19,away,9,TEN,236,252,39,61,25,16,Win,65,64,0,2,3,MIN,41,301,316,0
0.571428571,0.428571429,30.41666667,9/11/2016,2016,1,19,15,home,-9,MIN,252,236,10,65,16,25,Loss,64,65,2,0,0,TEN,41,316,301,3
0.2,0.333333333,20.66666667,9/11/2016,2016,1,14,23,away,-19,PHI,168,270,15,50,10,29,Loss,120,133,3,2,0,CLE,39,288,403,1
0.333333333,0.2,39.33333333,9/11/2016,2016,1,23,14,home,19,CLE,270,168,46,73,29,10,Win,133,120,2,3,1,PHI,39,403,288,0
0.272727273,0.333333333,25.11666667,9/11/2016,2016,1,18,22,away,1,NYJ,324,188,44,56,23,22,Win,57,152,7,1,1,CIN,45,381,340,1
0.333333333,0.272727273,34.88333333,9/11/2016,2016,1,22,18,home,-1,CIN,188,324,95,66,22,23,Loss,152,57,1,7,1,NYJ,45,340,381,1
0.363636364,0.363636364,30.41666667,9/11/2016,2016,1,25,27,away,1,NOS,319,419,141,64,35,34,Win,167,88,0,1,1,OAK,69,486,507,0
0.363636364,0.363636364,29.58333333,9/11/2016,2016,1,27,25,home,-1,OAK,419,319,53,65,34,35,Loss,88,167,1,0,0,NOS,69,507,486,1
0.466666667,0.357142857,34.01666667,9/11/2016,2016,1,25,26,away,-6,KCC,233,330,30,69,0,6,Loss,155,83,1,3,1,LAC,6,388,413,0
0.357142857,0.466666667,31.1,9/11/2016,2016,1,26,25,home,6,LAC,330,233,46,70,6,0,Win,83,155,3,1,0,KCC,6,413,388,1
0.230769231,0.4,27.11666667,9/11/2016,2016,1,11,18,away,-6,BAL,95,225,89,48,7,13,Loss,65,83,2,4,1,BUF,20,160,308,0
0.4,0.230769231,32.88333333,9/11/2016,2016,1,18,11,home,6,BUF,225,95,35,65,13,7,Win,83,65,4,2,0,BAL,20,308,160,1
0.307692308,0.6,23.68333333,9/11/2016,2016,1,14,17,away,-9,HOU,185,215,30,54,14,23,Loss,73,129,5,2,1,CHI,37,258,344,1
0.6,0.307692308,36.31666667,9/11/2016,2016,1,17,14,home,9,CHI,215,185,69,72,23,14,Win,129,73,2,5,1,HOU,37,344,258,1
0.5,0.266666667,28.61666667,9/11/2016,2016,1,18,20,away,4,JAX,199,300,24,60,27,23,Win,95,48,1,3,1,GBP,50,294,348,0
0.266666667,0.5,31.38333333,9/11/2016,2016,1,20,18,home,-4,GBP,300,199,79,68,23,27,Loss,48,95,3,1,0,JAX,50,348,294,1
0.214285714,0.3125,25.46666667,9/11/2016,2016,1,11,21,away,-2,SEA,150,240,40,54,10,12,Loss,64,112,5,3,2,MIA,22,214,352,0
0.3125,0.214285714,34.53333333,9/11/2016,2016,1,21,11,home,2,MIA,240,150,69,78,12,10,Win,112,64,3,5,0,SEA,22,352,214,2
0.5,0.588235294,23.28333333,9/11/2016,2016,1,18,24,away,1,DAL,203,227,40,54,20,19,Win,113,101,2,0,0,NYG,39,316,328,1
0.588235294,0.5,36.71666667,9/11/2016,2016,1,24,18,home,-1,NYG,227,203,50,75,19,20,Loss,101,113,0,2,1,DAL,39,328,316,0
0.555555556,0.5625,30.6,9/11/2016,2016,1,28,25,away,4,IND,332,368,70,64,39,35,Win,116,82,1,2,0,DET,74,448,450,0
0.5625,0.555555556,29.4,9/11/2016,2016,1,25,28,home,-4,DET,368,332,45,68,35,39,Loss,82,116,2,1,0,IND,74,450,448,0
0.625,0.5,33.98333333,9/11/2016,2016,1,19,21,away,2,ARI,257,252,69,66,23,21,Win,106,92,2,3,0,NEP,44,363,344,2
0.5,0.625,26.01666667,9/11/2016,2016,1,21,19,home,-2,NEP,252,257,58,59,21,23,Loss,92,106,3,2,2,ARI,44,344,363,0
0.642857143,0.3,33.3,9/12/2016,2016,1,23,18,away,22,WAS,290,329,81,68,38,16,Win,147,55,1,0,2,PIT,54,437,384,1
0.3,0.642857143,26.7,9/12/2016,2016,1,18,23,home,-22,PIT,329,290,55,55,16,38,Loss,55,147,0,1,1,WAS,54,384,437,2
0.2,0.470588235,27.83333333,9/12/2016,2016,1,10,28,away,-28,SFO,120,170,102,60,0,28,Loss,65,150,2,0,1,LAR,28,185,320,2
0.470588235,0.2,32.16666667,9/12/2016,2016,1,28,10,home,28,LAR,170,120,10,77,28,0,Win,150,65,0,2,2,SFO,28,320,185,1
0.615384615,0.3,39.2,9/15/2016,2016,2,28,16,away,6,BUF,370,307,50,71,37,31,Win,123,86,1,0,1,NYJ,68,493,393,1
0.3,0.615384615,20.8,9/15/2016,2016,2,16,28,home,-6,NYJ,307,370,59,50,31,37,Loss,86,123,0,1,1,BUF,68,393,493,1
0.285714286,0.466666667,24.1,9/18/2016,2016,2,16,26,away,-19,CAR,237,353,50,64,27,46,Loss,65,176,2,1,4,SFO,73,302,529,3
0.466666667,0.285714286,35.9,9/18/2016,2016,2,26,16,home,19,SFO,353,237,65,78,46,27,Win,176,65,1,2,3,CAR,73,529,302,4
0.5,0.416666667,32.85,9/18/2016,2016,2,24,24,away,4,WAS,278,350,39,64,27,23,Win,102,82,4,2,1,DAL,50,380,432,1
0.416666667,0.5,27.15,9/18/2016,2016,2,24,24,home,-4,DAL,350,278,51,65,23,27,Loss,82,102,2,4,1,WAS,50,432,380,1
0.25,0.411764706,27.08333333,9/18/2016,2016,2,21,19,away,-8,PIT,366,250,31,73,16,24,Loss,46,124,1,1,2,CIN,40,412,374,2
0.411764706,0.25,32.91666667,9/18/2016,2016,2,19,21,home,8,CIN,250,366,54,74,24,16,Win,124,46,1,1,2,PIT,40,374,412,2
0.230769231,0.466666667,25.88333333,9/18/2016,2016,2,16,22,away,-3,NYG,247,353,76,59,13,16,Loss,41,64,2,2,3,NOS,29,288,417,0
0.466666667,0.230769231,34.11666667,9/18/2016,2016,2,22,16,home,3,NOS,353,247,25,75,16,13,Win,64,41,2,2,0,NYG,29,417,288,3
0.5,0.5,23.23333333,9/18/2016,2016,2,23,29,away,-7,NEP,387,302,49,61,24,31,Loss,70,161,0,2,1,MIA,55,457,463,4
0.5,0.5,36.76666667,9/18/2016,2016,2,29,23,home,7,MIA,302,387,65,75,31,24,Win,161,70,2,0,4,NEP,55,463,457,1
0.214285714,0.266666667,26.01666667,9/18/2016,2016,2,14,15,away,-7,HOU,172,254,77,60,12,19,Loss,119,97,4,2,2,KCC,31,291,351,3
0.266666667,0.214285714,33.98333333,9/18/2016,2016,2,15,14,home,7,KCC,254,172,44,69,19,12,Win,97,119,2,4,3,HOU,31,351,291,2
0.416666667,0.4375,30.85,9/18/2016,2016,2,22,22,away,1,DET,224,238,83,60,16,15,Win,139,137,3,4,1,TEN,31,363,375,1
0.4375,0.416666667,29.15,9/18/2016,2016,2,22,22,home,-1,TEN,238,224,138,67,15,16,Loss,137,139,4,3,1,DET,31,375,363,1
0.625,0.533333333,30.98333333,9/18/2016,2016,2,22,17,away,5,CLE,302,242,29,71,25,20,Win,80,145,0,3,2,BAL,45,382,387,2
0.533333333,0.625,29.01666667,9/18/2016,2016,2,17,22,home,-5,BAL,242,302,59,59,20,25,Loss,145,80,3,0,2,CLE,45,387,382,2
0.307692308,0.25,30.05,9/18/2016,2016,2,17,17,away,-6,LAR,239,219,114,61,3,9,Loss,67,64,2,3,0,SEA,12,306,283,1
0.25,0.307692308,29.95,9/18/2016,2016,2,17,17,home,6,SEA,219,239,78,58,9,3,Win,64,67,3,2,1,LAR,12,283,306,0
0.384615385,0.428571429,30.95,9/18/2016,2016,2,21,20,away,-33,ARI,221,311,39,76,7,40,Loss,85,105,3,1,0,TBB,47,306,416,5
0.428571429,0.384615385,29.05,9/18/2016,2016,2,20,21,home,33,TBB,311,221,30,65,40,7,Win,105,85,1,3,5,ARI,47,416,306,0
0.181818182,0.538461538,25.13333333,9/18/2016,2016,2,20,25,away,-24,LAC,319,207,93,63,14,38,Loss,69,150,2,3,1,JAX,52,388,357,3
0.538461538,0.181818182,34.86666667,9/18/2016,2016,2,25,20,home,24,JAX,207,319,23,63,38,14,Win,150,69,3,2,3,LAC,52,357,388,1
0.5,0.416666667,27.25,9/18/2016,2016,2,27,29,away,7,OAK,389,299,72,64,35,28,Win,139,155,1,1,0,ATL,63,528,454,1
0.416666667,0.5,32.75,9/18/2016,2016,2,29,27,home,-7,ATL,299,389,58,71,28,35,Loss,155,139,1,1,1,OAK,63,454,528,0
0.428571429,0.454545455,29.31666667,9/18/2016,2016,2,19,24,away,-14,DEN,170,266,94,66,20,34,Loss,83,134,5,1,1,IND,54,253,400,2
0.454545455,0.428571429,30.68333333,9/18/2016,2016,2,24,19,home,14,IND,266,170,54,65,34,20,Win,134,83,1,5,2,DEN,54,400,253,1
0.461538462,0.285714286,29.7,9/18/2016,2016,2,20,15,away,-3,MIN,180,254,72,64,14,17,Loss,83,30,5,4,1,GBP,31,263,284,3
0.285714286,0.461538462,30.3,9/18/2016,2016,2,15,20,home,3,GBP,254,180,137,57,17,14,Win,30,83,4,5,3,MIN,31,284,263,1
0.2,0.4,36.08333333,9/19/2016,2016,2,21,16,away,15,CHI,180,220,34,68,29,14,Win,100,64,2,3,3,PHI,43,280,284,0
0.4,0.2,23.91666667,9/19/2016,2016,2,16,21,home,-15,PHI,220,180,60,50,14,29,Loss,64,100,3,2,0,CHI,43,284,280,3
0.4,0.285714286,31.36666667,9/22/2016,2016,3,19,15,away,-27,NEP,175,97,43,70,0,27,Loss,109,185,2,1,0,HOU,27,284,282,3
0.285714286,0.4,28.63333333,9/22/2016,2016,3,15,19,home,27,HOU,97,175,15,59,27,0,Win,185,109,1,2,3,NEP,27,282,284,0
0.333333333,0.307692308,34,9/25/2016,2016,3,25,16,away,-15,BUF,260,89,50,77,18,33,Loss,88,208,5,4,1,ARI,51,348,297,5
0.307692308,0.333333333,26,9/25/2016,2016,3,16,25,home,15,ARI,89,260,75,61,33,18,Win,208,88,4,5,5,BUF,51,297,348,1
0.384615385,0.166666667,29.05,9/25/2016,2016,3,17,19,away,7,TEN,245,212,58,61,17,10,Win,123,181,1,1,3,OAK,27,368,393,1
0.166666667,0.384615385,30.95,9/25/2016,2016,3,19,17,home,-7,OAK,212,245,70,63,10,17,Loss,181,123,1,1,1,TEN,27,393,368,3
0.4375,0.444444444,33.43333333,9/25/2016,2016,3,20,28,away,2,NYG,313,337,70,68,29,27,Win,90,120,2,2,3,WAS,56,403,457,1
0.444444444,0.4375,26.56666667,9/25/2016,2016,3,28,20,home,-2,WAS,337,313,128,61,27,29,Loss,120,90,2,2,1,NYG,56,457,403,3
0.266666667,0.2,37.36666667,9/25/2016,2016,3,21,23,away,-6,MIA,261,311,91,74,0,6,Loss,169,115,4,1,3,CLE,6,430,426,1
0.2,0.266666667,29.2,9/25/2016,2016,3,23,21,home,6,CLE,311,261,67,65,6,0,Win,115,169,1,4,1,MIA,6,426,430,3
0.230769231,0.375,31.1,9/25/2016,2016,3,18,14,away,2,JAX,199,168,58,64,19,17,Win,84,48,2,4,3,BAL,36,283,216,3
0.375,0.230769231,28.9,9/25/2016,2016,3,14,18,home,-2,BAL,168,199,75,63,17,19,Loss,48,84,4,2,3,JAX,36,216,283,3
0.571428571,0.5,35.11666667,9/25/2016,2016,3,22,17,away,-7,GBP,368,201,86,67,27,34,Loss,50,123,3,2,0,DET,61,418,324,1
0.5,0.571428571,24.88333333,9/25/2016,2016,3,17,22,home,7,DET,201,368,45,50,34,27,Win,123,50,2,3,1,GBP,61,324,418,0
0.5,0.416666667,27.9,9/25/2016,2016,3,21,20,away,12,CIN,303,189,41,60,29,17,Win,52,143,2,4,2,DEN,46,355,332,1
0.416666667,0.5,32.1,9/25/2016,2016,3,20,21,home,-12,DEN,189,303,69,64,17,29,Loss,143,52,4,2,1,CIN,46,332,355,2
0.25,0.375,25.13333333,9/25/2016,2016,3,13,18,away,12,CAR,153,201,42,54,22,10,Win,58,105,2,8,3,MIN,32,211,306,0
0.375,0.25,34.86666667,9/25/2016,2016,3,18,13,home,-12,MIN,201,153,65,72,10,22,Loss,105,58,8,2,0,CAR,32,306,211,3
0.461538462,0.5,26.4,9/25/2016,2016,3,18,30,away,5,TBB,183,389,69,60,37,32,Win,137,83,1,2,2,LAR,69,320,472,2
0.5,0.461538462,33.6,9/25/2016,2016,3,30,18,home,-5,LAR,389,183,80,82,32,37,Loss,83,137,2,1,2,TBB,69,472,320,2
0.266666667,0.642857143,24.05,9/25/2016,2016,3,12,18,away,-19,SEA,119,291,35,56,18,37,Loss,135,127,0,2,2,SFO,55,254,418,1
0.642857143,0.266666667,35.95,9/25/2016,2016,3,18,12,home,19,SFO,291,119,50,65,37,18,Win,127,135,2,0,1,SEA,55,418,254,2
0.5,0.466666667,27.91666667,9/25/2016,2016,3,17,18,away,-21,KCC,188,221,15,66,3,24,Loss,117,72,0,2,1,NYJ,27,305,293,8
0.466666667,0.5,32.08333333,9/25/2016,2016,3,18,17,home,21,NYJ,221,188,59,62,24,3,Win,72,117,2,0,8,KCC,27,293,305,1
0.363636364,0.222222222,27.28333333,9/25/2016,2016,3,17,24,away,-4,IND,315,317,80,58,22,26,Loss,37,93,2,2,2,LAC,48,352,410,3
0.222222222,0.363636364,32.71666667,9/25/2016,2016,3,24,17,home,4,LAC,317,315,66,65,26,22,Win,93,37,2,2,3,IND,48,410,352,2
0.363636364,0.4,25.06666667,9/25/2016,2016,3,15,25,away,-31,PHI,222,301,77,58,3,34,Loss,29,125,4,0,0,PIT,37,251,426,2
0.4,0.363636364,34.93333333,9/25/2016,2016,3,25,15,home,31,PIT,301,222,99,61,34,3,Win,125,29,0,4,2,PHI,37,426,251,0
0.2,0.454545455,24.68333333,9/25/2016,2016,3,21,25,away,-14,DAL,312,248,45,64,17,31,Loss,78,199,1,0,1,CHI,48,390,447,2
0.454545455,0.2,35.31666667,9/25/2016,2016,3,25,21,home,14,CHI,248,312,45,65,31,17,Win,199,78,0,1,2,DAL,48,447,390,1
0.454545455,0.538461538,27.43333333,9/26/2016,2016,3,26,32,away,13,NOS,225,359,35,63,45,32,Win,217,115,2,2,2,ATL,77,442,474,0
0.538461538,0.454545455,32.56666667,9/26/2016,2016,3,32,26,home,-13,ATL,359,225,75,79,32,45,Loss,115,217,2,2,0,NOS,77,474,442,2
0.181818182,0.2,21.96666667,9/29/2016,2016,4,8,19,away,-15,CIN,160,285,68,43,7,22,Loss,62,77,5,1,0,MIA,29,222,362,2
0.2,0.181818182,38.03333333,9/29/2016,2016,4,19,8,home,15,MIA,285,160,40,69,22,7,Win,77,62,1,5,2,CIN,29,362,222,0
0.529411765,0.272727273,32.65,10/2/2016,2016,4,23,23,away,-3,JAX,190,195,78,73,27,30,Loss,94,136,6,3,0,IND,57,284,331,1
0.272727273,0.529411765,27.35,10/2/2016,2016,4,23,23,home,3,IND,195,190,145,65,30,27,Win,136,94,3,6,1,JAX,57,331,284,0
0.466666667,0.416666667,31.7,10/2/2016,2016,4,16,21,away,-7,HOU,196,244,93,62,20,27,Loss,124,115,1,1,2,TEN,47,320,359,1
0.416666667,0.466666667,28.3,10/2/2016,2016,4,21,16,home,7,TEN,244,196,59,62,27,20,Win,115,124,1,1,1,HOU,47,359,320,2
0.666666667,0.5,28.95,10/2/2016,2016,4,26,24,away,-11,WAS,217,156,101,69,20,31,Loss,163,145,1,3,1,CLE,51,380,301,3
0.5,0.666666667,31.05,10/2/2016,2016,4,24,26,home,11,CLE,156,217,75,56,31,20,Win,145,163,3,1,3,WAS,51,301,380,1
0.3,0.466666667,30.75,10/2/2016,2016,4,21,20,away,10,NYJ,288,247,71,60,27,17,Win,66,58,2,4,3,SEA,44,354,305,0
0.466666667,0.3,29.25,10/2/2016,2016,4,20,21,home,-10,SEA,247,288,60,65,17,27,Loss,58,66,4,2,0,NYJ,44,305,354,3
0.466666667,0.083333333,36.18333333,10/2/2016,2016,4,24,13,away,16,NEP,244,187,60,73,16,0,Win,134,90,2,3,1,BUF,16,378,277,0
0.083333333,0.466666667,23.81666667,10/2/2016,2016,4,13,24,home,-16,BUF,187,244,74,52,0,16,Loss,90,134,3,2,0,NEP,16,277,378,1
0.4375,0.615384615,26.18333333,10/2/2016,2016,4,20,25,away,-15,ATL,329,481,55,64,33,48,Loss,49,90,1,3,1,CAR,81,378,571,2
0.615384615,0.4375,33.81666667,10/2/2016,2016,4,25,20,home,15,CAR,481,329,77,65,48,33,Win,90,49,3,1,2,ATL,81,571,378,1
0.25,0.294117647,25.26666667,10/2/2016,2016,4,13,25,away,1,BAL,199,282,93,54,28,27,Win,62,130,0,2,1,OAK,55,261,412,1
0.294117647,0.25,34.73333333,10/2/2016,2016,4,25,13,home,-1,OAK,282,199,105,80,27,28,Loss,130,62,2,0,1,BAL,55,412,261,1
0.333333333,0.384615385,26.76666667,10/2/2016,2016,4,16,23,away,-3,CHI,197,294,76,56,14,17,Loss,66,114,2,2,0,DET,31,263,408,2
0.384615385,0.333333333,33.23333333,10/2/2016,2016,4,23,16,home,3,DET,294,197,55,67,17,14,Win,114,66,2,2,2,CHI,31,408,263,0
0.230769231,0.3125,31.4,10/2/2016,2016,4,22,15,away,20,TBB,218,143,88,67,27,7,Win,89,72,4,5,3,DEN,34,307,215,0
0.3125,0.230769231,28.6,10/2/2016,2016,4,15,22,home,-20,DEN,143,218,69,66,7,27,Loss,72,89,5,4,0,TBB,34,215,307,3
0.428571429,0.461538462,27.85,10/2/2016,2016,4,12,26,away,4,ARI,247,302,84,55,17,13,Win,41,118,2,3,5,LAR,30,288,420,1
0.461538462,0.428571429,32.15,10/2/2016,2016,4,26,12,home,-4,LAR,302,247,45,75,13,17,Loss,118,41,3,2,1,ARI,30,420,288,5
0.611111111,0.461538462,32.65,10/2/2016,2016,4,21,21,away,1,LAC,192,308,34,72,35,34,Win,83,38,2,3,3,NOS,69,275,346,2
0.461538462,0.611111111,27.35,10/2/2016,2016,4,21,21,home,-1,NOS,308,192,46,67,34,35,Loss,38,83,3,2,2,LAC,69,346,275,3
0.428571429,0.571428571,36.45,10/2/2016,2016,4,26,14,away,7,SFO,234,189,45,73,24,17,Win,194,106,2,1,1,DAL,41,428,295,0
0.571428571,0.428571429,23.55,10/2/2016,2016,4,14,26,home,-7,DAL,189,234,32,53,17,24,Loss,106,194,1,2,0,SFO,41,295,428,1
0.470588235,0.545454545,30.6,10/2/2016,2016,4,22,18,away,-29,PIT,270,287,40,72,14,43,Loss,87,149,4,2,0,KCC,57,357,436,2
0.545454545,0.470588235,29.4,10/2/2016,2016,4,18,22,home,29,KCC,287,270,68,55,43,14,Win,149,87,2,4,2,PIT,57,436,357,0
0.166666667,0.5,24.46666667,10/3/2016,2016,4,18,22,away,-14,MIN,261,262,69,63,10,24,Loss,78,104,0,0,0,NYG,34,339,366,2
0.5,0.166666667,35.53333333,10/3/2016,2016,4,22,18,home,14,NYG,262,261,37,69,24,10,Win,104,78,0,0,2,MIN,34,366,339,0
0.3125,0.285714286,31.73333333,10/6/2016,2016,5,17,25,away,12,SFO,116,135,50,66,33,21,Win,172,151,1,7,3,ARI,54,288,286,0
0.285714286,0.3125,28.26666667,10/6/2016,2016,5,25,17,home,-12,ARI,135,116,34,74,21,33,Loss,151,172,7,1,0,SFO,54,286,288,3
0.529411765,0.384615385,34.65,10/9/2016,2016,5,24,17,away,20,CLE,403,235,61,77,33,13,Win,98,27,1,2,1,NEP,46,501,262,0
0.384615385,0.529411765,25.35,10/9/2016,2016,5,17,24,home,-20,NEP,235,403,35,59,13,33,Loss,27,98,2,1,0,CLE,46,262,501,1
0.454545455,0.333333333,29.6,10/9/2016,2016,5,18,21,away,-1,DET,230,164,111,57,23,24,Loss,116,80,3,4,1,PHI,47,346,244,2
0.333333333,0.454545455,30.4,10/9/2016,2016,5,21,18,home,1,PHI,164,230,18,56,24,23,Win,80,116,4,3,2,DET,47,244,346,1
0.222222222,0.25,30.08333333,10/9/2016,2016,5,25,20,away,-6,IND,397,298,80,62,23,29,Loss,125,98,0,5,0,CHI,52,522,396,1
0.25,0.222222222,29.91666667,10/9/2016,2016,5,20,25,home,6,CHI,298,397,68,65,29,23,Win,98,125,5,0,1,IND,52,396,522,0
0.416666667,0.363636364,36.73333333,10/9/2016,2016,5,23,8,away,13,MIA,163,149,40,70,30,17,Win,235,51,0,6,2,TEN,47,398,200,0
0.363636364,0.416666667,23.26666667,10/9/2016,2016,5,8,23,home,-13,TEN,149,163,83,41,17,30,Loss,51,235,6,0,0,MIA,47,200,398,2
0.25,0.2,29.58333333,10/9/2016,2016,5,18,18,away,6,BAL,250,188,46,62,16,10,Win,60,118,1,3,1,WAS,26,310,306,2
0.2,0.25,30.41666667,10/9/2016,2016,5,18,18,home,-6,WAS,188,250,65,69,10,16,Loss,118,60,3,1,2,BAL,26,306,310,1
0.076923077,0.5,22.53333333,10/9/2016,2016,5,16,22,away,-18,MIN,155,255,15,60,13,31,Loss,59,96,4,2,0,HOU,44,214,351,1
0.5,0.076923077,37.46666667,10/9/2016,2016,5,22,16,home,18,HOU,255,155,97,69,31,13,Win,96,59,2,4,1,MIN,44,351,214,0
0.181818182,0.5,28.16666667,10/9/2016,2016,5,16,30,away,-18,PIT,244,375,18,58,13,31,Loss,72,61,3,1,1,NYJ,44,316,436,0
0.5,0.181818182,31.83333333,10/9/2016,2016,5,30,16,home,18,NYJ,375,244,10,72,31,13,Win,61,72,1,3,0,PIT,44,436,316,1
0.166666667,0.25,28.86666667,10/9/2016,2016,5,19,18,away,7,DEN,250,183,78,62,23,16,Win,122,84,2,6,1,ATL,39,372,267,1
0.25,0.166666667,31.13333333,10/9/2016,2016,5,18,19,home,-7,ATL,183,250,57,65,16,23,Loss,84,122,6,2,1,DEN,39,267,372,1
0.416666667,0.5,32.28333333,10/9/2016,2016,5,27,21,away,-14,DAL,249,222,49,64,14,28,Loss,96,180,4,1,1,CIN,42,345,402,0
0.5,0.416666667,27.71666667,10/9/2016,2016,5,21,27,home,14,CIN,222,249,45,54,28,14,Win,180,96,1,4,0,DAL,42,402,345,1
0.333333333,0.333333333,24.43333333,10/9/2016,2016,5,15,23,away,11,LAR,112,243,60,52,30,19,Win,193,102,2,4,3,BUF,49,305,345,0
0.333333333,0.333333333,35.56666667,10/9/2016,2016,5,23,15,home,-11,BUF,243,112,40,64,19,30,Loss,102,193,4,2,0,LAR,49,345,305,3
0.25,0.357142857,23.7,10/9/2016,2016,5,17,20,away,-3,OAK,351,300,38,51,31,34,Loss,72,89,2,3,1,LAC,65,423,389,4
0.357142857,0.25,36.3,10/9/2016,2016,5,20,17,home,3,LAC,300,351,36,68,34,31,Win,89,72,3,2,4,OAK,65,389,423,1
0.307692308,0.473684211,23.36666667,10/9/2016,2016,5,14,23,away,-7,GBP,178,259,51,54,16,23,Loss,43,147,4,0,2,NYG,39,221,406,1
0.473684211,0.307692308,36.63333333,10/9/2016,2016,5,23,14,home,7,NYG,259,178,57,77,23,16,Win,147,43,0,4,1,GBP,39,406,221,2
0.4,0.125,34.15,10/10/2016,2016,5,20,20,away,3,CAR,202,278,40,69,17,14,Win,113,136,2,0,4,TBB,31,315,414,0
0.125,0.4,25.85,10/10/2016,2016,5,20,20,home,-3,TBB,278,202,60,53,14,17,Loss,136,113,0,2,0,CAR,31,414,315,4
0.4,0.230769231,26.53333333,10/13/2016,2016,6,16,16,away,-8,LAC,220,166,103,68,13,21,Loss,84,99,2,2,2,DEN,34,304,265,2
0.230769231,0.4,33.46666667,10/13/2016,2016,6,16,16,home,8,DEN,166,220,20,60,21,13,Win,99,84,2,2,2,LAC,34,265,304,2
0.230769231,0.615384615,24.81666667,10/16/2016,2016,6,16,29,away,-29,BUF,167,179,52,60,16,45,Loss,133,313,3,3,2,SFO,61,300,492,1
0.615384615,0.230769231,35.18333333,10/16/2016,2016,6,29,16,home,29,SFO,179,167,71,74,45,16,Win,313,133,3,3,1,BUF,61,492,300,2
0.333333333,0.538461538,25.78333333,10/16/2016,2016,6,12,26,away,-7,WAS,145,263,114,48,20,27,Loss,94,230,5,0,1,PHI,47,239,493,0
0.538461538,0.333333333,34.21666667,10/16/2016,2016,6,26,12,home,7,PHI,263,145,75,67,27,20,Win,230,94,0,5,0,WAS,47,493,239,1
0.214285714,0.538461538,28.98333333,10/16/2016,2016,6,16,19,away,-2,TEN,301,270,69,63,26,28,Loss,40,137,6,2,1,CLE,54,341,407,0
0.538461538,0.214285714,31.01666667,10/16/2016,2016,6,19,16,home,2,CLE,270,301,96,57,28,26,Win,137,40,2,6,0,TEN,54,407,341,1
0.277777778,0.285714286,35.06666667,10/16/2016,2016,6,22,19,away,-4,NYG,293,397,111,76,23,27,Loss,98,38,2,1,3,BAL,50,391,435,0
0.285714286,0.277777778,24.93333333,10/16/2016,2016,6,19,22,home,4,BAL,397,293,119,64,27,23,Win,38,98,1,2,0,NYG,50,435,391,3
0.272727273,0.5,31.08333333,10/16/2016,2016,6,32,23,away,-3,NOS,303,460,51,76,38,41,Loss,103,63,2,1,1,CAR,79,406,523,2
0.5,0.272727273,28.91666667,10/16/2016,2016,6,23,32,home,3,CAR,460,303,126,71,41,38,Win,63,103,1,2,2,NOS,79,523,406,1
0.2,0.411764706,24.21666667,10/16/2016,2016,6,20,22,away,1,CHI,263,297,50,55,17,16,Win,54,92,2,1,0,JAX,33,317,389,2
0.411764706,0.2,35.78333333,10/16/2016,2016,6,22,20,home,-1,JAX,297,263,87,77,16,17,Loss,92,54,1,2,2,CHI,33,389,317,0
0.666666667,0.545454545,27.8,10/16/2016,2016,6,23,20,away,-3,DET,311,265,62,55,28,31,Loss,76,83,1,1,0,LAR,59,387,348,1
0.545454545,0.666666667,32.2,10/16/2016,2016,6,20,23,home,3,LAR,265,311,62,58,31,28,Win,83,76,1,1,1,DET,59,348,387,0
0.272727273,0.5,23.5,10/16/2016,2016,6,15,24,away,-15,MIA,169,252,65,53,15,30,Loss,128,222,2,0,0,PIT,45,297,474,2
0.5,0.272727273,36.5,10/16/2016,2016,6,24,15,home,15,PIT,252,169,95,68,30,15,Win,222,128,0,2,2,MIA,45,474,297,0
0.416666667,0.4,32.05,10/16/2016,2016,6,20,25,away,-18,NEP,237,358,46,65,17,35,Loss,120,79,2,3,0,CIN,52,357,437,0
0.4,0.416666667,27.95,10/16/2016,2016,6,25,20,home,18,CIN,358,237,55,61,35,17,Win,79,120,3,2,0,NEP,52,437,357,0
0.538461538,0.4,36.75,10/16/2016,2016,6,22,16,away,16,OAK,223,221,10,64,26,10,Win,183,64,1,2,2,KCC,36,406,285,0
0.4,0.538461538,23.25,10/16/2016,2016,6,16,22,home,-16,KCC,221,223,25,53,10,26,Loss,64,183,2,1,0,OAK,36,285,406,2
0.272727273,0.357142857,29.85,10/16/2016,2016,6,22,22,away,-2,SEA,310,261,66,64,24,26,Loss,52,72,4,1,0,ATL,50,362,333,2
0.357142857,0.272727273,30.15,10/16/2016,2016,6,22,22,home,2,ATL,261,310,30,65,26,24,Win,72,52,1,4,2,SEA,50,333,362,0
0.272727273,0.538461538,29.83333333,10/16/2016,2016,6,24,24,away,14,GBP,233,294,60,62,30,16,Win,191,78,2,1,4,DAL,46,424,372,2
0.538461538,0.272727273,30.16666667,10/16/2016,2016,6,24,24,home,-14,DAL,294,233,23,67,16,30,Loss,78,191,1,2,2,GBP,46,372,424,4
0.357142857,0.454545455,36.55,10/16/2016,2016,6,19,26,away,-3,HOU,231,256,42,67,0,3,Loss,161,158,3,1,1,IND,3,392,414,1
0.454545455,0.357142857,30.28333333,10/16/2016,2016,6,26,19,home,3,IND,256,231,59,68,3,0,Win,158,161,1,3,1,HOU,3,414,392,1
0.153846154,0.545454545,23.96666667,10/17/2016,2016,6,11,28,away,-25,ARI,197,225,83,52,3,28,Loss,33,171,1,0,0,NYJ,31,230,396,2
0.545454545,0.153846154,36.03333333,10/17/2016,2016,6,28,11,home,25,NYJ,225,197,64,70,28,3,Win,171,33,0,1,2,ARI,31,396,230,0
0.25,0.5625,20.4,10/20/2016,2016,7,13,32,away,-16,GBP,120,303,108,45,10,26,Loss,69,103,1,2,1,CHI,36,189,406,2
0.5625,0.25,39.6,10/20/2016,2016,7,32,13,home,16,CHI,303,120,56,81,26,10,Win,103,69,2,1,2,GBP,36,406,189,1
0.307692308,0.473684211,24.95,10/23/2016,2016,7,13,20,away,7,LAR,196,271,33,57,17,10,Win,36,74,0,3,4,NYG,27,232,345,1
0.473684211,0.307692308,35.05,10/23/2016,2016,7,20,13,home,-7,NYG,271,196,43,76,10,17,Loss,74,36,3,0,1,LAR,27,345,232,4
0.642857143,0.333333333,32.63333333,10/23/2016,2016,7,27,20,away,-6,KCC,359,214,75,71,21,27,Loss,104,112,1,0,0,NOS,48,463,326,2
0.333333333,0.642857143,27.36666667,10/23/2016,2016,7,20,27,home,6,NOS,214,359,30,52,27,21,Win,112,104,0,1,2,KCC,48,326,463,0
0.4,0.6,32.5,10/23/2016,2016,7,26,26,away,8,TEN,341,207,131,65,34,26,Win,81,124,2,3,1,IND,60,422,331,0
0.6,0.4,27.5,10/23/2016,2016,7,26,26,home,-8,IND,207,341,38,68,26,34,Loss,124,81,3,2,0,TEN,60,331,422,1
0.473684211,0.363636364,32.13333333,10/23/2016,2016,7,18,15,away,-11,PHI,189,138,56,74,10,21,Loss,93,101,6,0,4,MIN,31,282,239,4
0.363636364,0.473684211,27.86666667,10/23/2016,2016,7,15,18,home,11,MIN,138,189,53,54,21,10,Win,101,93,0,6,4,PHI,31,239,282,4
0.428571429,0.5,31.8,10/23/2016,2016,7,22,23,away,-14,CIN,172,288,35,63,17,31,Loss,180,271,2,3,1,CLE,48,352,559,2
0.5,0.428571429,28.2,10/23/2016,2016,7,23,22,home,14,CLE,288,172,30,61,31,17,Win,271,180,3,2,2,CIN,48,559,352,1
0.6,0.333333333,34.98333333,10/23/2016,2016,7,26,19,away,-3,DET,283,250,20,70,17,20,Loss,130,94,2,3,0,WAS,37,413,344,2
0.333333333,0.6,25.01666667,10/23/2016,2016,7,19,26,home,3,WAS,250,283,30,51,20,17,Win,94,130,3,2,2,DET,37,344,413,0
0.444444444,0.307692308,33.45,10/23/2016,2016,7,21,19,away,17,JAX,200,239,117,71,33,16,Win,144,105,0,1,3,OAK,49,344,344,0
0.307692308,0.444444444,26.55,10/23/2016,2016,7,19,21,home,-17,OAK,239,200,112,60,16,33,Loss,105,144,1,0,0,JAX,49,344,344,3
0.230769231,0.416666667,22.96666667,10/23/2016,2016,7,16,26,away,-3,MIA,200,198,45,54,25,28,Loss,67,256,4,1,0,BUF,53,267,454,0
0.416666667,0.230769231,37.03333333,10/23/2016,2016,7,26,16,home,3,BUF,198,200,116,67,28,25,Win,256,67,1,4,0,MIA,53,454,267,0
0.214285714,0.375,23.38333333,10/23/2016,2016,7,11,16,away,-8,NYJ,234,189,35,57,16,24,Loss,11,155,2,5,2,BAL,40,245,344,3
0.375,0.214285714,36.61666667,10/23/2016,2016,7,16,11,home,8,BAL,189,234,25,66,24,16,Win,155,11,5,2,3,NYJ,40,344,245,2
0.428571429,0.4,33.81666667,10/23/2016,2016,7,27,20,away,17,SFO,264,113,78,73,34,17,Win,249,160,2,4,3,TBB,51,513,273,1
0.4,0.428571429,26.18333333,10/23/2016,2016,7,20,27,home,-17,TBB,113,264,31,66,17,34,Loss,160,249,4,2,1,SFO,51,273,513,3
0.5625,0.5,35.48333333,10/23/2016,2016,7,26,21,away,3,ATL,348,256,14,75,3,0,Win,78,130,4,3,1,LAC,3,426,386,2
0.5,0.5625,30.5,10/23/2016,2016,7,21,26,home,-3,LAC,256,348,70,63,0,3,Loss,130,78,3,4,2,ATL,3,386,426,1
0.583333333,0.3125,27.51666667,10/23/2016,2016,7,21,17,away,11,PIT,222,281,40,55,27,16,Win,140,94,0,0,1,NEP,43,362,375,2
0.3125,0.583333333,32.48333333,10/23/2016,2016,7,17,21,home,-11,NEP,281,222,85,69,16,27,Loss,94,140,0,0,2,PIT,43,375,362,1
0.214285714,0.476190476,28.65,10/23/2016,2016,7,11,23,away,0,ARI,205,311,90,57,3,3,Tie,52,132,1,4,0,SEA,6,257,443,0
0.476190476,0.214285714,46.35,10/23/2016,2016,7,23,11,home,0,SEA,311,205,45,90,3,3,Tie,132,52,4,1,0,ARI,6,443,257,0
0.388888889,0.272727273,29.36666667,10/24/2016,2016,7,14,19,away,-18,DEN,131,157,15,67,9,27,Loss,140,190,1,0,0,HOU,36,271,347,2
0.272727273,0.388888889,30.63333333,10/24/2016,2016,7,19,14,home,18,HOU,157,131,83,60,27,9,Win,190,140,0,1,2,DEN,36,347,271,0
0.461538462,0.6,25.58333333,10/27/2016,2016,8,27,25,away,-14,TEN,322,280,75,67,22,36,Loss,48,214,2,0,0,JAX,58,370,494,1
0.6,0.461538462,34.41666667,10/27/2016,2016,8,25,27,home,14,JAX,280,322,54,66,36,22,Win,214,48,0,2,1,TEN,58,494,370,0
0.470588235,0.533333333,39.7,10/30/2016,2016,8,30,35,away,0,CIN,446,263,106,88,0,0,Tie,100,152,1,3,2,WAS,0,546,415,1
0.533333333,0.470588235,35.3,10/30/2016,2016,8,35,30,home,0,WAS,263,446,85,81,0,0,Tie,152,100,3,1,1,CIN,0,415,546,2
0.4375,0.307692308,33.6,10/30/2016,2016,8,20,18,away,16,IND,334,172,40,71,30,14,Win,88,105,3,6,2,KCC,44,422,277,0
0.307692308,0.4375,26.4,10/30/2016,2016,8,18,20,home,-16,KCC,172,334,45,62,14,30,Loss,105,88,6,3,0,IND,44,277,422,2
0.388888889,0.307692308,44.2,10/30/2016,2016,8,27,18,away,6,TBB,498,168,200,85,6,0,Win,128,102,2,2,0,OAK,6,626,270,1
0.307692308,0.388888889,29.05,10/30/2016,2016,8,18,27,home,-6,OAK,168,498,64,61,0,6,Loss,102,128,2,2,1,TBB,6,270,626,0
0.454545455,0.6,23.8,10/30/2016,2016,8,15,28,away,-5,NOS,285,252,76,54,20,25,Loss,74,123,1,2,1,SEA,45,359,375,1
0.6,0.454545455,36.2,10/30/2016,2016,8,28,15,home,5,SEA,252,285,10,72,25,20,Win,123,74,2,1,1,NOS,45,375,359,1
0.272727273,0.4,26.03333333,10/30/2016,2016,8,19,20,away,-7,HOU,231,164,75,56,13,20,Loss,58,105,1,3,1,DET,33,289,269,0
0.4,0.272727273,33.96666667,10/30/2016,2016,8,20,19,home,7,DET,164,231,49,63,20,13,Win,105,58,3,1,0,HOU,33,269,289,1
0.466666667,0.5,33.68333333,10/30/2016,2016,8,21,22,away,3,CLE,222,339,37,71,31,28,Win,171,68,2,1,2,NYJ,59,393,407,0
0.5,0.466666667,26.31666667,10/30/2016,2016,8,22,21,home,-3,NYJ,339,222,10,70,28,31,Loss,68,171,1,2,0,CLE,59,407,393,2
0.692307692,0.307692308,29.85,10/30/2016,2016,8,23,25,away,16,BUF,285,209,116,61,41,25,Win,72,167,5,2,0,NEP,66,357,376,0
0.307692308,0.692307692,30.15,10/30/2016,2016,8,25,23,home,-16,NEP,209,285,84,68,25,41,Loss,167,72,2,5,0,BUF,66,376,357,0
0.333333333,0.428571429,29.2,10/30/2016,2016,8,22,19,away,-10,CAR,316,208,88,64,20,30,Loss,24,141,8,1,1,ARI,50,340,349,2
0.428571429,0.333333333,30.8,10/30/2016,2016,8,19,22,home,10,ARI,208,316,40,64,30,20,Win,141,24,1,8,2,CAR,50,349,340,1
0.411764706,0.333333333,33.13333333,10/30/2016,2016,8,21,15,away,-8,DEN,246,267,52,77,19,27,Loss,123,57,4,1,3,LAC,46,369,324,3
0.333333333,0.411764706,26.86666667,10/30/2016,2016,8,15,21,home,8,LAC,267,246,45,64,27,19,Win,57,123,1,4,3,DEN,46,324,369,3
0.6,0.444444444,31.28333333,10/30/2016,2016,8,24,25,away,-1,ATL,223,277,68,60,32,33,Loss,108,90,3,2,0,GBP,65,331,367,0
0.444444444,0.6,28.71666667,10/30/2016,2016,8,25,24,home,1,GBP,277,223,46,56,33,32,Win,90,108,2,3,0,ATL,65,367,331,0
0.4,0.285714286,33.25,10/30/2016,2016,8,21,26,away,-6,DAL,194,273,40,71,0,6,Loss,97,187,3,2,1,PHI,6,291,460,1
0.285714286,0.4,33.95,10/30/2016,2016,8,26,21,home,6,PHI,273,194,84,76,6,0,Win,187,97,2,3,1,DAL,6,460,291,1
0.153846154,0.5,27.31666667,10/31/2016,2016,8,15,19,away,-10,CHI,201,245,10,60,10,20,Loss,57,158,5,1,0,MIN,30,258,403,0
0.5,0.153846154,32.68333333,10/31/2016,2016,8,19,15,home,10,MIN,245,201,20,61,20,10,Win,158,57,1,5,0,CHI,30,403,258,0
0.6,0.571428571,33.46666667,11/3/2016,2016,9,31,23,away,15,TBB,325,326,34,70,43,28,Win,136,70,2,2,2,ATL,71,461,396,1
0.571428571,0.6,26.53333333,11/3/2016,2016,9,23,31,home,-15,ATL,326,325,85,70,28,43,Loss,70,136,2,2,1,TBB,71,396,461,2
0.5,0.428571429,33.51666667,11/6/2016,2016,9,18,22,away,6,MIN,214,259,57,62,6,0,Win,97,78,1,2,0,DET,6,311,337,1
0.428571429,0.5,33.13333333,11/6/2016,2016,9,22,18,home,-6,DET,259,214,54,67,0,6,Loss,78,97,2,1,1,MIN,6,337,311,0
0.2,0.307692308,32.66666667,11/6/2016,2016,9,21,16,away,-5,NYG,347,248,43,74,23,28,Loss,96,54,2,1,2,PHI,51,443,302,2
0.307692308,0.2,27.33333333,11/6/2016,2016,9,16,21,home,5,PHI,248,347,30,61,28,23,Win,54,96,1,2,2,NYG,51,302,443,2
0.3,0.454545455,29.63333333,11/6/2016,2016,9,18,20,away,-4,MIA,191,137,77,53,23,27,Loss,140,137,3,1,0,NYJ,50,331,274,2
0.454545455,0.3,30.36666667,11/6/2016,2016,9,20,18,home,4,NYJ,137,191,85,62,27,23,Win,137,140,1,3,2,MIA,50,274,331,0
0.384615385,0.071428571,29.65,11/6/2016,2016,9,25,10,away,-5,KCC,244,169,46,75,14,19,Loss,205,62,2,2,0,JAX,33,449,231,4
0.071428571,0.384615385,30.35,11/6/2016,2016,9,10,25,home,5,JAX,169,244,75,57,19,14,Win,62,205,2,2,4,KCC,33,231,449,0
0.666666667,0.111111111,39.65,11/6/2016,2016,9,29,13,away,25,CLE,255,177,38,70,35,10,Win,168,45,0,4,0,DAL,45,423,222,0
0.111111111,0.666666667,20.35,11/6/2016,2016,9,13,29,home,-25,DAL,177,255,33,44,10,35,Loss,45,168,4,0,0,CLE,45,222,423,0
0.25,0.235294118,27.83333333,11/6/2016,2016,9,15,13,away,-7,BAL,241,224,99,65,14,21,Loss,36,50,2,3,1,PIT,35,277,274,1
0.235294118,0.25,32.16666667,11/6/2016,2016,9,13,15,home,7,PIT,224,241,94,63,21,14,Win,50,36,3,2,1,BAL,35,274,277,1
0.647058824,0.222222222,38.88333333,11/6/2016,2016,9,29,19,away,18,SFO,323,393,40,82,41,23,Win,248,93,1,1,4,NOS,64,571,486,0
0.222222222,0.647058824,21.11666667,11/6/2016,2016,9,19,29,home,-18,NOS,393,323,78,57,23,41,Loss,93,248,1,1,0,SFO,64,486,571,4
0.4,0.285714286,34.2,11/6/2016,2016,9,16,18,away,3,LAR,185,280,35,62,13,10,Win,59,59,5,4,1,CAR,23,244,339,0
0.285714286,0.4,25.8,11/6/2016,2016,9,18,16,home,-3,CAR,280,185,109,67,10,13,Loss,59,59,4,5,0,LAR,23,339,244,1
0.5,0.333333333,30.05,11/6/2016,2016,9,22,25,away,5,GBP,270,289,35,66,31,26,Win,85,116,2,3,1,IND,57,355,405,2
0.333333333,0.5,29.95,11/6/2016,2016,9,25,22,home,-5,IND,289,270,25,65,26,31,Loss,116,85,3,2,2,GBP,57,405,355,1
0.454545455,0.454545455,23.51666667,11/6/2016,2016,9,24,31,away,-8,LAC,313,268,57,62,35,43,Loss,80,208,0,1,0,TEN,78,393,476,3
0.454545455,0.454545455,36.48333333,11/6/2016,2016,9,31,24,home,8,TEN,268,313,107,73,43,35,Win,208,80,1,0,3,LAC,78,476,393,0
0.272727273,0.357142857,18.53333333,11/6/2016,2016,9,13,30,away,-10,OAK,266,179,104,51,20,30,Loss,33,218,2,2,0,DEN,50,299,397,2
0.357142857,0.272727273,41.46666667,11/6/2016,2016,9,30,13,home,10,DEN,179,266,72,76,30,20,Win,218,33,2,2,2,OAK,50,397,299,0
0.705882353,0.285714286,40.28333333,11/7/2016,2016,9,30,19,away,-6,SEA,263,245,115,82,25,31,Loss,162,33,5,4,0,BUF,56,425,278,1
0.285714286,0.705882353,19.71666667,11/7/2016,2016,9,19,30,home,6,BUF,245,263,75,42,31,25,Win,33,162,4,5,1,SEA,56,278,425,0
0.2,0.583333333,21.4,11/10/2016,2016,10,11,29,away,-21,BAL,111,277,35,48,7,28,Loss,33,119,4,2,2,CLE,35,144,396,3
0.583333333,0.2,38.6,11/10/2016,2016,10,29,11,home,21,CLE,277,111,61,77,28,7,Win,119,33,2,4,3,BAL,35,396,144,2
0.466666667,0.588235294,27.83333333,11/13/2016,2016,10,16,23,away,3,JAX,92,247,89,61,24,21,Win,181,80,1,2,2,HOU,45,273,327,0
0.588235294,0.466666667,32.16666667,11/13/2016,2016,10,23,16,home,-3,HOU,247,92,49,73,21,24,Loss,80,181,2,1,0,JAX,45,327,273,2
0.578947368,0.444444444,39.36666667,11/13/2016,2016,10,24,19,away,2,NOS,234,293,10,83,25,23,Win,103,80,6,1,4,DEN,48,337,373,2
0.444444444,0.578947368,20.63333333,11/13/2016,2016,10,19,24,home,-2,DEN,293,234,25,51,23,25,Loss,80,103,1,6,2,NOS,48,373,337,4
0.352941176,0.333333333,34.48333333,11/13/2016,2016,10,16,17,away,3,NYJ,155,157,55,67,9,6,Win,125,139,3,1,1,LAR,15,280,296,0
0.333333333,0.352941176,25.51666667,11/13/2016,2016,10,17,16,home,-3,LAR,157,155,31,58,6,9,Loss,139,125,1,3,0,NYJ,15,296,280,1
0.181818182,0.357142857,21.83333333,11/13/2016,2016,10,11,25,away,-9,PHI,255,221,67,48,15,24,Loss,48,208,2,2,1,ATL,39,303,429,1
0.357142857,0.181818182,38.16666667,11/13/2016,2016,10,25,11,home,9,ATL,221,255,77,76,24,15,Win,208,48,2,2,1,PHI,39,429,303,1
0.166666667,0.428571429,24.8,11/13/2016,2016,10,18,22,away,3,CAR,165,242,45,61,20,17,Win,91,99,3,2,2,KCC,37,256,341,1
0.428571429,0.166666667,35.2,11/13/2016,2016,10,22,18,home,-3,KCC,242,165,53,69,17,20,Loss,99,91,2,3,1,CAR,37,341,256,2
0.181818182,0.533333333,22.85,11/13/2016,2016,10,15,22,away,-26,TBB,161,280,74,54,10,36,Loss,122,80,4,4,1,CHI,46,283,360,4
0.533333333,0.181818182,37.15,11/13/2016,2016,10,22,15,home,26,CHI,280,161,85,68,36,10,Win,80,122,4,4,4,TBB,46,360,283,1
0.454545455,0.5,30.06666667,11/13/2016,2016,10,22,23,away,-6,WAS,284,260,35,64,20,26,Loss,47,128,3,1,1,MIN,46,331,388,1
0.5,0.454545455,29.93333333,11/13/2016,2016,10,23,22,home,6,MIN,260,284,35,62,26,20,Win,128,47,1,3,1,WAS,46,388,331,1
0.266666667,0.5,30.48333333,11/13/2016,2016,10,21,19,away,-22,TEN,333,292,107,73,25,47,Loss,69,154,5,1,0,GBP,72,402,446,3
0.5,0.266666667,29.51666667,11/13/2016,2016,10,19,21,home,22,GBP,292,333,65,59,47,25,Win,154,69,1,5,3,TEN,72,446,402,0
0.4,0.545454545,27.01666667,11/13/2016,2016,10,17,29,away,7,LAC,231,309,81,50,31,24,Win,106,70,1,3,4,MIA,55,337,379,1
0.545454545,0.4,32.98333333,11/13/2016,2016,10,29,17,home,-7,MIA,309,231,29,71,24,31,Loss,70,106,3,1,1,LAC,55,379,337,4
0.411764706,0.5,27.7,11/13/2016,2016,10,15,26,away,-3,ARI,198,363,100,61,20,23,Loss,83,80,3,2,4,SFO,43,281,443,1
0.5,0.411764706,32.3,11/13/2016,2016,10,26,15,home,3,SFO,363,198,10,74,23,20,Win,80,83,2,3,1,ARI,43,443,281,4
0.538461538,0.4,30.4,11/13/2016,2016,10,20,30,away,5,PIT,295,400,98,59,35,30,Win,127,48,2,1,0,DAL,65,422,448,1
0.4,0.538461538,29.6,11/13/2016,2016,10,30,20,home,-5,DAL,400,295,40,66,30,35,Loss,48,127,1,2,1,PIT,65,448,422,0
0.5,0.6,30.41666667,11/13/2016,2016,10,23,25,away,7,NEP,324,304,60,66,31,24,Win,96,81,3,2,2,SEA,55,420,385,0
0.6,0.5,29.58333333,11/13/2016,2016,10,25,23,home,-7,SEA,304,324,61,62,24,31,Loss,81,96,2,3,0,NEP,55,385,420,2
0.181818182,0.428571429,28.61666667,11/14/2016,2016,10,12,23,away,-1,NYG,186,229,60,55,20,21,Loss,78,122,3,1,2,CIN,41,264,351,1
0.428571429,0.181818182,31.38333333,11/14/2016,2016,10,23,12,home,1,CIN,229,186,15,72,21,20,Win,122,78,1,3,1,NYG,41,351,264,2
0.307692308,0.411764706,32.25,11/17/2016,2016,10,28,17,away,-3,CAR,264,173,48,72,20,23,Loss,107,50,3,2,0,NOS,43,371,223,2
0.411764706,0.307692308,27.75,11/17/2016,2016,10,17,28,home,3,NOS,173,264,45,62,23,20,Win,50,107,2,3,2,CAR,43,223,371,0
0.416666667,0.266666667,33.96666667,11/20/2016,2016,11,24,17,away,15,CLE,167,176,70,64,24,9,Win,146,33,0,8,2,PIT,33,313,209,0
0.266666667,0.416666667,26.03333333,11/20/2016,2016,11,17,24,home,-15,PIT,176,167,52,62,9,24,Loss,33,146,8,0,0,CLE,33,209,313,2
0.333333333,0.583333333,24.35,11/20/2016,2016,11,17,27,away,-10,DAL,267,299,136,52,17,27,Loss,101,118,1,1,0,BAL,44,368,417,0
0.583333333,0.333333333,35.65,11/20/2016,2016,11,27,17,home,10,BAL,299,267,45,67,27,17,Win,118,101,1,1,0,DAL,44,417,368,0
0.285714286,0.357142857,32.91666667,11/20/2016,2016,11,16,14,away,-7,DET,202,263,25,62,19,26,Loss,83,14,0,3,2,JAX,45,285,277,3
0.357142857,0.285714286,27.08333333,11/20/2016,2016,11,14,16,home,7,JAX,263,202,32,57,26,19,Win,14,83,3,0,3,DET,45,277,285,2
0.357142857,0.416666667,31.01666667,11/20/2016,2016,11,20,18,away,-7,IND,254,251,109,70,17,24,Loss,97,76,5,2,1,TEN,41,351,327,0
0.416666667,0.357142857,28.98333333,11/20/2016,2016,11,18,20,home,7,TEN,251,254,70,58,24,17,Win,76,97,2,5,0,IND,41,327,351,1
0.25,0.533333333,32.18333333,11/20/2016,2016,11,20,23,away,4,CIN,159,207,75,63,16,12,Win,183,93,2,1,2,BUF,28,342,300,1
0.533333333,0.25,27.81666667,11/20/2016,2016,11,23,20,home,-4,BUF,207,159,25,71,12,16,Loss,93,183,1,2,1,CIN,28,300,342,2
0.6875,0.5,35.3,11/20/2016,2016,11,27,19,away,2,KCC,326,261,42,74,19,17,Win,116,82,1,0,2,TBB,36,442,343,1
0.5,0.6875,24.7,11/20/2016,2016,11,19,27,home,-2,TBB,261,326,30,52,17,19,Loss,82,116,0,1,1,KCC,36,343,442,2
0.333333333,0.357142857,30.48333333,11/20/2016,2016,11,17,19,away,-6,NYG,222,227,40,59,16,22,Loss,93,102,4,0,0,CHI,38,315,329,1
0.357142857,0.333333333,29.51666667,11/20/2016,2016,11,19,17,home,6,CHI,227,222,35,65,22,16,Win,102,93,0,4,1,NYG,38,329,315,0
0.307692308,0.461538462,31.03333333,11/20/2016,2016,11,24,16,away,-6,MIN,155,145,96,70,24,30,Loss,135,72,4,2,1,ARI,54,290,217,2
0.461538462,0.307692308,28.96666667,11/20/2016,2016,11,16,24,home,6,ARI,145,155,73,54,30,24,Win,72,135,2,4,2,MIN,54,217,290,1
0.090909091,0.153846154,28.68333333,11/20/2016,2016,11,17,12,away,4,LAR,142,125,82,57,14,10,Win,98,102,4,1,1,MIA,24,240,227,1
0.153846154,0.090909091,31.31666667,11/20/2016,2016,11,12,17,home,-4,MIA,125,142,70,60,10,14,Loss,102,98,1,4,1,LAR,24,227,240,1
0.5,0.357142857,29.28333333,11/20/2016,2016,11,28,20,away,13,SFO,273,177,40,71,30,17,Win,171,122,1,5,0,NEP,47,444,299,0
0.357142857,0.5,30.71666667,11/20/2016,2016,11,20,28,home,-13,NEP,177,273,68,62,17,30,Loss,122,171,5,1,0,SFO,47,299,444,0
0.375,0.333333333,31.1,11/20/2016,2016,11,20,18,away,-11,SEA,195,287,48,73,15,26,Loss,113,152,2,1,0,PHI,41,308,439,2
0.333333333,0.375,28.9,11/20/2016,2016,11,18,20,home,11,PHI,287,195,48,63,26,15,Win,152,113,1,2,2,SEA,41,439,308,0
0.466666667,0.642857143,30.38333333,11/20/2016,2016,11,19,21,away,-18,WAS,340,364,59,65,24,42,Loss,84,151,2,2,0,GBP,66,424,515,2
0.642857143,0.466666667,29.61666667,11/20/2016,2016,11,21,19,home,18,GBP,364,340,40,62,42,24,Win,151,84,2,2,2,WAS,66,515,424,0
0.5,0.363636364,36.45,11/21/2016,2016,11,22,16,away,-7,OAK,230,295,101,74,20,27,Loss,124,30,2,0,1,HOU,47,354,325,2
0.363636364,0.5,23.55,11/21/2016,2016,11,16,22,home,7,HOU,295,230,21,51,27,20,Win,30,124,0,2,2,OAK,47,325,354,1
0.2,0.428571429,31.51666667,11/24/2016,2016,12,17,18,away,-3,DET,224,214,40,53,13,16,Loss,82,94,0,2,0,MIN,29,306,308,1
0.428571429,0.2,28.48333333,11/24/2016,2016,12,18,17,home,3,MIN,214,224,16,61,16,13,Win,94,82,2,0,1,DET,29,308,306,0
0.533333333,0.5,33.4,11/24/2016,2016,12,25,24,away,-5,DAL,449,190,30,72,26,31,Loss,56,163,0,1,0,WAS,57,505,353,0
0.5,0.533333333,26.6,11/24/2016,2016,12,24,25,home,5,WAS,190,449,25,55,31,26,Win,163,56,1,0,0,DAL,57,353,505,0
0.636363636,0.533333333,28.25,11/24/2016,2016,12,16,18,away,21,IND,221,219,67,50,28,7,Win,148,91,0,3,2,PIT,35,369,310,0
0.533333333,0.636363636,31.75,11/24/2016,2016,12,18,16,home,-21,PIT,219,221,10,63,7,28,Loss,91,148,3,0,0,IND,35,310,369,2
0.454545455,0.529411765,29.41666667,11/27/2016,2016,12,18,25,away,6,CHI,226,316,118,52,27,21,Win,149,95,0,0,2,TEN,48,375,411,0
0.529411765,0.454545455,30.58333333,11/27/2016,2016,12,25,18,home,-6,TEN,316,226,48,76,21,27,Loss,95,149,0,0,0,CHI,48,411,375,2
0.533333333,0.416666667,33.58333333,11/27/2016,2016,12,20,15,away,-7,BUF,118,151,60,65,21,28,Loss,183,153,2,5,0,JAX,49,301,304,0
0.416666667,0.533333333,26.41666667,11/27/2016,2016,12,15,20,home,7,JAX,151,118,31,52,28,21,Win,153,183,5,2,0,BUF,49,304,301,0
0.3125,0.3125,28.71666667,11/27/2016,2016,12,22,16,away,-5,BAL,261,219,15,71,14,19,Loss,64,92,3,2,1,CIN,33,325,311,2
0.3125,0.3125,31.28333333,11/27/2016,2016,12,16,22,home,5,CIN,219,261,69,68,19,14,Win,92,64,2,3,2,BAL,33,311,325,1
0.363636364,0.444444444,25.63333333,11/27/2016,2016,12,23,28,away,-19,ATL,274,244,60,61,19,38,Loss,58,116,2,3,1,ARI,57,332,360,1
0.444444444,0.363636364,34.36666667,11/27/2016,2016,12,28,23,home,19,ARI,244,274,23,67,38,19,Win,116,58,3,2,1,ATL,57,360,332,1
0.307692308,0.214285714,26.15,11/27/2016,2016,12,13,21,away,14,CLE,192,285,100,55,27,13,Win,104,58,1,7,3,NYG,40,296,343,1
0.214285714,0.307692308,33.85,11/27/2016,2016,12,21,13,home,-14,NYG,285,192,35,72,13,27,Loss,58,104,7,1,1,CLE,40,343,296,3
0.2,0.461538462,24.06666667,11/27/2016,2016,12,13,27,away,-28,NOS,178,346,62,52,21,49,Loss,69,209,3,2,1,LAR,70,247,555,2
0.461538462,0.2,35.93333333,11/27/2016,2016,12,27,13,home,28,LAR,346,178,45,71,49,21,Win,209,69,2,3,2,NOS,70,555,247,1
0.5,0.5,29.46666667,11/27/2016,2016,12,25,19,away,-7,MIA,282,263,65,73,24,31,Loss,193,95,2,2,0,SFO,55,475,358,2
0.5,0.5,30.53333333,11/27/2016,2016,12,19,25,home,7,SFO,263,282,42,58,31,24,Win,95,193,2,2,2,MIA,55,358,475,0
0.363636364,0.363636364,29.98333333,11/27/2016,2016,12,18,22,away,8,HOU,235,239,78,49,21,13,Win,67,114,1,1,4,LAC,34,302,353,1
0.363636364,0.363636364,30.01666667,11/27/2016,2016,12,22,18,home,-8,LAC,239,235,58,65,13,21,Loss,114,67,1,1,1,HOU,34,353,302,4
0.090909091,0.363636364,26.35,11/27/2016,2016,12,16,19,away,-9,TBB,118,220,27,61,5,14,Loss,127,118,6,0,2,SEA,19,245,338,3
0.363636364,0.090909091,33.65,11/27/2016,2016,12,19,16,home,9,SEA,220,118,68,63,14,5,Win,118,127,0,6,3,TBB,19,338,245,2
0.3,0.533333333,26.38333333,11/27/2016,2016,12,19,22,away,-3,OAK,229,310,67,56,32,35,Loss,129,56,2,1,2,CAR,67,358,366,2
0.533333333,0.3,33.61666667,11/27/2016,2016,12,22,19,home,3,CAR,310,229,46,71,35,32,Win,56,129,1,2,2,OAK,67,366,358,2
0.285714286,0.454545455,30.6,11/27/2016,2016,12,26,16,away,5,NYJ,286,269,15,71,22,17,Win,91,64,0,1,2,NEP,39,377,333,0
0.454545455,0.285714286,29.4,11/27/2016,2016,12,16,26,home,-5,NEP,269,286,66,56,17,22,Loss,64,91,1,0,0,NYJ,39,333,377,2
0.294117647,0.45,37.65,11/27/2016,2016,12,23,21,away,3,DEN,190,340,71,76,6,3,Win,83,124,6,5,1,KCC,9,273,464,0
0.45,0.294117647,37.31666667,11/27/2016,2016,12,21,23,home,-3,KCC,340,190,97,77,3,6,Loss,124,83,5,6,0,DEN,9,464,273,1
0.714285714,0.454545455,35.38333333,11/28/2016,2016,12,25,20,away,14,PHI,313,211,51,67,27,13,Win,74,81,0,4,1,GBP,40,387,292,0
0.454545455,0.714285714,24.61666667,11/28/2016,2016,12,20,25,home,-14,GBP,211,313,42,58,13,27,Loss,81,74,4,0,0,PHI,40,292,387,1
0.111111111,0.375,26.71666667,12/1/2016,2016,13,13,21,away,2,MIN,124,231,78,49,17,15,Win,140,87,3,3,1,DAL,32,264,318,2
0.375,0.111111111,33.28333333,12/1/2016,2016,13,21,13,home,-2,DAL,231,124,57,69,15,17,Loss,87,140,3,3,2,MIN,32,318,264,1
0.3,0.6,28.13333333,12/4/2016,2016,13,17,32,away,1,ATL,266,290,128,48,29,28,Win,123,128,1,2,1,KCC,57,389,418,1
0.6,0.3,31.86666667,12/4/2016,2016,13,32,17,home,-1,KCC,290,266,30,66,28,29,Loss,128,123,2,1,1,ATL,57,418,389,1
0.416666667,0.461538462,36.86666667,12/4/2016,2016,13,24,20,away,15,NOS,337,319,39,67,28,13,Win,85,50,2,1,3,DET,41,422,369,0
0.461538462,0.416666667,23.13333333,12/4/2016,2016,13,20,24,home,-15,DET,319,337,83,57,13,28,Loss,50,85,1,2,0,NOS,41,369,422,3
0.083333333,0.25,22.05,12/4/2016,2016,13,7,20,away,-16,NEP,126,269,30,49,10,26,Loss,36,133,4,0,0,LAR,36,162,402,2
0.25,0.083333333,37.95,12/4/2016,2016,13,20,7,home,16,LAR,269,126,46,75,26,10,Win,133,36,0,4,2,NEP,36,402,162,0
0.076923077,0.333333333,25.43333333,12/4/2016,2016,13,10,19,away,10,JAX,102,179,32,54,20,10,Win,104,154,2,1,3,DEN,30,206,333,0
0.333333333,0.076923077,34.56666667,12/4/2016,2016,13,19,10,home,-10,DEN,179,102,65,81,10,20,Loss,154,104,1,2,0,JAX,30,333,206,3
0.4,0.333333333,31.51666667,12/4/2016,2016,13,17,16,away,-8,GBP,184,200,12,64,13,21,Loss,123,109,2,1,1,HOU,34,307,309,1
0.333333333,0.4,28.48333333,12/4/2016,2016,13,16,17,home,8,HOU,200,184,30,57,21,13,Win,109,123,1,2,1,GBP,34,309,307,1
0.470588235,0.5,31.96666667,12/4/2016,2016,13,22,21,away,-18,CIN,306,332,88,80,14,32,Loss,53,80,1,0,2,PHI,46,359,412,3
0.5,0.470588235,28.03333333,12/4/2016,2016,13,21,22,home,18,PHI,332,306,23,64,32,14,Win,80,53,0,1,3,CIN,46,412,359,2
0.307692308,0.454545455,30.76666667,12/4/2016,2016,13,16,28,away,-32,BAL,215,386,57,58,6,38,Loss,62,110,2,0,2,MIA,44,277,496,3
0.454545455,0.307692308,29.23333333,12/4/2016,2016,13,28,16,home,32,MIA,386,215,68,70,38,6,Win,110,62,0,2,3,BAL,44,496,277,2
0.285714286,0.428571429,28.7,12/4/2016,2016,13,10,19,away,-20,CHI,6,184,106,55,6,26,Loss,141,142,6,1,1,SFO,32,147,326,0
0.428571429,0.285714286,31.3,12/4/2016,2016,13,19,10,home,20,SFO,184,6,40,59,26,6,Win,142,141,1,6,0,CHI,32,326,147,1
0.6,0.384615385,30.25,12/4/2016,2016,13,24,24,away,-14,OAK,170,260,73,69,24,38,Loss,212,139,4,0,0,BUF,62,382,399,2
0.384615385,0.6,29.75,12/4/2016,2016,13,24,24,home,14,BUF,260,170,65,67,38,24,Win,139,212,0,4,2,OAK,62,399,382,0
0.363636364,0.466666667,25.86666667,12/4/2016,2016,13,16,20,away,-10,PIT,178,272,24,55,14,24,Loss,56,117,2,2,2,NYG,38,234,389,2
0.466666667,0.363636364,34.13333333,12/4/2016,2016,13,20,16,home,10,NYG,272,178,115,69,24,14,Win,117,56,2,2,2,PIT,38,389,234,2
0.454545455,0.625,26.23333333,12/4/2016,2016,13,19,24,away,-8,ARI,246,281,35,57,23,31,Loss,87,88,2,2,0,WAS,54,333,369,2
0.625,0.454545455,33.76666667,12/4/2016,2016,13,24,19,home,8,WAS,281,246,51,72,31,23,Win,88,87,2,2,2,ARI,54,369,333,0
0.384615385,0.5,31.68333333,12/4/2016,2016,13,20,18,away,7,LAC,268,211,35,61,28,21,Win,81,119,1,2,2,TBB,49,349,330,1
0.5,0.384615385,28.31666667,12/4/2016,2016,13,18,20,home,-7,TBB,211,268,45,53,21,28,Loss,119,81,2,1,1,LAC,49,330,349,2
0.416666667,0.5,25.98333333,12/4/2016,2016,13,14,29,away,-33,SEA,182,294,63,54,7,40,Loss,89,240,0,3,1,CAR,47,271,534,2
0.5,0.416666667,34.01666667,12/4/2016,2016,13,29,14,home,33,CAR,294,182,37,71,40,7,Win,240,89,3,0,2,SEA,47,534,271,1
0.538461538,0.272727273,38.4,12/5/2016,2016,13,27,13,away,31,NYJ,282,214,28,70,41,10,Win,139,36,1,1,3,IND,51,421,250,1
0.272727273,0.538461538,21.6,12/5/2016,2016,13,13,27,home,-31,IND,214,282,90,52,10,41,Loss,36,139,1,1,1,NYJ,51,250,421,3
0.277777778,0.454545455,31.75,12/8/2016,2016,14,18,14,away,-8,KCC,109,258,82,73,13,21,Loss,135,65,1,1,3,OAK,34,244,323,0
0.454545455,0.277777778,28.25,12/8/2016,2016,14,14,18,home,8,OAK,258,109,73,54,21,13,Win,65,135,1,1,0,KCC,34,323,244,3
0.428571429,0.333333333,38.68333333,12/11/2016,2016,14,24,14,away,7,BUF,220,208,45,73,27,20,Win,240,67,0,5,1,PIT,47,460,275,3
0.333333333,0.428571429,21.31666667,12/11/2016,2016,14,14,24,home,-7,PIT,208,220,46,48,20,27,Loss,67,240,5,0,3,BUF,47,275,460,1
0.272727273,0.375,27.55,12/11/2016,2016,14,19,16,away,-3,TEN,330,73,87,64,10,13,Loss,18,180,3,2,0,DEN,23,348,253,2
0.375,0.272727273,32.45,12/11/2016,2016,14,16,19,home,3,DEN,73,330,55,65,13,10,Win,180,18,2,3,2,TEN,23,253,348,0
0.285714286,0.5,23.36666667,12/11/2016,2016,14,16,24,away,5,PHI,227,288,86,46,27,22,Win,107,95,2,4,2,WAS,49,334,383,1
0.5,0.285714286,36.63333333,12/11/2016,2016,14,24,16,home,-5,WAS,288,227,54,76,22,27,Loss,95,107,4,2,1,PHI,49,383,334,2
0.307692308,0.307692308,29.93333333,12/11/2016,2016,14,21,15,away,-3,MIA,125,231,54,63,23,26,Loss,175,83,3,1,3,ARI,49,300,314,4
0.307692308,0.307692308,30.06666667,12/11/2016,2016,14,15,21,home,3,ARI,231,125,118,57,26,23,Win,83,175,1,3,4,MIA,49,314,300,3
0.384615385,0.333333333,27.38333333,12/11/2016,2016,14,17,17,away,-12,CAR,220,146,32,64,16,28,Loss,58,126,5,2,1,LAC,44,278,272,5
0.333333333,0.384615385,32.61666667,12/11/2016,2016,14,17,17,home,12,LAC,146,220,35,67,28,16,Win,126,58,2,5,5,CAR,44,272,278,1
0.533333333,0.428571429,34.88333333,12/11/2016,2016,14,21,13,away,13,CLE,147,85,43,70,23,10,Win,213,169,4,3,1,CIN,33,360,254,0
0.428571429,0.533333333,25.11666667,12/11/2016,2016,14,13,21,home,-13,CIN,85,147,34,53,10,23,Loss,169,213,3,4,0,CLE,33,254,360,1
0.4,0.5,25.71666667,12/11/2016,2016,14,16,25,away,-3,DET,204,209,139,50,17,20,Loss,92,114,1,3,2,CHI,37,296,323,0
0.5,0.4,34.28333333,12/11/2016,2016,14,25,16,home,3,CHI,209,204,55,66,20,17,Win,114,92,3,1,0,DET,37,323,296,2
0.357142857,0.416666667,36.08333333,12/11/2016,2016,14,20,21,away,5,IND,131,265,124,67,22,17,Win,185,83,2,1,3,HOU,39,316,348,1
0.416666667,0.357142857,23.91666667,12/11/2016,2016,14,21,20,home,-5,HOU,265,131,59,61,17,22,Loss,83,185,1,2,1,IND,39,348,316,3
0.272727273,0.4375,31.11666667,12/11/2016,2016,14,22,18,away,9,JAX,292,230,93,63,25,16,Win,85,85,0,4,0,MIN,41,377,315,1
0.4375,0.272727273,28.88333333,12/11/2016,2016,14,18,22,home,-9,MIN,230,292,114,65,16,25,Loss,85,85,4,0,1,JAX,41,315,377,0
0.444444444,0.166666667,41.91666667,12/11/2016,2016,14,24,17,away,6,SFO,216,116,56,81,6,0,Win,188,248,6,2,0,NYJ,6,404,364,1
0.166666667,0.444444444,24.5,12/11/2016,2016,14,17,24,home,-6,NYJ,116,216,25,55,0,6,Loss,248,188,2,6,1,SFO,6,364,404,0
0.307692308,0.461538462,26.75,12/11/2016,2016,14,14,21,away,-5,TBB,248,166,104,58,11,16,Loss,46,104,1,2,0,NOS,27,294,270,3
0.461538462,0.307692308,33.25,12/11/2016,2016,14,21,14,home,5,NOS,166,248,65,63,16,11,Win,104,46,2,1,3,TBB,27,270,294,0
0.307692308,0.428571429,27.13333333,12/11/2016,2016,14,18,21,away,28,LAR,220,208,40,57,42,14,Win,66,104,2,3,5,ATL,56,286,312,0
0.428571429,0.307692308,32.86666667,12/11/2016,2016,14,21,18,home,-28,ATL,208,220,105,67,14,42,Loss,104,66,3,2,0,LAR,56,312,286,5
0.5,0.363636364,31.83333333,12/11/2016,2016,14,22,18,away,-28,GBP,218,237,63,68,10,38,Loss,136,93,3,1,0,SEA,48,354,330,6
0.363636364,0.5,28.16666667,12/11/2016,2016,14,18,22,home,28,SEA,237,218,50,56,38,10,Win,93,136,1,3,6,GBP,48,330,354,0
0.066666667,0.142857143,29.13333333,12/11/2016,2016,14,13,12,away,-3,NYG,152,167,54,65,7,10,Loss,108,93,3,3,3,DAL,17,260,260,3
0.142857143,0.066666667,30.86666667,12/11/2016,2016,14,12,13,home,3,DAL,167,152,50,64,10,7,Win,93,108,3,3,3,NYG,17,260,260,3
0.375,0.5,30.76666667,12/12/2016,2016,14,17,20,away,-7,NEP,306,401,47,68,23,30,Loss,42,95,2,1,3,BAL,53,348,496,1
0.5,0.375,29.23333333,12/12/2016,2016,14,20,17,home,7,BAL,401,306,48,65,30,23,Win,95,42,1,2,1,NEP,53,496,348,3
0.25,0.466666667,27.48333333,12/15/2016,2016,15,13,19,away,-21,SEA,136,227,76,56,3,24,Loss,47,72,4,2,1,LAR,27,183,299,0
0.466666667,0.25,32.51666667,12/15/2016,2016,15,19,13,home,21,LAR,227,136,86,58,24,3,Win,72,47,2,4,0,SEA,27,299,183,1
0.416666667,0.333333333,27.46666667,12/17/2016,2016,15,13,20,away,21,NYJ,236,244,70,46,34,13,Win,67,116,1,3,4,MIA,47,303,360,1
0.333333333,0.416666667,32.53333333,12/17/2016,2016,15,20,13,home,-21,MIA,244,236,42,72,13,34,Loss,116,67,3,1,1,NYJ,47,360,303,4
0.3,0.375,32.78333333,12/18/2016,2016,15,20,29,away,3,CHI,225,354,64,58,30,27,Win,226,95,4,1,4,GBP,57,451,449,0
0.375,0.3,27.21666667,12/18/2016,2016,15,29,20,home,-3,GBP,354,225,40,63,27,30,Loss,95,226,1,4,0,CHI,57,449,451,4
0.230769231,0.285714286,23.3,12/18/2016,2016,15,9,23,away,-1,HOU,83,308,91,50,20,21,Loss,67,79,2,0,2,JAX,41,150,387,1
0.285714286,0.230769231,36.7,12/18/2016,2016,15,23,9,home,1,JAX,308,83,71,78,21,20,Win,79,67,0,2,1,HOU,41,387,150,2
0.272727273,0.444444444,25.68333333,12/18/2016,2016,15,16,29,away,-20,BUF,162,171,51,54,13,33,Loss,107,280,5,1,0,CLE,46,269,451,0
0.444444444,0.272727273,34.31666667,12/18/2016,2016,15,29,16,home,20,CLE,171,162,42,66,33,13,Win,280,107,1,5,0,BUF,46,451,269,0
0.444444444,0.363636364,36.63333333,12/18/2016,2016,15,27,18,away,-1,BAL,159,189,30,81,26,27,Loss,169,151,1,3,2,PHI,53,328,340,1
0.363636364,0.444444444,23.36666667,12/18/2016,2016,15,18,27,home,1,PHI,189,159,62,57,27,26,Win,151,169,3,1,1,BAL,53,340,328,2
0.428571429,0.285714286,30.58333333,12/18/2016,2016,15,21,13,away,2,KCC,241,159,25,63,19,17,Win,148,157,1,1,1,TEN,36,389,316,3
0.285714286,0.428571429,29.41666667,12/18/2016,2016,15,13,21,home,-2,TEN,159,241,40,57,17,19,Loss,157,148,1,1,3,KCC,36,316,389,1
0.357142857,0.466666667,29.73333333,12/18/2016,2016,15,16,17,away,-11,NYG,268,186,15,59,6,17,Loss,56,114,1,2,0,DET,23,324,300,2
0.466666667,0.357142857,30.26666667,12/18/2016,2016,15,17,16,home,11,DET,186,268,46,62,17,6,Win,114,56,2,1,2,NYG,23,300,324,0
0.538461538,0.333333333,37.03333333,12/18/2016,2016,15,27,20,away,28,MIN,250,248,55,68,34,6,Win,161,34,0,5,3,IND,40,411,282,0
0.333333333,0.538461538,22.96666667,12/18/2016,2016,15,20,27,home,-28,IND,248,250,27,56,6,34,Loss,34,161,5,0,0,MIN,40,282,411,3
0.384615385,0.5,32.53333333,12/18/2016,2016,15,26,19,away,4,CIN,285,146,104,66,24,20,Win,97,76,1,1,1,PIT,44,382,222,0
0.5,0.384615385,27.46666667,12/18/2016,2016,15,19,26,home,-4,PIT,146,285,86,56,20,24,Loss,76,97,1,1,0,CIN,44,222,382,1
0.642857143,0.5,37.21666667,12/18/2016,2016,15,33,26,away,7,ARI,358,309,46,83,48,41,Win,130,116,3,1,2,NOS,89,488,425,1
0.5,0.642857143,22.78333333,12/18/2016,2016,15,26,33,home,-7,NOS,309,358,52,56,41,48,Loss,116,130,1,3,1,ARI,89,425,488,2
0.461538462,0.555555556,23.98333333,12/18/2016,2016,15,15,29,away,-28,ATL,165,302,20,55,13,41,Loss,107,248,2,1,1,SFO,54,272,550,1
0.555555556,0.461538462,36.01666667,12/18/2016,2016,15,29,15,home,28,SFO,302,165,27,66,41,13,Win,248,107,1,2,1,ATL,54,550,272,1
0.294117647,0.166666667,33.6,12/18/2016,2016,15,20,15,away,13,DEN,177,251,30,73,16,3,Win,136,58,2,4,3,NEP,19,313,309,0
0.166666667,0.294117647,26.4,12/18/2016,2016,15,15,20,home,-13,NEP,251,177,49,61,3,16,Loss,58,136,4,2,0,DEN,19,309,313,3
0.307692308,0.533333333,32.28333333,12/18/2016,2016,15,18,14,away,3,LAC,200,190,15,61,19,16,Win,145,73,2,3,2,OAK,35,345,263,2
0.533333333,0.307692308,27.71666667,12/18/2016,2016,15,14,18,home,-3,OAK,190,200,44,55,16,19,Loss,73,145,3,2,2,LAC,35,263,345,2
0.333333333,0.384615385,23.93333333,12/18/2016,2016,15,16,24,away,-6,DAL,224,264,35,59,20,26,Loss,52,185,4,3,1,TBB,46,276,449,4
0.384615385,0.333333333,36.06666667,12/18/2016,2016,15,24,16,home,6,TBB,264,224,91,71,26,20,Win,185,52,3,4,4,DAL,46,449,276,1
0.266666667,0.166666667,34.65,12/19/2016,2016,15,22,18,away,11,WAS,290,306,62,72,26,15,Win,148,29,2,1,3,CAR,41,438,335,0
0.166666667,0.266666667,25.35,12/19/2016,2016,15,18,22,home,-11,CAR,306,290,70,61,15,26,Loss,29,148,1,2,0,WAS,41,335,438,3
0.454545455,0.333333333,34.06666667,12/22/2016,2016,16,24,15,away,-5,PHI,356,168,50,88,19,24,Loss,114,118,0,0,1,NYG,43,470,286,3
0.333333333,0.454545455,25.93333333,12/22/2016,2016,16,15,24,home,5,NYG,168,356,5,55,24,19,Win,118,114,0,0,3,PHI,43,286,470,1
0.416666667,0.444444444,33.66666667,12/24/2016,2016,16,22,30,away,3,BUF,233,317,15,68,3,0,Win,261,272,0,2,0,MIA,3,494,589,1
0.444444444,0.416666667,40.55,12/24/2016,2016,16,30,22,home,-3,MIA,317,233,35,90,0,3,Loss,272,261,2,0,1,BUF,3,589,494,0
0.090909091,0.611111111,25.28333333,12/24/2016,2016,16,14,21,away,-38,NEP,128,211,77,55,3,41,Loss,111,114,2,1,0,NYJ,44,239,325,4
0.611111111,0.090909091,34.71666667,12/24/2016,2016,16,21,14,home,38,NYJ,211,128,20,70,41,3,Win,114,111,1,2,4,NEP,44,325,239,0
0.357142857,0.333333333,27.48333333,12/24/2016,2016,16,19,25,away,-21,JAX,205,331,49,67,17,38,Loss,58,84,3,2,1,TEN,55,263,415,1
0.333333333,0.357142857,32.51666667,12/24/2016,2016,16,25,19,home,21,TEN,331,205,45,69,38,17,Win,84,58,2,3,1,JAX,55,415,263,1
0.333333333,0.461538462,31.01666667,12/24/2016,2016,16,22,19,away,-13,GBP,353,308,70,74,25,38,Loss,93,40,4,4,0,MIN,63,446,348,2
0.461538462,0.333333333,28.98333333,12/24/2016,2016,16,19,22,home,13,MIN,308,353,21,58,38,25,Win,40,93,4,4,2,GBP,63,348,446,0
0.333333333,0.4,27.51666667,12/24/2016,2016,16,19,23,away,-3,CLE,322,127,92,65,17,20,Loss,34,124,0,9,0,LAC,37,356,251,1
0.4,0.333333333,32.48333333,12/24/2016,2016,16,23,19,home,3,LAC,127,322,44,66,20,17,Win,124,34,9,0,1,CLE,37,251,356,0
0.615384615,0.7,32.58333333,12/24/2016,2016,16,21,31,away,20,CHI,270,318,73,64,41,21,Win,208,140,0,1,5,WAS,62,478,458,0
0.7,0.615384615,27.41666667,12/24/2016,2016,16,31,21,home,-20,WAS,318,270,52,67,21,41,Loss,140,208,1,0,0,CHI,62,458,478,5
0.428571429,0.266666667,32.75,12/24/2016,2016,16,21,17,away,17,CAR,256,183,45,61,33,16,Win,152,119,4,2,2,ATL,49,408,302,0
0.266666667,0.428571429,27.25,12/24/2016,2016,16,17,21,home,-17,ATL,183,256,24,68,16,33,Loss,119,152,2,4,0,CAR,49,302,408,2
0.5,0.6,23.91666667,12/24/2016,2016,16,20,27,away,-8,OAK,288,253,22,53,25,33,Loss,102,210,0,1,0,IND,58,390,463,3
0.6,0.5,36.08333333,12/24/2016,2016,16,27,20,home,8,IND,253,288,97,72,33,25,Win,210,102,1,0,3,OAK,58,463,390,0
0.583333333,0.416666667,28.4,12/24/2016,2016,16,23,25,away,-7,NOS,260,294,63,58,24,31,Loss,89,123,2,2,0,TBB,55,349,417,2
0.416666667,0.583333333,31.6,12/24/2016,2016,16,25,23,home,7,TBB,294,260,59,67,31,24,Win,123,89,2,2,2,NOS,55,417,349,0
0.111111111,0.470588235,26.3,12/24/2016,2016,16,21,24,away,3,SEA,276,313,85,57,34,31,Win,94,78,1,6,1,ARI,65,370,391,1
0.470588235,0.111111111,33.7,12/24/2016,2016,16,24,21,home,-3,ARI,313,276,40,78,31,34,Loss,78,94,6,1,1,SEA,65,391,370,1
0.375,0.307692308,31.05,12/24/2016,2016,16,21,13,away,1,LAR,253,78,100,70,22,21,Win,70,99,4,4,2,SFO,43,323,177,2
0.307692308,0.375,28.95,12/24/2016,2016,16,13,21,home,-1,SFO,78,253,45,57,21,22,Loss,99,70,4,4,2,LAR,43,177,323,2
0.4375,0.285714286,28.9,12/24/2016,2016,16,15,17,away,-2,HOU,244,155,60,63,10,12,Loss,50,95,3,4,0,CIN,22,294,250,1
0.285714286,0.4375,31.1,12/24/2016,2016,16,17,15,home,2,CIN,155,244,25,57,12,10,Win,95,50,4,3,1,HOU,22,250,294,0
0.529411765,0.428571429,34.61666667,12/25/2016,2016,16,22,23,away,-4,PIT,246,279,95,72,27,31,Loss,122,127,2,0,2,BAL,58,368,406,1
0.428571429,0.529411765,25.38333333,12/25/2016,2016,16,23,22,home,4,BAL,279,246,45,55,31,27,Win,127,122,0,2,1,PIT,58,406,368,2
0.266666667,0.529411765,21.98333333,12/25/2016,2016,16,14,23,away,-23,KCC,183,246,70,57,10,33,Loss,63,238,0,0,1,DEN,43,246,484,3
0.529411765,0.266666667,38.01666667,12/25/2016,2016,16,23,14,home,23,DEN,246,183,65,74,33,10,Win,238,63,0,0,3,KCC,43,484,246,1
0.416666667,0.5,30.71666667,12/26/2016,2016,16,23,23,away,-21,DAL,229,211,62,70,21,42,Loss,90,164,4,1,0,DET,63,319,375,2
0.5,0.416666667,29.28333333,12/26/2016,2016,16,23,23,home,21,DET,211,229,47,52,42,21,Win,164,90,1,4,2,DAL,63,375,319,0
0.5,0.125,29.3,1/1/2017,2016,17,22,25,away,-17,CIN,263,218,41,70,10,27,Loss,72,153,3,1,0,BAL,37,335,371,2
0.125,0.5,30.7,1/1/2017,2016,17,25,22,home,17,BAL,218,263,20,67,27,10,Win,153,72,1,3,2,CIN,37,371,335,0
0.2,0.6,29.13333333,1/1/2017,2016,17,20,16,away,-7,TEN,243,133,35,74,17,24,Loss,46,103,4,4,1,HOU,41,289,236,1
0.6,0.2,30.86666667,1/1/2017,2016,17,16,20,home,7,HOU,133,243,50,59,24,17,Win,103,46,4,4,1,TEN,41,236,289,1
0.266666667,0.333333333,32.4,1/1/2017,2016,17,18,18,away,-1,TBB,207,188,45,67,16,17,Loss,128,112,3,3,2,CAR,33,335,300,3
0.333333333,0.266666667,27.6,1/1/2017,2016,17,18,18,home,1,CAR,188,207,30,63,17,16,Win,112,128,3,3,3,TBB,33,300,335,2
0.285714286,0.2,29.6,1/1/2017,2016,17,23,24,away,-4,IND,288,290,54,71,20,24,Loss,182,94,2,4,2,JAX,44,470,384,2
0.2,0.285714286,30.4,1/1/2017,2016,17,24,23,home,4,JAX,290,288,35,67,24,20,Win,94,182,4,2,2,IND,44,384,470,2
0.583333333,0.583333333,31.36666667,1/1/2017,2016,17,22,16,away,21,MIA,276,205,64,63,35,14,Win,120,75,0,0,2,NEP,49,396,280,0
0.583333333,0.583333333,28.63333333,1/1/2017,2016,17,16,22,home,-21,NEP,205,276,73,57,14,35,Loss,75,120,0,0,0,MIA,49,280,396,2
0.222222222,0.5,29.8,1/1/2017,2016,17,19,21,away,-28,MIN,140,250,49,59,10,38,Loss,183,124,2,0,1,CHI,48,323,374,5
0.5,0.222222222,30.2,1/1/2017,2016,17,21,19,home,28,CHI,250,140,15,62,38,10,Win,124,183,0,2,5,MIN,48,374,323,1
0.375,0.307692308,28.55,1/1/2017,2016,17,14,18,away,-20,NYJ,162,202,0,62,10,30,Loss,68,127,3,1,0,BUF,40,230,329,3
0.307692308,0.375,31.45,1/1/2017,2016,17,18,14,home,20,BUF,202,162,15,61,30,10,Win,127,68,1,3,3,NYJ,40,329,230,0
0.416666667,0.428571429,24.3,1/1/2017,2016,17,15,24,away,-14,PHI,126,232,35,53,13,27,Loss,69,114,3,2,0,DAL,40,195,346,2
0.428571429,0.416666667,35.7,1/1/2017,2016,17,24,15,home,14,DAL,232,126,61,75,27,13,Win,114,69,2,3,2,PHI,40,346,195,0
0.533333333,0.214285714,38.9,1/1/2017,2016,17,27,21,away,-3,PIT,206,243,37,77,3,6,Loss,231,69,4,4,1,CLE,9,437,312,4
0.214285714,0.533333333,33.15,1/1/2017,2016,17,21,27,home,3,CLE,243,206,43,69,6,3,Win,69,231,4,4,4,PIT,9,312,437,1
0.4375,0.545454545,30.25,1/1/2017,2016,17,26,25,away,-6,ATL,341,323,70,75,32,38,Loss,132,142,2,1,0,NOS,70,473,465,1
0.545454545,0.4375,29.75,1/1/2017,2016,17,25,26,home,6,NOS,323,341,63,59,38,32,Win,142,132,1,2,1,ATL,70,465,473,0
0.352941176,0.333333333,35.86666667,1/1/2017,2016,17,17,16,away,9,WAS,171,246,42,68,19,10,Win,161,38,1,4,3,NYG,29,332,284,0
0.333333333,0.352941176,24.13333333,1/1/2017,2016,17,16,17,home,-9,NYG,246,171,42,54,10,19,Loss,38,161,4,1,0,WAS,29,284,332,3
0.285714286,0.142857143,27.96666667,1/1/2017,2016,17,21,9,away,38,LAR,260,71,51,67,44,6,Win,84,52,1,7,3,ARI,50,344,123,2
0.142857143,0.285714286,32.03333333,1/1/2017,2016,17,9,21,home,-38,ARI,71,260,61,57,6,44,Loss,52,84,7,1,2,LAR,50,123,344,3
0.181818182,0.333333333,24.58333333,1/1/2017,2016,17,11,18,away,-18,DEN,164,206,125,50,6,24,Loss,57,143,2,0,1,OAK,30,221,349,3
0.333333333,0.181818182,35.41666667,1/1/2017,2016,17,18,11,home,18,OAK,206,164,43,67,24,6,Win,143,57,0,2,3,DEN,30,349,221,1
0.666666667,0.3,30.8,1/1/2017,2016,17,26,26,away,10,LAC,262,269,19,60,37,27,Win,103,129,1,0,2,KCC,64,365,398,1
0.3,0.666666667,29.2,1/1/2017,2016,17,26,26,home,-10,KCC,269,262,50,64,27,37,Loss,129,103,0,1,1,LAC,64,398,365,2
0.25,0.181818182,29.56666667,1/1/2017,2016,17,18,14,away,2,SFO,289,191,34,65,25,23,Win,87,62,2,5,2,SEA,48,376,253,0
0.181818182,0.25,30.43333333,1/1/2017,2016,17,14,18,home,-2,SEA,191,289,25,58,23,25,Loss,62,87,5,2,0,SFO,48,253,376,2
0.538461538,0.416666667,34.15,1/1/2017,2016,17,28,24,away,7,DET,295,332,75,71,31,24,Win,153,76,1,2,1,GBP,55,448,408,0
0.416666667,0.538461538,25.85,1/1/2017,2016,17,24,28,home,-7,GBP,332,295,30,64,24,31,Loss,76,153,2,1,0,DET,55,408,448,1
0.125,0.266666667,26.51666667,1/7/2017,2016,PF,16,19,away,-13,HOU,139,168,63,69,14,27,Loss,64,123,3,0,0,OAK,41,203,291,3
0.266666667,0.125,33.48333333,1/7/2017,2016,PF,19,16,home,13,OAK,168,139,65,69,27,14,Win,123,64,0,3,3,HOU,41,291,203,0
0.181818182,0.5625,23.35,1/7/2017,2016,PF,13,24,away,-20,SEA,182,210,68,50,6,26,Loss,49,177,3,3,0,DET,32,231,387,0
0.5625,0.181818182,36.65,1/7/2017,2016,PF,24,13,home,20,DET,210,182,40,71,26,6,Win,177,49,3,3,0,SEA,32,387,231,0
0.428571429,0.444444444,32.03333333,1/8/2017,2016,PF,18,19,away,-18,PIT,253,188,64,62,12,30,Loss,52,179,5,1,2,MIA,42,305,367,3
0.444444444,0.428571429,27.96666667,1/8/2017,2016,PF,19,18,home,18,MIA,188,253,60,54,30,12,Win,179,52,1,5,3,PIT,42,367,305,2
0.3125,0.357142857,25.48333333,1/8/2017,2016,PF,15,23,away,-25,GBP,295,331,42,63,13,38,Loss,70,75,2,5,0,NYG,51,365,406,2
0.357142857,0.3125,34.51666667,1/8/2017,2016,PF,23,15,home,25,NYG,331,295,21,70,38,13,Win,75,70,5,2,2,GBP,51,406,365,0
0.454545455,0.5,26.68333333,1/14/2017,2016,PF,17,28,away,-16,ATL,208,323,40,54,20,36,Loss,101,99,3,3,0,SEA,56,309,422,2
0.5,0.454545455,33.31666667,1/14/2017,2016,PF,28,17,home,16,SEA,323,208,10,69,36,20,Win,99,101,3,3,2,ATL,56,422,309,0
0.1875,0.357142857,32.5,1/14/2017,2016,PF,14,20,away,-18,NEP,180,279,75,66,16,34,Loss,105,98,3,2,3,HOU,50,285,377,3
0.357142857,0.1875,27.5,1/14/2017,2016,PF,20,14,home,18,HOU,279,180,50,67,34,16,Win,98,105,2,3,3,NEP,50,377,285,3
0.545454545,0.545454545,29.76666667,1/15/2017,2016,PF,27,25,away,3,DAL,326,291,22,63,34,31,Win,87,138,3,2,1,GBP,65,413,429,1
0.545454545,0.545454545,30.23333333,1/15/2017,2016,PF,25,27,home,-3,GBP,291,326,50,64,31,34,Loss,138,87,2,3,1,DAL,65,429,413,1
0.466666667,0.222222222,34.21666667,1/15/2017,2016,PF,20,16,away,2,KCC,218,166,53,66,18,16,Win,171,61,1,1,2,PIT,34,389,227,1
0.222222222,0.466666667,25.78333333,1/15/2017,2016,PF,16,20,home,-2,PIT,166,218,60,49,16,18,Loss,61,171,1,1,1,KCC,34,227,389,2
0.4,0.769230769,26.35,1/22/2017,2016,PF,24,30,away,-23,ATL,268,392,63,64,21,44,Loss,99,101,2,0,0,GBP,65,367,493,2
0.769230769,0.4,33.65,1/22/2017,2016,PF,30,24,home,23,GBP,392,268,31,68,44,21,Win,101,99,0,2,2,ATL,65,493,367,0
0.6,0.647058824,28.56666667,1/22/2017,2016,PF,22,26,away,-19,NEP,314,374,19,67,17,36,Loss,54,57,0,2,0,PIT,53,368,431,2
0.647058824,0.6,31.43333333,1/22/2017,2016,PF,26,22,home,19,PIT,374,314,10,71,36,17,Win,57,54,2,0,2,NEP,53,431,368,0
0.5,0.125,40.51666667,2/5/2017,2016,PF,37,17,away,6,ATL,442,240,23,93,6,0,Win,104,104,5,5,1,NEP,6,546,344,2
0.125,0.5,23.45,2/5/2017,2016,PF,17,37,home,-6,NEP,240,442,65,46,0,6,Loss,104,104,5,5,2,ATL,6,344,546,1
0.363636364,0.333333333,30.23333333,9/7/2017,2017,1,26,25,away,15,NEP,352,247,139,65,42,27,Win,185,124,3,3,0,KCC,69,537,371,1
0.333333333,0.363636364,29.76666667,9/7/2017,2017,1,25,26,home,-15,KCC,247,352,55,74,27,42,Loss,124,185,3,3,1,NEP,69,371,537,0
0.4,0.5,26.66666667,9/10/2017,2017,1,24,19,away,-12,DET,263,285,55,67,23,35,Loss,45,82,1,1,1,ARI,58,308,367,4
0.5,0.4,33.33333333,9/10/2017,2017,1,19,24,home,12,ARI,285,263,100,69,35,23,Win,82,45,1,1,4,DET,58,367,308,1
0.454545455,0.384615385,30.56666667,9/10/2017,2017,1,18,20,away,6,CHI,308,176,73,55,23,17,Win,64,125,2,4,0,ATL,40,372,301,0
0.384615385,0.454545455,29.43333333,9/10/2017,2017,1,20,18,home,-6,ATL,176,308,40,63,17,23,Loss,125,64,4,2,0,CHI,40,301,372,0
0.428571429,0.307692308,34,9/10/2017,2017,1,17,14,away,20,CIN,111,144,85,60,20,0,Win,157,77,1,5,5,BAL,20,268,221,1
0.307692308,0.428571429,26,9/10/2017,2017,1,14,17,home,-20,BAL,144,111,66,58,0,20,Loss,77,157,5,1,1,CIN,20,221,268,5
0.285714286,0.470588235,26.93333333,9/10/2017,2017,1,11,23,away,-9,BUF,176,218,62,55,12,21,Loss,38,190,1,2,1,NYJ,33,214,408,2
0.470588235,0.285714286,33.06666667,9/10/2017,2017,1,23,11,home,9,NYJ,218,176,50,72,21,12,Win,190,38,2,1,2,BUF,33,408,214,1
0.384615385,0.25,28.83333333,9/10/2017,2017,1,16,20,away,3,CLE,255,180,143,54,21,18,Win,35,57,1,7,1,PIT,39,290,237,1
0.25,0.384615385,31.16666667,9/10/2017,2017,1,20,16,home,-3,PIT,180,255,61,62,18,21,Loss,57,35,7,1,1,CLE,39,237,290,1
0.25,0.416666667,30.08333333,9/10/2017,2017,1,19,23,away,22,HOU,125,110,89,60,29,7,Win,155,93,0,10,4,JAX,36,280,203,0
0.416666667,0.25,29.91666667,9/10/2017,2017,1,23,19,home,-22,JAX,110,125,94,69,7,29,Loss,93,155,10,0,0,HOU,36,203,280,4
0.416666667,0.5,31.65,9/10/2017,2017,1,22,21,away,10,TEN,250,255,49,63,26,16,Win,109,95,2,1,0,OAK,42,359,350,0
0.5,0.416666667,28.35,9/10/2017,2017,1,21,22,home,-10,OAK,255,250,49,63,16,26,Loss,95,109,1,2,0,TEN,42,350,359,0
0.571428571,0.272727273,34.26666667,9/10/2017,2017,1,19,16,away,13,WAS,298,200,76,65,30,17,Win,58,64,2,4,4,PHI,47,356,264,2
0.272727273,0.571428571,25.73333333,9/10/2017,2017,1,16,19,home,-13,PHI,200,298,15,61,17,30,Loss,64,58,4,2,2,WAS,47,264,356,4
0,0.357142857,25.58333333,9/10/2017,2017,1,10,19,away,-37,LAR,150,310,20,49,9,46,Loss,75,63,4,1,1,IND,55,225,373,3
0.357142857,0,34.41666667,9/10/2017,2017,1,19,10,home,37,IND,310,150,50,64,46,9,Win,63,75,1,4,3,LAR,55,373,225,1
0.538461538,0.181818182,34.35,9/10/2017,2017,1,20,13,away,20,SFO,171,166,40,63,23,3,Win,116,51,0,4,2,CAR,26,287,217,2
0.181818182,0.538461538,25.65,9/10/2017,2017,1,13,20,home,-20,CAR,166,171,74,54,3,23,Loss,51,116,4,0,2,SFO,26,217,287,2
0.25,0.5625,20.78333333,9/10/2017,2017,1,12,26,away,-8,GBP,135,286,50,48,9,17,Loss,90,84,3,4,1,SEA,26,225,370,1
0.5625,0.25,39.21666667,9/10/2017,2017,1,26,12,home,8,SEA,286,135,70,74,17,9,Win,84,90,4,3,1,GBP,26,370,225,1
0.333333333,0.533333333,25.76666667,9/10/2017,2017,1,13,22,away,-16,DAL,198,263,55,53,3,19,Loss,35,129,3,1,0,NYG,22,233,392,1
0.533333333,0.333333333,34.23333333,9/10/2017,2017,1,22,13,home,16,NYG,263,198,50,71,19,3,Win,129,35,1,3,1,DAL,22,392,233,0
0.363636364,0.642857143,28.73333333,9/11/2017,2017,1,19,23,away,-10,MIN,284,341,52,59,19,29,Loss,60,129,1,1,0,NOS,48,344,470,0
0.642857143,0.363636364,31.26666667,9/11/2017,2017,1,23,19,home,10,NOS,341,284,50,63,29,19,Win,129,60,1,1,0,MIN,48,470,344,0
0.25,0.533333333,25.78333333,9/11/2017,2017,1,17,22,away,-3,DEN,185,181,40,56,21,24,Loss,64,140,1,4,2,LAC,45,249,321,1
0.533333333,0.25,34.21666667,9/11/2017,2017,1,22,17,home,3,LAC,181,185,62,68,24,21,Win,140,64,4,1,1,DEN,45,321,249,2
0.266666667,0.266666667,32.25,9/14/2017,2017,1,14,12,away,4,CIN,98,213,61,62,13,9,Win,168,82,3,3,1,HOU,22,266,295,0
0.266666667,0.266666667,27.75,9/14/2017,2017,1,12,14,home,-4,HOU,213,98,45,62,9,13,Loss,82,168,3,3,0,CIN,22,295,266,1
0.4,0.444444444,28.81666667,9/17/2017,2017,2,17,18,away,3,IND,306,190,41,65,3,0,Win,83,76,4,4,1,ARI,3,389,266,1
0.444444444,0.4,33.15,9/17/2017,2017,2,18,17,home,-3,ARI,190,306,70,70,0,3,Loss,76,83,4,4,1,IND,3,266,389,1
0.166666667,0.363636364,26.6,9/17/2017,2017,2,20,24,away,-14,BAL,293,201,65,66,10,24,Loss,93,136,3,2,2,CLE,34,386,337,5
0.363636364,0.166666667,33.4,9/17/2017,2017,2,24,20,home,14,CLE,201,293,45,68,24,10,Win,136,93,2,3,5,BAL,34,337,386,2
0.307692308,0.4375,21.11666667,9/17/2017,2017,2,10,19,away,-6,CAR,107,178,44,51,3,9,Loss,69,77,3,6,0,BUF,12,176,255,0
0.4375,0.307692308,38.88333333,9/17/2017,2017,2,19,10,home,6,BUF,178,107,40,66,9,3,Win,77,69,6,3,0,CAR,12,255,176,0
0.5,0.533333333,26.81666667,9/17/2017,2017,2,19,22,away,-22,TBB,290,194,59,62,7,29,Loss,20,117,1,2,1,CHI,36,310,311,4
0.533333333,0.5,33.18333333,9/17/2017,2017,2,22,19,home,22,CHI,194,290,34,67,29,7,Win,117,20,2,1,4,TBB,36,311,310,1
0.461538462,0.461538462,30.76666667,9/17/2017,2017,2,21,20,away,21,JAX,211,211,70,64,37,16,Win,179,99,1,2,3,TEN,53,390,310,1
0.461538462,0.461538462,29.23333333,9/17/2017,2017,2,20,21,home,-21,TEN,211,211,99,61,16,37,Loss,99,179,2,1,1,JAX,53,310,390,3
0.533333333,0.416666667,30.81666667,9/17/2017,2017,2,27,16,away,-7,KCC,299,232,30,69,20,27,Loss,107,112,6,4,0,PHI,47,406,344,2
0.416666667,0.533333333,29.18333333,9/17/2017,2017,2,16,27,home,7,PHI,232,299,40,51,27,20,Win,112,107,4,6,2,KCC,47,344,406,0
0.333333333,0.230769231,25.63333333,9/17/2017,2017,2,14,22,away,-17,PIT,146,233,131,60,9,26,Loss,91,102,2,2,0,MIN,35,237,335,1
0.230769231,0.333333333,34.36666667,9/17/2017,2017,2,22,14,home,17,MIN,233,146,72,69,26,9,Win,102,91,2,2,1,PIT,35,335,237,0
0.5,0.333333333,35.1,9/17/2017,2017,2,29,20,away,16,NOS,436,348,66,72,36,20,Win,119,81,2,1,0,NEP,56,555,429,0
0.333333333,0.5,24.9,9/17/2017,2017,2,20,29,home,-16,NEP,348,436,35,63,20,36,Loss,81,119,1,2,0,NOS,56,429,555,0
0.384615385,0.25,33.36666667,9/17/2017,2017,2,21,24,away,2,LAC,225,323,23,68,19,17,Win,111,44,2,1,0,MIA,36,336,367,0
0.25,0.384615385,26.63333333,9/17/2017,2017,2,24,21,home,-2,MIA,323,225,56,54,17,19,Loss,44,111,1,2,0,LAC,36,367,336,0
0.583333333,0.666666667,28.96666667,9/17/2017,2017,2,17,21,away,-25,OAK,145,230,47,53,20,45,Loss,126,180,4,0,0,NYJ,65,271,410,2
0.666666667,0.583333333,31.03333333,9/17/2017,2017,2,21,17,home,25,NYJ,230,145,79,55,45,20,Win,180,126,0,4,2,OAK,65,410,271,0
0.214285714,0.6,26.16666667,9/17/2017,2017,2,16,26,away,-25,DEN,228,202,69,66,17,42,Loss,40,178,2,2,2,DAL,59,268,380,2
0.6,0.214285714,33.83333333,9/17/2017,2017,2,26,16,home,25,DAL,202,228,61,73,42,17,Win,178,40,2,2,2,DEN,59,380,268,2
0.384615385,0.416666667,36.31666667,9/17/2017,2017,2,21,14,away,7,LAR,156,235,25,68,27,20,Win,229,97,2,2,2,WAS,47,385,332,0
0.416666667,0.384615385,23.68333333,9/17/2017,2017,2,14,21,home,-7,WAS,235,156,75,49,20,27,Loss,97,229,2,2,0,LAR,47,332,385,2
0.166666667,0.421052632,23.03333333,9/17/2017,2017,2,11,21,away,-3,SEA,89,181,66,48,9,12,Loss,159,131,2,3,0,SFO,21,248,312,1
0.421052632,0.166666667,36.96666667,9/17/2017,2017,2,21,11,home,3,SFO,181,89,71,79,12,9,Win,131,159,3,2,1,SEA,21,312,248,0
0.416666667,0.454545455,31.38333333,9/17/2017,2017,2,24,19,away,-11,ATL,308,223,70,68,23,34,Loss,59,141,3,3,0,GBP,57,367,364,2
0.454545455,0.416666667,28.61666667,9/17/2017,2017,2,19,24,home,11,GBP,223,308,34,58,34,23,Win,141,59,3,3,2,ATL,57,364,367,0
0.466666667,0.333333333,32.78333333,9/18/2017,2017,2,12,14,away,14,NYG,119,208,50,56,24,10,Win,138,62,3,5,1,DET,34,257,270,1
0.333333333,0.466666667,27.21666667,9/18/2017,2017,2,14,12,home,-14,DET,208,119,50,55,10,24,Loss,62,138,5,3,1,NYG,34,270,257,1
0.666666667,0.5,29.71666667,9/21/2017,2017,3,26,25,away,2,SFO,292,308,52,60,41,39,Win,126,113,0,4,2,LAR,80,418,421,2
0.5,0.666666667,30.28333333,9/21/2017,2017,3,25,26,home,-2,LAR,308,292,55,74,39,41,Loss,113,126,4,0,2,SFO,80,421,418,2
0.272727273,0.25,25.95,9/24/2017,2017,3,12,24,away,-37,JAX,52,244,88,54,7,44,Loss,134,166,2,0,0,BAL,51,186,410,3
0.25,0.272727273,34.05,9/24/2017,2017,3,24,12,home,37,BAL,244,52,70,68,44,7,Win,166,134,0,2,3,JAX,51,410,186,0
0.444444444,0.230769231,32.58333333,9/24/2017,2017,3,26,21,away,4,DET,277,253,68,65,30,26,Win,151,71,2,2,0,ATL,56,428,324,3
0.230769231,0.444444444,27.41666667,9/24/2017,2017,3,21,26,home,-4,ATL,253,277,98,66,26,30,Loss,71,151,2,2,3,DET,56,324,428,0
0.428571429,0.375,29.56666667,9/24/2017,2017,3,21,16,away,-10,BUF,255,197,79,66,16,26,Loss,111,75,3,4,0,DEN,42,366,272,2
0.375,0.428571429,30.43333333,9/24/2017,2017,3,16,21,home,10,DEN,197,255,69,63,26,16,Win,75,111,4,3,2,BUF,42,272,366,0
0.5,0.5,31.15,9/24/2017,2017,3,21,18,away,21,CAR,213,156,10,57,34,13,Win,149,132,1,4,3,NOS,47,362,288,0
0.5,0.5,28.85,9/24/2017,2017,3,18,21,home,-21,NOS,156,213,5,59,13,34,Loss,132,149,4,1,0,CAR,47,288,362,3
0.363636364,0.333333333,27.56666667,9/24/2017,2017,3,19,18,away,-6,CHI,212,84,40,59,0,6,Loss,70,222,3,2,2,PIT,6,282,306,2
0.333333333,0.363636364,33.98333333,9/24/2017,2017,3,18,19,home,6,PIT,84,212,73,62,6,0,Win,222,70,2,3,2,CHI,6,306,282,2
0.384615385,0.470588235,26.55,9/24/2017,2017,3,25,16,away,-3,IND,235,243,113,69,28,31,Loss,111,92,1,3,1,CLE,59,346,335,3
0.470588235,0.384615385,33.45,9/24/2017,2017,3,16,25,home,3,CLE,243,235,99,63,31,28,Win,92,111,3,1,3,IND,59,335,346,1
0.428571429,0.461538462,33.63333333,9/24/2017,2017,3,23,21,away,-3,NEP,292,337,60,67,33,36,Loss,125,59,2,5,1,HOU,69,417,396,2
0.461538462,0.428571429,26.36666667,9/24/2017,2017,3,21,23,home,3,HOU,337,292,69,60,36,33,Win,59,125,5,2,2,NEP,69,396,417,1
0.083333333,0.307692308,23.86666667,9/24/2017,2017,3,16,16,away,-14,NYJ,195,233,51,63,6,20,Loss,30,103,3,2,1,MIA,26,225,336,2
0.307692308,0.083333333,36.13333333,9/24/2017,2017,3,16,16,home,14,MIA,233,195,94,59,20,6,Win,103,30,2,3,2,NYJ,26,336,225,1
0.166666667,0.538461538,22.23333333,9/24/2017,2017,3,20,25,away,-17,MIN,316,369,37,51,17,34,Loss,26,125,2,0,0,TBB,51,342,494,3
0.538461538,0.166666667,37.76666667,9/24/2017,2017,3,25,20,home,17,TBB,369,316,53,70,34,17,Win,125,26,0,2,3,MIN,51,494,342,0
0.3,0.357142857,22.46666667,9/24/2017,2017,3,21,24,away,-3,PHI,366,161,137,64,24,27,Loss,49,193,0,3,1,NYG,51,415,354,2
0.357142857,0.3,37.53333333,9/24/2017,2017,3,24,21,home,3,NYG,161,366,103,73,27,24,Win,193,49,3,0,2,PHI,51,354,415,1
0.285714286,0.285714286,27.31666667,9/24/2017,2017,3,24,21,away,-6,TEN,364,225,98,72,27,33,Loss,69,195,1,0,0,SEA,60,433,420,0
0.285714286,0.285714286,32.68333333,9/24/2017,2017,3,21,24,home,6,SEA,225,364,45,67,33,27,Win,195,69,0,1,0,TEN,60,420,433,0
0.333333333,0.466666667,34.28333333,9/24/2017,2017,3,21,22,away,-3,GBP,191,280,68,60,0,3,Loss,110,64,3,6,1,CIN,3,301,344,1
0.466666667,0.333333333,29.35,9/24/2017,2017,3,22,21,home,3,CIN,280,191,33,65,3,0,Win,64,110,6,3,1,GBP,3,344,301,1
0.333333333,0.384615385,30.43333333,9/24/2017,2017,3,16,24,away,14,LAC,122,226,122,51,24,10,Win,189,104,5,2,3,KCC,34,311,330,0
0.384615385,0.333333333,29.56666667,9/24/2017,2017,3,24,16,home,-14,KCC,226,122,61,68,10,24,Loss,104,189,2,5,0,LAC,34,330,311,3
0,0.466666667,21.9,9/24/2017,2017,3,7,18,away,-17,WAS,96,356,35,48,10,27,Loss,32,116,4,1,2,OAK,37,128,472,3
0.466666667,0,38.1,9/24/2017,2017,3,18,7,home,17,OAK,356,96,77,65,27,10,Win,116,32,1,4,3,WAS,37,472,128,2
0.222222222,0.444444444,23.75,9/25/2017,2017,3,15,22,away,11,ARI,174,283,76,45,28,17,Win,99,49,1,6,0,DAL,45,273,332,0
0.444444444,0.222222222,36.25,9/25/2017,2017,3,22,15,home,-11,DAL,283,174,50,75,17,28,Loss,49,99,6,1,0,ARI,45,332,273,0
0.416666667,0.5,31.85,9/28/2017,2017,4,20,17,away,-21,GBP,205,169,62,64,14,35,Loss,103,91,1,2,0,CHI,49,308,260,4
0.5,0.416666667,28.15,9/28/2017,2017,4,17,20,home,21,CHI,169,205,55,53,35,14,Win,91,103,2,1,4,GBP,49,260,308,0
0.461538462,0.125,34.46666667,10/1/2017,2017,4,22,11,away,20,MIA,261,128,71,70,20,0,Win,86,58,1,4,1,NOS,20,347,186,0
0.125,0.461538462,25.53333333,10/1/2017,2017,4,11,22,home,-20,NOS,128,261,90,47,0,20,Loss,58,86,4,1,0,MIA,20,186,347,1
0.461538462,0.384615385,28.75,10/1/2017,2017,4,15,25,away,6,ATL,164,242,55,59,23,17,Win,117,147,3,1,3,BUF,40,281,389,0
0.384615385,0.461538462,31.25,10/1/2017,2017,4,25,15,home,-6,BUF,242,164,45,72,17,23,Loss,147,117,1,3,0,ATL,40,389,281,3
0.466666667,0.384615385,35.48333333,10/1/2017,2017,4,22,18,away,17,BAL,208,206,60,73,26,9,Win,173,82,1,4,3,PIT,35,381,288,1
0.384615385,0.466666667,24.51666667,10/1/2017,2017,4,18,22,home,-17,PIT,206,208,55,68,9,26,Loss,82,173,4,1,1,BAL,35,288,381,3
0.666666667,0.5,28.88333333,10/1/2017,2017,4,28,24,away,3,NEP,304,293,33,60,33,30,Win,140,80,2,3,0,CAR,63,444,373,2
0.5,0.666666667,31.11666667,10/1/2017,2017,4,24,28,home,-3,CAR,293,304,55,67,30,33,Loss,80,140,3,2,2,NEP,63,373,444,0
0.545454545,0.3125,35.03333333,10/1/2017,2017,4,25,16,away,24,CLE,264,170,66,63,31,7,Win,86,45,3,2,1,CIN,38,350,215,1
0.3125,0.545454545,24.96666667,10/1/2017,2017,4,16,25,home,-24,CIN,170,264,28,61,7,31,Loss,45,86,2,3,1,CLE,38,215,350,1
0.384615385,0.5,30.53333333,10/1/2017,2017,4,24,22,away,5,DAL,244,251,41,68,35,30,Win,168,189,1,2,2,LAR,65,412,440,0
0.5,0.384615385,29.46666667,10/1/2017,2017,4,22,24,home,-5,LAR,251,244,45,65,30,35,Loss,189,168,2,1,0,DAL,65,440,412,2
0.230769231,0.3,36.45,10/1/2017,2017,4,19,15,away,7,MIN,154,197,60,68,14,7,Win,97,87,6,2,3,DET,21,251,284,0
0.3,0.230769231,23.55,10/1/2017,2017,4,15,19,home,-7,DET,197,154,10,54,7,14,Loss,87,97,2,6,0,MIN,21,284,251,3
0.25,0.5,20.31666667,10/1/2017,2017,4,9,33,away,-43,HOU,109,272,88,41,14,57,Loss,86,173,2,2,1,TEN,71,195,445,5
0.5,0.25,39.68333333,10/1/2017,2017,4,33,9,home,43,TEN,272,109,20,78,57,14,Win,173,86,2,2,5,HOU,71,445,195,1
0.266666667,0.352941176,35.13333333,10/1/2017,2017,4,20,18,away,-3,NYJ,136,215,47,75,0,3,Loss,175,256,1,5,2,JAX,3,311,471,1
0.352941176,0.266666667,34.4,10/1/2017,2017,4,18,20,home,3,JAX,215,136,70,69,3,0,Win,256,175,5,1,1,NYJ,3,471,311,2
0.263157895,0.3125,33.21666667,10/1/2017,2017,4,20,25,away,-3,ARI,210,317,113,79,3,6,Loss,95,51,3,6,1,SFO,9,305,368,1
0.3125,0.263157895,36.25,10/1/2017,2017,4,25,20,home,3,SFO,317,210,80,79,6,3,Win,51,95,6,3,1,ARI,9,368,305,1
0.5625,0.5,39.3,10/1/2017,2017,4,26,18,away,2,LAC,240,342,58,74,26,24,Win,214,58,1,2,1,PHI,50,454,400,0
0.5,0.5625,20.7,10/1/2017,2017,4,18,26,home,-2,PHI,342,240,39,53,24,26,Loss,58,214,2,1,0,LAC,50,400,454,1
0.470588235,0.272727273,34.21666667,10/1/2017,2017,4,24,20,away,-2,TBB,288,323,0,77,23,25,Loss,91,111,0,1,0,NYG,48,379,434,0
0.272727273,0.470588235,25.78333333,10/1/2017,2017,4,20,24,home,2,NYG,323,288,19,62,25,23,Win,111,91,1,0,0,TBB,48,434,379,0
0.166666667,0.3125,27.05,10/1/2017,2017,4,11,16,away,-6,DEN,230,155,75,53,10,16,Loss,24,143,3,4,0,OAK,26,254,298,1
0.3125,0.166666667,32.95,10/1/2017,2017,4,16,11,home,6,OAK,155,230,40,62,16,10,Win,143,24,4,3,1,DEN,26,298,254,0
0.428571429,0.666666667,27.8,10/1/2017,2017,4,16,22,away,-28,SEA,139,283,31,57,18,46,Loss,98,194,3,3,2,IND,64,237,477,2
0.666666667,0.428571429,32.2,10/1/2017,2017,4,22,16,home,28,IND,283,139,45,62,46,18,Win,194,98,3,3,2,SEA,64,477,237,2
0.363636364,0.615384615,22.85,10/2/2017,2017,4,15,29,away,-9,KCC,220,261,44,50,20,29,Loss,111,168,0,4,0,WAS,49,331,429,1
0.615384615,0.363636364,37.15,10/2/2017,2017,4,29,15,home,9,WAS,261,220,15,72,29,20,Win,168,111,4,0,1,KCC,49,429,331,0
0.333333333,0.307692308,30.83333333,10/5/2017,2017,5,23,26,away,5,TBB,289,319,108,66,19,14,Win,113,90,3,2,0,NEP,33,402,409,2
0.307692308,0.333333333,29.16666667,10/5/2017,2017,5,26,23,home,-5,NEP,319,289,70,68,14,19,Loss,90,113,2,3,2,TBB,33,409,402,0
0.285714286,0.642857143,24.21666667,10/8/2017,2017,5,16,19,away,-27,PHI,276,297,61,60,7,34,Loss,31,122,2,1,1,ARI,41,307,419,1
0.642857143,0.285714286,35.78333333,10/8/2017,2017,5,19,16,home,27,ARI,297,276,60,64,34,7,Win,122,31,1,2,1,PHI,41,419,307,1
0.333333333,0.4,29.98333333,10/8/2017,2017,5,17,18,away,-4,CIN,139,323,71,67,16,20,Loss,82,65,6,1,3,BUF,36,221,388,1
0.4,0.333333333,30.01666667,10/8/2017,2017,5,18,17,home,4,BUF,323,139,71,64,20,16,Win,65,82,1,6,1,CIN,36,388,221,3
0.4375,0.384615385,35.38333333,10/8/2017,2017,5,16,19,away,3,DET,334,192,100,64,27,24,Win,28,50,3,6,1,CAR,51,362,242,0
0.384615385,0.4375,24.61666667,10/8/2017,2017,5,19,16,home,-3,CAR,192,334,10,56,24,27,Loss,50,28,6,3,0,DET,51,242,362,1
0.333333333,0.428571429,25.56666667,10/8/2017,2017,5,14,22,away,3,CLE,178,279,80,51,17,14,Win,34,140,3,1,3,NYJ,31,212,419,1
0.428571429,0.333333333,34.43333333,10/8/2017,2017,5,22,14,home,-3,NYJ,279,178,60,70,14,17,Loss,140,34,1,3,1,CLE,31,419,212,3
0.285714286,0.5,31.08333333,10/8/2017,2017,5,23,25,away,-3,IND,336,288,77,70,0,3,Loss,66,159,2,4,1,SFO,3,402,447,0
0.5,0.285714286,37.28333333,10/8/2017,2017,5,25,23,home,3,SFO,288,336,62,73,3,0,Win,159,66,4,2,0,IND,3,447,402,1
0.5,0.466666667,28.86666667,10/8/2017,2017,5,15,21,away,21,PIT,82,301,19,53,30,9,Win,231,70,2,2,5,JAX,39,313,371,1
0.466666667,0.5,31.13333333,10/8/2017,2017,5,21,15,home,-21,JAX,301,82,37,77,9,30,Loss,70,231,2,2,1,PIT,39,371,313,5
0.444444444,0.333333333,31.75,10/8/2017,2017,5,21,18,away,5,NYG,258,183,87,73,27,22,Win,124,152,0,5,2,LAC,49,382,335,1
0.333333333,0.444444444,28.25,10/8/2017,2017,5,18,21,home,-5,LAC,183,258,67,66,22,27,Loss,152,124,5,0,1,NYG,49,335,382,2
0.153846154,0.333333333,30.25,10/8/2017,2017,5,14,12,away,-6,MIA,119,78,77,58,10,16,Loss,69,100,6,1,2,TEN,26,188,178,2
0.333333333,0.153846154,29.75,10/8/2017,2017,5,12,14,home,6,TEN,78,119,23,59,16,10,Win,100,69,1,6,2,MIA,26,178,188,2
0.5,0.5,33.71666667,10/8/2017,2017,5,19,15,away,13,OAK,222,137,5,65,30,17,Win,143,108,0,3,1,BAL,47,365,245,0
0.5,0.5,26.28333333,10/8/2017,2017,5,15,19,home,-13,BAL,137,222,24,54,17,30,Loss,108,143,3,0,0,OAK,47,245,365,1
0.470588235,0.533333333,31.26666667,10/8/2017,2017,5,15,21,away,6,LAR,179,275,40,66,16,10,Win,62,100,3,2,5,SEA,26,241,375,2
0.533333333,0.470588235,28.73333333,10/8/2017,2017,5,21,15,home,-6,SEA,275,179,45,71,10,16,Loss,100,62,2,3,2,LAR,26,375,241,5
0.428571429,0.583333333,24.9,10/8/2017,2017,5,25,26,away,4,DAL,182,245,38,58,35,31,Win,160,163,4,1,3,GBP,66,342,408,1
0.583333333,0.428571429,35.1,10/8/2017,2017,5,26,25,home,-4,GBP,245,182,70,72,31,35,Loss,163,160,1,4,1,DAL,66,408,342,3
0.5625,0.3,38.28333333,10/8/2017,2017,5,29,20,away,8,HOU,323,248,64,73,42,34,Win,127,144,1,3,1,KCC,76,450,392,0
0.3,0.5625,21.71666667,10/8/2017,2017,5,20,29,home,-8,KCC,248,323,59,57,34,42,Loss,144,127,3,1,0,HOU,76,392,450,1
0.4,0.25,31.4,10/9/2017,2017,5,17,16,away,3,CHI,141,159,69,67,20,17,Win,159,115,4,1,2,MIN,37,300,274,0
0.25,0.4,28.6,10/9/2017,2017,5,16,17,home,-3,MIN,159,141,55,56,17,20,Loss,115,159,1,4,0,CHI,37,274,300,2
0.357142857,0.25,28.56666667,10/12/2017,2017,6,15,23,away,5,CAR,209,225,126,60,28,23,Win,101,80,3,2,3,PHI,51,310,305,1
0.25,0.357142857,31.43333333,10/12/2017,2017,6,23,15,home,-5,PHI,225,209,1,79,23,28,Loss,80,101,2,3,1,CAR,51,305,310,3
0.416666667,0.545454545,34.4,10/15/2017,2017,6,20,19,away,3,ATL,151,239,42,64,20,17,Win,138,100,0,2,1,MIA,37,289,339,1
0.545454545,0.416666667,25.6,10/15/2017,2017,6,19,20,home,-3,MIA,239,151,73,56,17,20,Loss,100,138,2,0,1,ATL,37,339,289,1
0.294117647,0.166666667,36.75,10/15/2017,2017,6,18,16,away,3,BAL,111,166,44,75,3,0,Win,231,125,4,3,3,CHI,3,342,291,2
0.166666667,0.294117647,31.15,10/15/2017,2017,6,16,18,home,-3,CHI,166,111,69,70,0,3,Loss,125,231,3,4,2,BAL,3,291,342,3
0.214285714,0.384615385,30.9,10/15/2017,2017,6,16,18,away,-16,HOU,113,217,72,63,17,33,Loss,134,123,4,1,1,CLE,50,247,340,3
0.384615385,0.214285714,29.1,10/15/2017,2017,6,18,16,home,16,CLE,217,113,44,63,33,17,Win,123,134,1,4,3,HOU,50,340,247,1
0.5,0.166666667,27.81666667,10/15/2017,2017,6,18,19,away,-14,NOS,281,186,46,76,38,52,Loss,66,193,5,0,3,DET,90,347,379,5
0.166666667,0.5,32.18333333,10/15/2017,2017,6,19,18,home,14,DET,186,281,118,67,52,38,Win,193,66,0,5,5,NOS,90,379,347,3
0.235294118,0.333333333,27.85,10/15/2017,2017,6,14,24,away,-13,MIN,155,239,92,65,10,23,Loss,72,112,4,0,2,GBP,33,227,351,3
0.333333333,0.235294118,32.15,10/15/2017,2017,6,24,14,home,13,GBP,239,155,65,70,23,10,Win,112,72,0,4,3,MIN,33,351,227,2
0.538461538,0.529411765,26.33333333,10/15/2017,2017,6,23,23,away,7,NYJ,257,334,45,63,24,17,Win,118,74,0,4,3,NEP,41,375,408,2
0.529411765,0.538461538,33.66666667,10/15/2017,2017,6,23,23,home,-7,NEP,334,257,69,75,17,24,Loss,74,118,4,0,2,NYJ,41,408,375,3
0.352941176,0.5,23.13333333,10/15/2017,2017,6,21,25,away,-2,WAS,250,325,40,70,24,26,Loss,85,94,3,1,2,SFO,50,335,419,1
0.5,0.352941176,36.86666667,10/15/2017,2017,6,25,21,home,2,SFO,325,250,43,71,26,24,Win,94,85,1,3,1,WAS,50,419,335,2
0.5,0.444444444,27.61666667,10/15/2017,2017,6,21,23,away,-5,ARI,344,272,49,64,33,38,Loss,70,160,2,2,2,TBB,71,414,432,2
0.444444444,0.5,32.38333333,10/15/2017,2017,6,23,21,home,5,TBB,272,344,61,59,38,33,Win,160,70,2,2,2,ARI,71,432,414,2
0.307692308,0.266666667,28.01666667,10/15/2017,2017,6,12,19,away,10,JAX,107,220,70,56,27,17,Win,142,169,3,5,1,LAR,44,249,389,1
0.266666667,0.307692308,31.98333333,10/15/2017,2017,6,19,12,home,-10,LAR,220,107,40,66,17,27,Loss,169,142,5,3,1,JAX,44,389,249,1
0.363636364,0.272727273,36.65,10/15/2017,2017,6,23,12,away,6,KCC,245,223,57,63,19,13,Win,194,28,1,3,0,PIT,32,439,251,1
0.272727273,0.363636364,23.35,10/15/2017,2017,6,12,23,home,-6,PIT,223,245,48,52,13,19,Loss,28,194,3,1,1,KCC,32,251,439,0
0.428571429,0.5,32.05,10/15/2017,2017,6,20,15,away,1,OAK,263,165,32,65,17,16,Win,80,109,1,1,2,LAC,33,343,274,1
0.5,0.428571429,27.95,10/15/2017,2017,6,15,20,home,-1,LAC,165,263,40,53,16,17,Loss,109,80,1,1,1,OAK,33,274,343,2
0.285714286,0.294117647,30.6,10/15/2017,2017,6,12,20,away,13,DEN,118,366,77,54,23,10,Win,148,46,3,4,3,NYG,33,266,412,0
0.294117647,0.285714286,29.4,10/15/2017,2017,6,20,12,home,-13,NYG,366,118,46,75,10,23,Loss,46,148,4,3,0,DEN,33,412,266,3
0.222222222,0.461538462,24.11666667,10/16/2017,2017,6,18,25,away,-14,TEN,212,305,51,57,22,36,Loss,85,168,1,1,1,IND,58,297,473,1
0.461538462,0.222222222,35.88333333,10/16/2017,2017,6,25,18,home,14,IND,305,212,45,67,36,22,Win,168,85,1,1,1,TEN,58,473,297,1
0.533333333,0.461538462,30.6,10/19/2017,2017,7,19,32,away,-1,OAK,331,417,108,60,30,31,Loss,94,88,1,0,0,KCC,61,425,505,0
0.461538462,0.533333333,29.4,10/19/2017,2017,7,32,19,home,1,KCC,417,331,97,73,31,30,Win,88,94,0,1,0,OAK,61,505,425,0
0.25,0.684210526,20.98333333,10/22/2017,2017,7,10,28,away,-33,LAR,171,228,65,47,0,33,Loss,25,197,3,1,1,ARI,33,196,425,2
0.684210526,0.25,39.01666667,10/22/2017,2017,7,28,10,home,33,ARI,228,171,45,78,33,0,Win,197,25,1,3,2,LAR,33,425,196,1
0.375,0.466666667,27.98333333,10/22/2017,2017,7,16,17,away,-8,MIN,144,188,15,64,16,24,Loss,64,169,5,0,1,BAL,40,208,357,0
0.466666667,0.375,32.01666667,10/22/2017,2017,7,17,16,home,8,BAL,188,144,47,64,24,16,Win,169,64,0,5,0,MIN,40,357,208,1
0.545454545,0.625,33.16666667,10/22/2017,2017,7,27,23,away,-3,BUF,378,261,55,70,27,30,Loss,69,173,1,1,1,TBB,57,447,434,3
0.625,0.545454545,26.83333333,10/22/2017,2017,7,23,27,home,3,TBB,261,378,35,67,30,27,Win,173,69,1,1,3,BUF,57,434,447,1
0.4,0.181818182,38.58333333,10/22/2017,2017,7,20,5,away,-14,CHI,185,85,35,69,3,17,Loss,108,68,5,4,0,CAR,20,293,153,3
0.181818182,0.4,21.41666667,10/22/2017,2017,7,5,20,home,14,CAR,85,185,40,37,17,3,Win,68,108,4,5,3,CHI,20,153,293,0
0.294117647,0.230769231,35.38333333,10/22/2017,2017,7,16,19,away,3,CLE,189,218,35,68,3,0,Win,80,66,2,2,3,TEN,3,269,284,1
0.230769231,0.294117647,32.7,10/22/2017,2017,7,19,16,home,-3,TEN,218,189,81,67,0,3,Loss,66,80,2,2,1,CLE,3,284,269,3
0.533333333,0.363636364,36.93333333,10/22/2017,2017,7,25,16,away,9,GBP,324,79,80,75,26,17,Win,161,181,1,1,1,NOS,43,485,260,2
0.363636364,0.533333333,23.06666667,10/22/2017,2017,7,16,25,home,-9,NOS,79,324,54,50,17,26,Loss,181,161,1,1,2,GBP,43,260,485,1
0.571428571,0.333333333,32.78333333,10/22/2017,2017,7,23,15,away,27,IND,330,136,34,65,27,0,Win,188,96,1,10,0,JAX,27,518,232,2
0.333333333,0.571428571,27.21666667,10/22/2017,2017,7,15,23,home,-27,JAX,136,330,55,67,0,27,Loss,96,188,10,1,2,IND,27,232,518,0
0.363636364,0.384615385,28.03333333,10/22/2017,2017,7,16,25,away,-3,MIA,180,304,124,52,28,31,Loss,92,53,3,3,2,NYJ,59,272,357,2
0.384615385,0.363636364,31.96666667,10/22/2017,2017,7,25,16,home,3,NYJ,304,180,76,65,31,28,Win,53,92,3,3,2,MIA,59,357,272,2
0.636363636,0.461538462,32.83333333,10/22/2017,2017,7,27,23,away,30,SFO,236,187,36,70,40,10,Win,265,103,0,5,3,DAL,50,501,290,0
0.461538462,0.636363636,27.16666667,10/22/2017,2017,7,23,27,home,-30,DAL,187,236,22,65,10,40,Loss,103,265,5,0,0,SFO,50,290,501,3
0.272727273,0.181818182,24.75,10/22/2017,2017,7,11,21,away,-15,PIT,108,268,54,51,14,29,Loss,71,152,4,0,0,CIN,43,179,420,2
0.181818182,0.272727273,35.25,10/22/2017,2017,7,21,11,home,15,CIN,268,108,5,68,29,14,Win,152,71,0,4,2,PIT,43,420,179,0
0.214285714,0.25,31.06666667,10/22/2017,2017,7,12,14,away,-21,LAC,182,162,68,59,0,21,Loss,69,80,5,3,0,DEN,21,251,242,3
0.25,0.214285714,28.93333333,10/22/2017,2017,7,14,12,home,21,DEN,162,182,81,55,21,0,Win,80,69,3,5,3,LAC,21,242,251,0
0.461538462,0.166666667,35.43333333,10/22/2017,2017,7,26,14,away,17,NYG,321,131,110,71,24,7,Win,104,46,1,1,1,SEA,31,425,177,1
0.166666667,0.461538462,24.56666667,10/22/2017,2017,7,14,26,home,-17,SEA,131,321,28,57,7,24,Loss,46,104,1,1,1,NYG,31,177,425,1
0.222222222,0.538461538,25.91666667,10/22/2017,2017,7,21,25,away,-16,NEP,223,241,40,56,7,23,Loss,120,162,1,2,0,ATL,30,343,403,0
0.538461538,0.222222222,34.08333333,10/22/2017,2017,7,25,21,home,16,ATL,241,223,65,67,23,7,Win,162,120,2,1,0,NEP,30,403,343,0
0.333333333,0.5,30.25,10/23/2017,2017,7,19,23,away,-10,PHI,269,244,55,62,24,34,Loss,75,127,4,3,1,WAS,58,344,371,1
0.5,0.333333333,29.75,10/23/2017,2017,7,23,19,home,10,WAS,244,269,55,61,34,24,Win,127,75,3,4,1,PHI,58,371,344,1
0.266666667,0.230769231,28.76666667,10/26/2017,2017,8,13,19,away,-40,BAL,151,121,43,66,0,40,Loss,45,174,3,0,0,MIA,40,196,295,2
0.230769231,0.266666667,31.23333333,10/26/2017,2017,8,19,13,home,40,MIA,121,151,40,62,40,0,Win,174,45,0,3,2,BAL,40,295,196,0
0.375,0.307692308,37.86666667,10/29/2017,2017,8,26,16,away,17,CLE,287,161,58,78,33,16,Win,88,115,1,3,2,MIN,49,375,276,1
0.307692308,0.375,22.13333333,10/29/2017,2017,8,16,26,home,-17,MIN,161,287,74,59,16,33,Loss,115,88,3,1,1,CLE,49,276,375,2
0.357142857,0.333333333,28.31666667,10/29/2017,2017,8,18,15,away,5,NYJ,246,236,68,62,25,20,Win,140,43,1,3,1,ATL,45,386,279,2
0.333333333,0.357142857,31.68333333,10/29/2017,2017,8,15,18,home,-5,ATL,236,246,50,58,20,25,Loss,43,140,3,1,2,NYJ,45,279,386,1
0.3,0.4,24.38333333,10/29/2017,2017,8,23,17,away,-20,BUF,313,165,50,63,14,34,Loss,54,166,0,0,0,OAK,48,367,331,4
0.4,0.3,35.61666667,10/29/2017,2017,8,17,23,home,20,OAK,165,313,95,64,34,14,Win,166,54,0,0,4,BUF,48,331,367,0
0.470588235,0.166666667,32.18333333,10/29/2017,2017,8,14,16,away,14,TBB,154,194,51,63,17,3,Win,100,85,0,3,3,CAR,20,254,279,1
0.166666667,0.470588235,27.81666667,10/29/2017,2017,8,16,14,home,-14,CAR,194,154,55,63,3,17,Loss,85,100,3,0,1,TBB,20,279,254,3
0.470588235,0.222222222,28.61666667,10/29/2017,2017,8,17,19,away,-8,NOS,150,286,31,65,12,20,Loss,157,101,2,2,2,CHI,32,307,387,1
0.222222222,0.470588235,31.38333333,10/29/2017,2017,8,19,17,home,8,CHI,286,150,51,60,20,12,Win,101,157,2,2,1,NOS,32,387,307,2
0.5,0.363636364,33.21666667,10/29/2017,2017,8,19,17,away,-1,CIN,216,218,45,71,23,24,Loss,115,58,4,3,2,IND,47,331,276,1
0.363636364,0.5,26.78333333,10/29/2017,2017,8,17,19,home,1,IND,218,216,54,53,24,23,Win,58,115,3,4,1,CIN,47,276,331,2
0.3,0.473684211,23.01666667,10/29/2017,2017,8,16,27,away,-8,NEP,192,317,77,52,13,21,Loss,157,97,1,3,0,LAC,34,349,414,1
0.473684211,0.3,36.98333333,10/29/2017,2017,8,27,16,home,8,LAC,317,192,80,82,21,13,Win,97,157,3,1,1,NEP,34,414,349,0
0.2,0.285714286,27.05,10/29/2017,2017,8,14,19,away,-23,PHI,144,192,69,64,10,33,Loss,94,112,4,3,1,SFO,43,238,304,2
0.285714286,0.2,32.95,10/29/2017,2017,8,19,14,home,23,SFO,192,144,35,66,33,10,Win,112,94,3,4,2,PHI,43,304,238,1
0.2,0.416666667,30.36666667,10/29/2017,2017,8,25,21,away,-3,SEA,367,446,93,69,38,41,Loss,142,33,5,2,1,HOU,79,509,479,3
0.416666667,0.2,29.63333333,10/29/2017,2017,8,21,25,home,3,HOU,446,367,120,64,41,38,Win,33,142,2,5,3,SEA,79,479,509,1
0.357142857,0.307692308,33.31666667,10/29/2017,2017,8,18,16,away,14,WAS,138,236,89,63,33,19,Win,169,49,2,4,3,DAL,52,307,285,1
0.307692308,0.357142857,26.68333333,10/29/2017,2017,8,16,18,home,-14,DAL,236,138,32,58,19,33,Loss,49,169,4,2,1,WAS,52,285,307,3
0.5,0.166666667,28.38333333,10/29/2017,2017,8,17,21,away,5,DET,317,411,37,60,20,15,Win,75,71,0,2,1,PIT,35,392,482,2
0.166666667,0.5,31.61666667,10/29/2017,2017,8,21,17,home,-5,PIT,411,317,57,69,15,20,Loss,71,75,2,0,2,DET,35,482,392,1
0.384615385,0.166666667,31.38333333,10/30/2017,2017,8,23,16,away,-10,KCC,187,197,53,70,19,29,Loss,177,79,3,1,2,DEN,48,364,276,5
0.166666667,0.384615385,28.61666667,10/30/2017,2017,8,16,23,home,10,DEN,197,187,69,59,29,19,Win,79,177,1,3,5,KCC,48,276,364,2
0.375,0.428571429,26.5,11/2/2017,2017,9,21,21,away,-13,NYJ,244,137,99,69,21,34,Loss,63,194,7,1,0,BUF,55,307,331,3
0.428571429,0.375,33.5,11/2/2017,2017,9,21,21,home,13,BUF,137,244,66,62,34,21,Win,194,63,1,7,3,NYJ,55,331,307,0
0.333333333,0.307692308,27.13333333,11/5/2017,2017,9,17,20,away,-3,CAR,302,129,70,58,17,20,Loss,53,201,2,1,2,ATL,37,355,330,1
0.307692308,0.333333333,32.86666667,11/5/2017,2017,9,20,17,home,3,ATL,129,302,29,63,20,17,Win,201,53,1,2,1,CAR,37,330,355,2
0.375,0.272727273,32.36666667,11/5/2017,2017,9,24,14,away,-3,TEN,268,186,39,77,20,23,Loss,73,71,2,3,1,BAL,43,341,257,2
0.272727273,0.375,27.63333333,11/5/2017,2017,9,14,24,home,3,BAL,186,268,39,52,23,20,Win,71,73,3,2,2,TEN,43,257,341,1
0.125,0.666666667,19.76666667,11/5/2017,2017,9,8,26,away,-16,JAX,119,259,77,37,7,23,Loss,29,149,2,0,1,CIN,30,148,408,0
0.666666667,0.125,40.23333333,11/5/2017,2017,9,26,8,home,16,CIN,259,119,50,78,23,7,Win,149,29,0,2,0,JAX,30,408,148,1
0.230769231,0.384615385,30.1,11/5/2017,2017,9,14,25,away,-28,PHI,191,222,105,60,23,51,Loss,35,197,3,2,1,DEN,74,226,419,2
0.384615385,0.230769231,29.9,11/5/2017,2017,9,25,14,home,28,DEN,222,191,35,67,51,23,Win,197,35,2,3,2,PHI,74,419,226,1
0.285714286,0.285714286,30.98333333,11/5/2017,2017,9,17,19,away,6,HOU,279,194,68,61,20,14,Win,92,94,3,2,1,IND,34,371,288,1
0.285714286,0.285714286,29.01666667,11/5/2017,2017,9,19,17,home,-6,IND,194,279,74,67,14,20,Loss,94,92,2,3,1,HOU,34,288,371,1
0.5,0.5,30.5,11/5/2017,2017,9,20,17,away,34,NYG,311,208,55,61,51,17,Win,162,111,0,2,3,LAR,68,473,319,0
0.5,0.5,29.5,11/5/2017,2017,9,17,20,home,-34,LAR,208,311,52,66,17,51,Loss,111,162,2,0,0,NYG,68,319,473,3
0.307692308,0.538461538,27.7,11/5/2017,2017,9,14,21,away,-20,NOS,113,256,50,57,10,30,Loss,87,151,4,1,2,TBB,40,200,407,1
0.538461538,0.307692308,32.3,11/5/2017,2017,9,21,14,home,20,TBB,256,113,28,60,30,10,Win,151,87,1,4,1,NOS,40,407,200,2
0.4375,0.352941176,36.36666667,11/5/2017,2017,9,20,17,away,10,SFO,201,266,25,73,20,10,Win,167,63,0,5,2,ARI,30,368,329,2
0.352941176,0.4375,23.63333333,11/5/2017,2017,9,17,20,home,-10,ARI,266,201,53,73,10,20,Loss,63,167,5,0,2,SFO,30,329,368,2
0.307692308,0.357142857,27.68333333,11/5/2017,2017,9,16,22,away,3,SEA,193,289,62,60,17,14,Win,51,148,6,2,2,WAS,31,244,437,1
0.357142857,0.307692308,32.31666667,11/5/2017,2017,9,22,16,home,-3,WAS,289,193,138,75,14,17,Loss,148,51,2,6,1,SEA,31,437,244,2
0.363636364,0.583333333,28.71666667,11/5/2017,2017,9,17,24,away,-11,DAL,255,244,52,55,17,28,Loss,68,131,2,1,0,KCC,45,323,375,1
0.583333333,0.363636364,31.28333333,11/5/2017,2017,9,24,17,home,11,KCC,244,255,65,65,28,17,Win,131,68,1,2,1,DAL,45,375,323,0
0.533333333,0.416666667,30.93333333,11/5/2017,2017,9,20,23,away,3,MIA,295,309,105,58,27,24,Win,84,86,1,1,1,OAK,51,379,395,2
0.416666667,0.533333333,29.06666667,11/5/2017,2017,9,23,20,home,-3,OAK,309,295,107,61,24,27,Loss,86,84,1,1,2,MIA,51,395,379,1
0.615384615,0.222222222,36.91666667,11/6/2017,2017,9,24,21,away,13,GBP,353,233,19,67,30,17,Win,64,78,1,3,0,DET,47,417,311,1
0.222222222,0.615384615,23.08333333,11/6/2017,2017,9,21,24,home,-13,DET,233,353,20,58,17,30,Loss,78,64,3,1,1,GBP,47,311,417,0
0.230769231,0.4,30.88333333,11/9/2017,2017,10,14,24,away,6,ARI,212,256,108,60,22,16,Win,75,34,5,2,1,SEA,38,287,290,0
0.4,0.230769231,29.11666667,11/9/2017,2017,10,24,14,home,-6,SEA,256,212,58,73,16,22,Loss,34,75,2,5,0,ARI,38,290,287,1
0.5,0.181818182,41.38333333,11/12/2017,2017,10,32,10,away,37,BUF,184,129,41,73,47,10,Win,298,69,0,2,1,NOS,57,482,198,1
0.181818182,0.5,18.61666667,11/12/2017,2017,10,10,32,home,-37,NOS,129,184,56,45,10,47,Loss,69,298,2,0,1,BUF,57,198,482,1
0.4375,0.285714286,33.88333333,11/12/2017,2017,10,18,14,away,7,CHI,182,268,35,65,23,16,Win,160,55,3,5,1,GBP,39,342,323,0
0.285714286,0.4375,26.11666667,11/12/2017,2017,10,14,18,home,-7,GBP,268,182,78,57,16,23,Loss,55,160,5,3,0,CHI,39,323,342,1
0.1,0.466666667,19.85,11/12/2017,2017,10,15,27,away,-4,TEN,255,236,84,50,20,24,Loss,53,180,1,4,2,CIN,44,308,416,2
0.466666667,0.1,40.15,11/12/2017,2017,10,27,15,home,4,CIN,236,255,55,84,24,20,Win,180,53,4,1,2,TEN,44,416,308,2
0.333333333,0.454545455,34.56666667,11/12/2017,2017,10,26,16,away,-14,DET,212,241,60,77,24,38,Loss,201,104,4,4,1,CLE,62,413,345,2
0.454545455,0.333333333,25.43333333,11/12/2017,2017,10,16,26,home,14,CLE,241,212,81,49,38,24,Win,104,201,4,4,2,DET,62,345,413,1
0.384615385,0.4,29.96666667,11/12/2017,2017,10,18,13,away,3,IND,228,196,70,62,20,17,Win,88,71,1,3,1,PIT,37,316,267,1
0.4,0.384615385,30.03333333,11/12/2017,2017,10,13,18,home,-3,PIT,196,228,82,56,17,20,Loss,71,88,3,1,1,IND,37,267,316,1
0.2,0.277777778,31.78333333,11/12/2017,2017,10,16,20,away,-3,JAX,235,263,77,67,0,3,Loss,87,135,0,3,2,LAC,3,322,398,2
0.277777778,0.2,35.01666667,11/12/2017,2017,10,20,16,home,3,LAC,263,235,106,81,3,0,Win,135,87,3,0,2,JAX,3,398,322,2
0.666666667,0.357142857,28.9,11/12/2017,2017,10,21,24,away,8,WAS,304,313,40,60,38,30,Win,102,81,0,1,1,MIN,68,406,394,2
0.357142857,0.666666667,31.1,11/12/2017,2017,10,24,21,home,-8,MIN,313,304,15,73,30,38,Loss,81,102,1,0,2,WAS,68,394,406,1
0.2,0.4375,28.1,11/12/2017,2017,10,15,17,away,-5,TBB,219,181,77,64,10,15,Loss,56,90,6,1,1,NYJ,25,275,271,2
0.4375,0.2,31.9,11/12/2017,2017,10,17,15,home,5,NYJ,181,219,50,66,15,10,Win,90,56,1,6,2,TBB,25,271,275,1
0.333333333,0.375,28.48333333,11/12/2017,2017,10,17,19,away,-26,LAR,194,339,60,64,7,33,Loss,89,104,3,3,0,HOU,40,283,443,4
0.375,0.333333333,31.51666667,11/12/2017,2017,10,19,17,home,26,HOU,339,194,86,66,33,7,Win,104,89,3,3,4,LAR,40,443,283,0
0.454545455,0.538461538,27.9,11/12/2017,2017,10,18,22,away,-20,ATL,126,204,54,59,7,27,Loss,107,132,8,1,1,DAL,34,233,336,2
0.538461538,0.454545455,32.1,11/12/2017,2017,10,22,18,home,20,DAL,204,126,35,64,27,7,Win,132,107,1,8,2,ATL,34,336,233,1
0.357142857,0.666666667,31,11/12/2017,2017,10,19,21,away,-10,SFO,260,288,35,63,21,31,Loss,114,186,3,0,2,NYG,52,374,474,1
0.666666667,0.357142857,29,11/12/2017,2017,10,21,19,home,10,NYG,288,260,44,58,31,21,Win,186,114,0,3,1,SFO,52,474,374,2
0.363636364,0.533333333,29.71666667,11/12/2017,2017,10,28,17,away,25,DEN,297,221,5,67,41,16,Win,99,118,1,0,2,NEP,57,396,339,0
0.533333333,0.363636364,30.28333333,11/12/2017,2017,10,17,28,home,-25,NEP,221,297,28,61,16,41,Loss,118,99,0,1,0,DEN,57,339,396,2
0.583333333,0.785714286,24.35,11/13/2017,2017,10,17,30,away,-24,CAR,213,254,57,54,21,45,Loss,100,294,0,0,0,MIA,66,313,548,1
0.785714286,0.583333333,35.65,11/13/2017,2017,10,30,17,home,24,MIA,254,213,37,71,45,21,Win,294,100,0,0,1,CAR,66,548,313,0
0.384615385,0.333333333,28.33333333,11/16/2017,2017,11,17,25,away,-23,PIT,264,284,65,60,17,40,Loss,52,65,5,3,0,TEN,57,316,349,4
0.333333333,0.384615385,31.66666667,11/16/2017,2017,11,25,17,home,23,TEN,284,264,61,69,40,17,Win,65,52,3,5,4,PIT,57,349,316,0
0.230769231,0.461538462,31.81666667,11/19/2017,2017,11,19,18,away,10,MIA,268,365,82,62,30,20,Win,53,83,1,1,5,TBB,50,321,448,0
0.461538462,0.230769231,28.18333333,11/19/2017,2017,11,18,19,home,-10,TBB,365,268,123,60,20,30,Loss,83,53,1,1,0,MIA,50,448,321,5
0.3,0.533333333,26.23333333,11/19/2017,2017,11,17,22,away,-10,HOU,244,223,90,54,21,31,Loss,48,134,2,1,2,ARI,52,292,357,2
0.533333333,0.3,33.76666667,11/19/2017,2017,11,22,17,home,10,ARI,223,244,42,67,31,21,Win,134,48,1,2,2,HOU,52,357,292,2
0.214285714,0.307692308,30.05,11/19/2017,2017,11,14,16,away,23,GBP,161,190,30,57,23,0,Win,58,75,3,6,5,BAL,23,219,265,1
0.307692308,0.214285714,29.95,11/19/2017,2017,11,16,14,home,-23,BAL,190,161,53,67,0,23,Loss,75,58,6,3,1,GBP,23,265,219,5
0.3,0.333333333,30.6,11/19/2017,2017,11,20,25,away,3,CHI,287,176,49,58,27,24,Win,65,222,3,1,1,DET,51,352,398,1
0.333333333,0.3,29.4,11/19/2017,2017,11,25,20,home,-3,DET,176,287,64,61,24,27,Loss,222,65,1,3,1,CHI,51,398,352,1
0.3,0.230769231,36.91666667,11/19/2017,2017,11,15,11,away,12,CLE,145,134,40,76,19,7,Win,139,50,2,5,5,JAX,26,284,184,1
0.230769231,0.3,23.08333333,11/19/2017,2017,11,11,15,home,-12,JAX,134,145,0,55,7,19,Loss,50,139,5,2,1,CLE,26,184,284,5
0.272727273,0.230769231,37.26666667,11/19/2017,2017,11,22,20,away,-3,NYG,229,205,87,71,0,3,Loss,134,112,1,0,1,KCC,3,363,317,3
0.230769231,0.272727273,30.83333333,11/19/2017,2017,11,20,22,home,3,KCC,205,229,48,68,3,0,Win,112,134,0,1,3,NYG,3,317,363,1
0.272727273,0.5,22.63333333,11/19/2017,2017,11,15,27,away,-17,MIN,209,280,60,56,7,24,Loss,45,171,2,0,0,LAR,31,254,451,1
0.5,0.272727273,37.36666667,11/19/2017,2017,11,27,15,home,17,LAR,280,209,65,73,24,7,Win,171,45,0,2,1,MIN,31,451,254,0
0.333333333,0.333333333,32.18333333,11/19/2017,2017,11,24,27,away,-3,NOS,300,375,67,67,0,3,Loss,156,160,2,2,1,WAS,3,456,535,0
0.333333333,0.333333333,30.4,11/19/2017,2017,11,27,24,home,3,WAS,375,300,54,66,3,0,Win,160,156,2,2,0,NOS,3,535,456,1
0.428571429,0.5,23.91666667,11/19/2017,2017,11,18,28,away,-30,LAC,220,283,48,62,24,54,Loss,173,146,1,1,0,BUF,78,393,429,6
0.5,0.428571429,36.08333333,11/19/2017,2017,11,28,18,home,30,BUF,283,220,13,73,54,24,Win,146,173,1,1,6,LAC,78,429,393,0
0.466666667,0.571428571,24.81666667,11/19/2017,2017,11,12,20,away,3,DEN,141,229,14,53,20,17,Win,49,112,2,3,2,CIN,37,190,341,0
0.571428571,0.466666667,35.18333333,11/19/2017,2017,11,20,12,home,-3,CIN,229,141,50,79,17,20,Loss,112,49,3,2,0,DEN,37,341,190,2
0.5,0.466666667,27.61666667,11/19/2017,2017,11,25,21,away,25,OAK,332,235,10,58,33,8,Win,89,109,1,1,2,NEP,41,421,344,0
0.466666667,0.5,32.38333333,11/19/2017,2017,11,21,25,home,-25,NEP,235,332,66,71,8,33,Loss,109,89,1,1,0,OAK,41,344,421,2
0.357142857,0.214285714,29.48333333,11/19/2017,2017,11,17,14,away,28,DAL,168,113,30,60,37,9,Win,215,112,0,4,4,PHI,46,383,225,0
0.214285714,0.357142857,30.51666667,11/19/2017,2017,11,14,17,home,-28,PHI,113,168,10,63,9,37,Loss,112,215,4,0,0,DAL,46,225,383,4
0.642857143,0.416666667,30.35,11/20/2017,2017,11,22,26,away,3,SEA,190,224,69,58,34,31,Win,89,136,1,3,2,ATL,65,279,360,1
0.416666667,0.642857143,29.65,11/20/2017,2017,11,26,22,home,-3,ATL,224,190,106,69,31,34,Loss,136,89,3,1,1,SEA,65,360,279,2
0.461538462,0.272727273,34.95,11/23/2017,2017,12,28,17,away,7,DET,272,236,74,73,30,23,Win,136,53,2,3,2,MIN,53,408,289,0
0.272727273,0.461538462,25.05,11/23/2017,2017,12,17,28,home,-7,MIN,236,272,54,53,23,30,Loss,53,136,3,2,0,DET,53,289,408,2
0.642857143,0.545454545,36.08333333,11/23/2017,2017,12,25,14,away,22,DAL,434,168,56,66,28,6,Win,81,79,0,2,2,LAC,34,515,247,0
0.545454545,0.642857143,23.91666667,11/23/2017,2017,12,14,25,home,-22,LAC,168,434,60,49,6,28,Loss,79,81,2,0,0,DAL,34,247,515,2
0.142857143,0.266666667,25.38333333,11/23/2017,2017,12,7,17,away,-10,WAS,86,201,79,55,10,20,Loss,84,122,4,6,1,NYG,30,170,323,1
0.266666667,0.142857143,34.61666667,11/23/2017,2017,12,17,7,home,10,NYG,201,86,55,68,20,10,Win,122,84,6,4,1,WAS,30,323,170,1
0.363636364,0.785714286,29.9,11/26/2017,2017,12,27,23,away,-14,ATL,279,368,15,68,20,34,Loss,94,148,1,0,1,TBB,54,373,516,0
0.785714286,0.363636364,30.1,11/26/2017,2017,12,23,27,home,14,TBB,368,279,42,64,34,20,Win,148,94,0,1,0,ATL,54,516,373,1
0.352941176,0.153846154,33.3,11/26/2017,2017,12,17,14,away,6,KCC,164,181,50,68,16,10,Win,104,55,2,2,1,BUF,26,268,236,0
0.153846154,0.352941176,26.7,11/26/2017,2017,12,14,17,home,-6,BUF,181,164,50,57,10,16,Loss,55,104,2,2,0,KCC,26,236,268,1
0.214285714,0.357142857,31.83333333,11/26/2017,2017,12,17,21,away,8,NYJ,154,282,84,64,35,27,Win,145,109,3,3,1,CAR,62,299,391,0
0.357142857,0.214285714,28.16666667,11/26/2017,2017,12,21,17,home,-8,CAR,282,154,68,65,27,35,Loss,109,145,3,3,0,NYJ,62,391,299,1
0.230769231,0.4375,22.86666667,11/26/2017,2017,12,8,24,away,-28,PHI,134,244,56,49,3,31,Loss,6,176,2,1,3,CHI,34,140,420,2
0.4375,0.230769231,37.13333333,11/26/2017,2017,12,24,8,home,28,CHI,244,134,70,73,31,3,Win,176,6,1,2,2,PHI,34,420,140,3
0.4,0.4,29.46666667,11/26/2017,2017,12,21,23,away,-14,CIN,236,209,69,67,16,30,Loss,169,152,4,1,0,CLE,46,405,361,0
0.4,0.4,30.53333333,11/26/2017,2017,12,23,21,home,14,CLE,209,236,35,59,30,16,Win,152,169,1,4,0,CIN,46,361,405,0
0.375,0.428571429,28.63333333,11/26/2017,2017,12,19,15,away,4,IND,184,165,15,53,20,16,Win,92,89,0,8,1,TEN,36,276,254,2
0.428571429,0.375,31.36666667,11/26/2017,2017,12,15,19,home,-4,TEN,165,184,67,61,16,20,Loss,89,92,8,0,2,IND,36,254,276,1
0.181818182,0.416666667,27.31666667,11/26/2017,2017,12,15,25,away,-18,NEP,154,221,52,60,17,35,Loss,67,196,7,1,2,MIA,52,221,417,3
0.416666667,0.181818182,32.68333333,11/26/2017,2017,12,25,15,home,18,MIA,221,154,70,67,35,17,Win,196,67,1,7,3,NEP,52,417,221,2
0.384615385,0.3125,29.51666667,11/26/2017,2017,12,20,16,away,11,SFO,228,196,35,64,24,13,Win,90,84,0,3,1,SEA,37,318,280,1
0.3125,0.384615385,30.48333333,11/26/2017,2017,12,16,20,home,-11,SEA,196,228,74,67,13,24,Loss,84,90,3,0,1,SFO,37,280,318,1
0.083333333,0.411764706,25.35,11/26/2017,2017,12,19,20,away,-3,ARI,128,236,45,58,24,27,Loss,91,108,3,1,2,JAX,51,219,344,3
0.411764706,0.083333333,34.65,11/26/2017,2017,12,20,19,home,3,JAX,236,128,98,70,27,24,Win,108,91,1,3,3,ARI,51,344,219,2
0.357142857,0.384615385,24.1,11/26/2017,2017,12,12,21,away,-7,OAK,160,244,75,57,14,21,Loss,56,104,5,2,1,DEN,35,216,348,1
0.384615385,0.357142857,35.9,11/26/2017,2017,12,21,12,home,7,DEN,244,160,68,63,21,14,Win,104,56,2,5,1,OAK,35,348,216,1
0.230769231,0.214285714,24.56666667,11/26/2017,2017,12,14,24,away,-6,LAR,223,327,112,52,20,26,Loss,123,88,3,4,1,NOS,46,346,415,0
0.214285714,0.230769231,35.43333333,11/26/2017,2017,12,24,14,home,6,NOS,327,223,90,73,26,20,Win,88,123,4,3,0,LAR,46,415,346,1
0.461538462,0.615384615,26.4,11/26/2017,2017,12,15,28,away,-3,PIT,227,341,27,54,28,31,Loss,80,121,4,1,3,GBP,59,307,462,0
0.615384615,0.461538462,33.6,11/26/2017,2017,12,28,15,home,3,GBP,341,227,45,70,31,28,Win,121,80,1,4,0,PIT,59,462,307,3
0.428571429,0.214285714,30.26666667,11/27/2017,2017,12,20,17,away,-7,BAL,237,155,36,64,16,23,Loss,66,139,2,1,0,HOU,39,303,294,3
0.214285714,0.428571429,29.73333333,11/27/2017,2017,12,17,20,home,7,HOU,155,237,89,65,23,16,Win,139,66,1,2,3,BAL,39,294,303,0
0.428571429,0.5,27.53333333,11/30/2017,2017,13,15,21,away,-24,DAL,224,93,43,60,14,38,Loss,56,182,4,1,0,WAS,52,280,275,4
0.5,0.428571429,32.46666667,11/30/2017,2017,13,21,15,home,24,WAS,93,224,25,65,38,14,Win,182,56,1,4,4,DAL,52,275,280,0
0.5,0.1,34.03333333,12/3/2017,2017,13,22,15,away,5,ATL,207,173,51,63,14,9,Win,105,102,2,0,0,MIN,23,312,275,0
0.1,0.5,25.96666667,12/3/2017,2017,13,15,22,home,-5,MIN,173,207,55,51,9,14,Loss,102,105,0,2,0,ATL,23,275,312,0
0.307692308,0.416666667,30.15,12/3/2017,2017,13,18,24,away,-24,BAL,294,269,45,61,20,44,Loss,78,101,3,0,0,DET,64,372,370,3
0.416666667,0.307692308,29.85,12/3/2017,2017,13,24,18,home,24,DET,269,294,25,63,44,20,Win,101,78,0,3,3,BAL,64,370,372,0
0.416666667,0.384615385,34.01666667,12/3/2017,2017,13,23,16,away,20,BUF,244,85,66,68,23,3,Win,191,183,3,4,1,NEP,26,435,268,1
0.384615385,0.416666667,25.98333333,12/3/2017,2017,13,16,23,home,-20,NEP,85,244,34,64,3,23,Loss,183,191,4,3,1,BUF,26,268,435,1
0.555555556,0.5,38.78333333,12/3/2017,2017,13,23,8,away,1,CHI,278,85,53,73,15,14,Win,110,62,2,2,0,SFO,29,388,147,1
0.5,0.555555556,21.21666667,12/3/2017,2017,13,8,23,home,-1,SFO,85,278,29,36,14,15,Loss,62,110,2,2,1,CHI,29,147,388,0
0.076923077,0.266666667,25.63333333,12/3/2017,2017,13,14,15,away,-26,MIA,167,222,57,67,9,35,Loss,103,145,3,2,3,DEN,44,270,367,3
0.266666667,0.076923077,34.36666667,12/3/2017,2017,13,15,14,home,26,DEN,222,167,85,64,35,9,Win,145,103,2,3,3,MIA,44,367,270,3
0.5625,0.416666667,37.28333333,12/3/2017,2017,13,25,16,away,-6,GBP,230,77,74,74,0,6,Loss,165,199,7,2,1,TBB,6,395,276,1
0.416666667,0.5625,26.73333333,12/3/2017,2017,13,16,25,home,6,TBB,77,230,47,53,6,0,Win,199,165,2,7,1,GBP,6,276,395,1
0.5,0.454545455,33.81666667,12/3/2017,2017,13,24,19,away,-11,TEN,331,146,85,75,13,24,Loss,53,198,4,2,1,HOU,37,384,344,1
0.454545455,0.5,26.18333333,12/3/2017,2017,13,19,24,home,11,HOU,146,331,63,50,24,13,Win,198,53,2,4,1,TEN,37,344,384,1
0.333333333,0.6,26.21666667,12/3/2017,2017,13,17,22,away,-20,JAX,149,330,31,66,10,30,Loss,141,96,4,1,0,IND,40,290,426,2
0.6,0.333333333,33.78333333,12/3/2017,2017,13,22,17,home,20,IND,330,149,55,64,30,10,Win,96,141,1,4,2,JAX,40,426,290,0
0.375,0.65,17.18333333,12/3/2017,2017,13,17,30,away,-7,NYJ,362,331,30,46,31,38,Loss,112,157,2,0,0,KCC,69,474,488,0
0.65,0.375,42.81666667,12/3/2017,2017,13,30,17,home,7,KCC,331,362,40,85,38,31,Win,157,112,0,2,0,NYJ,69,488,474,0
0.454545455,0.533333333,25.05,12/3/2017,2017,13,17,23,away,-9,LAC,202,335,24,57,10,19,Loss,89,94,3,1,0,CLE,29,291,429,2
0.533333333,0.454545455,34.95,12/3/2017,2017,13,23,17,home,9,CLE,335,202,62,69,19,10,Win,94,89,1,3,2,LAC,29,429,291,0
0.272727273,0.466666667,28.96666667,12/3/2017,2017,13,18,19,away,16,ARI,213,187,36,56,32,16,Win,90,118,1,7,2,LAR,48,303,305,1
0.466666667,0.272727273,31.03333333,12/3/2017,2017,13,19,18,home,-16,LAR,187,213,25,62,16,32,Loss,118,90,7,1,1,ARI,48,305,303,2
0.3,0.4,26.65,12/3/2017,2017,13,16,19,away,-10,NOS,167,252,54,53,21,31,Loss,112,148,2,2,1,CAR,52,279,400,1
0.4,0.3,33.35,12/3/2017,2017,13,19,16,home,10,CAR,252,167,68,64,31,21,Win,148,112,2,2,1,NOS,52,400,279,1
0.357142857,0.4,28.68333333,12/3/2017,2017,13,15,18,away,-7,OAK,200,282,5,61,17,24,Loss,65,119,3,1,1,NYG,41,265,401,2
0.4,0.357142857,31.31666667,12/3/2017,2017,13,18,15,home,7,NYG,282,200,42,66,24,17,Win,119,65,1,3,2,OAK,41,401,265,1
0.5,0.5,31.9,12/3/2017,2017,13,25,20,away,-14,SEA,327,209,64,74,10,24,Loss,98,101,3,2,0,PHI,34,425,310,2
0.5,0.5,28.1,12/3/2017,2017,13,20,25,home,14,PHI,209,327,46,58,24,10,Win,101,98,2,3,2,SEA,34,310,425,0
0.333333333,0.5,29.81666667,12/4/2017,2017,13,24,19,away,3,CIN,282,223,66,63,23,20,Win,92,130,1,2,0,PIT,43,374,353,1
0.5,0.333333333,30.18333333,12/4/2017,2017,13,19,24,home,-3,PIT,223,282,173,60,20,23,Loss,130,92,2,1,1,CIN,43,353,374,0
0.3,0.583333333,25.31666667,12/7/2017,2017,14,18,26,away,-3,ATL,256,211,82,52,17,20,Loss,50,132,2,1,3,NOS,37,306,343,1
0.583333333,0.3,34.68333333,12/7/2017,2017,14,26,18,home,3,NOS,211,256,35,65,20,17,Win,132,50,1,2,1,ATL,37,343,306,3
0.25,0.555555556,36.03333333,12/10/2017,2017,14,16,14,away,-6,BUF,64,92,20,69,0,6,Loss,163,227,1,0,2,IND,6,227,319,0
0.555555556,0.25,32.41666667,12/10/2017,2017,14,14,16,home,6,IND,92,64,10,67,6,0,Win,227,163,0,1,0,BUF,6,319,227,2
0.466666667,0.333333333,28.7,12/10/2017,2017,14,21,15,away,-7,CAR,256,129,30,71,24,31,Loss,100,216,6,2,1,MIN,55,356,345,3
0.333333333,0.466666667,31.3,12/10/2017,2017,14,15,21,home,7,MIN,129,256,48,63,31,24,Win,216,100,2,6,3,CAR,55,345,356,1
0.363636364,0.25,38.15,12/10/2017,2017,14,29,14,away,26,CIN,250,164,74,72,33,7,Win,232,70,2,3,2,CHI,40,482,234,0
0.25,0.363636364,21.85,12/10/2017,2017,14,14,29,home,-26,CHI,164,250,56,53,7,33,Loss,70,232,3,2,0,CIN,40,234,482,2
0.5,0.538461538,36.28333333,12/10/2017,2017,14,24,17,away,6,CLE,256,209,20,74,6,0,Win,85,136,1,2,2,GBP,6,341,345,0
0.538461538,0.5,28.63333333,12/10/2017,2017,14,17,24,home,-6,GBP,209,256,45,57,0,6,Loss,136,85,2,1,0,CLE,6,345,341,2
0.5,0.375,27.11666667,12/10/2017,2017,14,19,21,away,20,NYG,332,228,51,61,30,10,Win,122,102,0,0,2,DAL,40,454,330,0
0.375,0.5,32.88333333,12/10/2017,2017,14,21,19,home,-20,DAL,228,332,69,75,10,30,Loss,102,122,0,0,0,NYG,40,330,454,2
0.454545455,0.5,29.78333333,12/10/2017,2017,14,21,28,away,3,TBB,381,267,105,62,24,21,Win,53,133,0,3,5,DET,45,434,400,3
0.5,0.454545455,30.21666667,12/10/2017,2017,14,28,21,home,-3,DET,267,381,65,69,21,24,Loss,133,53,3,0,3,TBB,45,400,434,5
0.181818182,0.230769231,34.81666667,12/10/2017,2017,14,20,18,away,10,HOU,314,221,87,66,26,16,Win,102,90,2,3,1,SFO,42,416,311,1
0.230769231,0.181818182,25.18333333,12/10/2017,2017,14,18,20,home,-10,SFO,221,314,81,64,16,26,Loss,90,102,3,2,1,HOU,42,311,416,1
0.384615385,0.384615385,23.33333333,12/10/2017,2017,14,15,23,away,-11,KCC,198,243,39,55,15,26,Loss,70,165,3,4,1,OAK,41,268,408,3
0.384615385,0.384615385,36.66666667,12/10/2017,2017,14,23,15,home,11,OAK,243,198,69,71,26,15,Win,165,70,4,3,3,KCC,41,408,268,1
0.333333333,0.214285714,26.18333333,12/10/2017,2017,14,14,16,away,-5,ARI,139,125,48,56,7,12,Loss,65,136,3,8,0,TEN,19,204,261,2
0.214285714,0.333333333,33.81666667,12/10/2017,2017,14,16,14,home,5,TEN,125,139,30,63,12,7,Win,136,65,8,3,2,ARI,19,261,204,0
0.230769231,0.411764706,22.41666667,12/10/2017,2017,14,6,17,away,-23,DEN,41,189,20,48,0,23,Loss,59,84,4,2,0,NYJ,23,100,273,2
0.411764706,0.230769231,37.58333333,12/10/2017,2017,14,17,6,home,23,NYJ,189,41,21,68,23,0,Win,84,59,2,4,2,DEN,23,273,100,0
0.166666667,0.4,24.66666667,12/10/2017,2017,14,9,24,away,-17,LAC,136,314,47,50,13,30,Loss,65,174,2,2,1,WAS,43,201,488,1
0.4,0.166666667,35.33333333,12/10/2017,2017,14,24,9,home,17,WAS,314,136,40,71,30,13,Win,174,65,2,2,1,LAC,43,488,201,1
0.222222222,0.333333333,26.98333333,12/10/2017,2017,14,17,20,away,-6,JAX,260,268,73,57,24,30,Loss,141,156,2,0,1,SEA,54,401,424,3
0.333333333,0.222222222,33.01666667,12/10/2017,2017,14,20,17,home,6,SEA,268,260,48,66,30,24,Win,156,141,0,2,3,JAX,54,424,401,1
0.4,0.285714286,39.2,12/10/2017,2017,14,29,17,away,8,LAR,316,198,67,85,43,35,Win,139,109,2,2,2,PHI,78,455,307,1
0.285714286,0.4,20.8,12/10/2017,2017,14,17,29,home,-8,PHI,198,316,102,45,35,43,Loss,109,139,2,2,1,LAR,78,307,455,2
0.4,0.666666667,26.16666667,12/10/2017,2017,14,26,31,away,-1,PIT,261,486,35,62,38,39,Loss,152,59,1,3,0,BAL,77,413,545,1
0.666666667,0.4,33.83333333,12/10/2017,2017,14,31,26,home,1,BAL,486,261,101,85,39,38,Win,59,152,3,1,1,PIT,77,545,413,0
0,0.285714286,23.85,12/11/2017,2017,14,14,21,away,-7,MIA,223,242,78,55,20,27,Loss,25,120,2,2,0,NEP,47,248,362,2
0.285714286,0,36.15,12/11/2017,2017,14,21,14,home,7,NEP,242,223,102,70,27,20,Win,120,25,2,2,2,MIA,47,362,248,0
0.466666667,0.461538462,36.85,12/14/2017,2017,15,23,15,away,12,IND,251,158,80,74,25,13,Win,211,70,2,1,0,DEN,38,462,228,1
0.461538462,0.466666667,23.15,12/14/2017,2017,15,15,23,home,-12,DEN,158,251,39,53,13,25,Loss,70,211,1,2,1,IND,38,228,462,0
0.416666667,0.461538462,30.91666667,12/16/2017,2017,15,22,18,away,-10,DET,306,202,97,63,10,20,Loss,43,91,2,4,1,CHI,30,349,293,3
0.461538462,0.416666667,29.08333333,12/16/2017,2017,15,18,22,home,10,CHI,202,306,58,57,20,10,Win,91,43,4,2,3,DET,30,293,349,1
0.363636364,0.428571429,26.65,12/16/2017,2017,15,20,20,away,-17,KCC,209,223,61,60,13,30,Loss,98,174,2,1,0,LAC,43,307,397,4
0.428571429,0.363636364,33.35,12/16/2017,2017,15,20,20,home,17,LAC,223,209,71,63,30,13,Win,174,98,1,2,4,KCC,43,397,307,0
0.210526316,0.111111111,36.26666667,12/17/2017,2017,15,19,14,away,-5,WAS,145,187,71,80,15,20,Loss,141,31,5,1,1,ARI,35,286,218,2
0.111111111,0.210526316,23.73333333,12/17/2017,2017,15,14,19,home,5,ARI,187,145,82,47,20,15,Win,31,141,1,5,2,WAS,35,218,286,1
0.4375,0.357142857,36.8,12/17/2017,2017,15,23,15,away,17,CLE,279,136,57,74,27,10,Win,97,130,1,2,4,BAL,37,376,266,0
0.357142857,0.4375,23.2,12/17/2017,2017,15,15,23,home,-17,BAL,136,279,35,58,10,27,Loss,130,97,2,1,0,CLE,37,266,376,4
0.3125,0.466666667,32.41666667,12/17/2017,2017,15,21,21,away,-8,BUF,249,212,60,73,16,24,Loss,100,116,3,2,0,MIA,40,349,328,3
0.466666667,0.3125,27.58333333,12/17/2017,2017,15,21,21,home,8,MIA,212,249,28,61,24,16,Win,116,100,2,3,3,BUF,40,328,349,0
0.363636364,0.5,26.05,12/17/2017,2017,15,24,29,away,-7,CAR,264,236,28,67,24,31,Loss,120,151,3,1,0,GBP,55,384,387,4
0.5,0.363636364,33.95,12/17/2017,2017,15,29,24,home,7,GBP,236,264,40,70,31,24,Win,151,120,1,3,4,CAR,55,387,384,0
0.076923077,0.333333333,24.13333333,12/17/2017,2017,15,8,18,away,-27,MIN,115,222,44,51,7,34,Loss,46,124,3,2,1,CIN,41,161,346,2
0.333333333,0.076923077,35.86666667,12/17/2017,2017,15,18,8,home,27,CIN,222,115,93,61,34,7,Win,124,46,2,3,2,MIN,41,346,161,1
0.25,0.3,26.7,12/17/2017,2017,15,9,25,away,-38,JAX,99,326,127,56,7,45,Loss,87,138,4,1,0,HOU,52,186,464,1
0.3,0.25,33.3,12/17/2017,2017,15,25,9,home,38,HOU,326,99,54,68,45,7,Win,138,87,1,4,1,JAX,52,464,186,0
0.333333333,0.3,30.83333333,12/17/2017,2017,15,19,23,away,-12,NOS,170,281,50,68,19,31,Loss,124,131,1,0,3,NYJ,50,294,412,2
0.3,0.333333333,29.16666667,12/17/2017,2017,15,23,19,home,12,NYJ,281,170,92,64,31,19,Win,131,124,0,1,2,NOS,50,412,294,3
0.461538462,0.555555556,30.88333333,12/17/2017,2017,15,22,27,away,5,NYG,233,429,44,66,34,29,Win,108,75,1,1,1,PHI,63,341,504,0
0.555555556,0.461538462,29.11666667,12/17/2017,2017,15,27,22,home,-5,PHI,429,233,67,81,29,34,Loss,75,108,1,1,0,NYG,63,504,341,1
0.375,0.285714286,36.76666667,12/17/2017,2017,15,19,11,away,35,SEA,108,71,25,68,42,7,Win,244,78,2,7,2,LAR,49,352,149,1
0.285714286,0.375,23.23333333,12/17/2017,2017,15,11,19,home,-35,LAR,71,108,60,54,7,42,Loss,78,244,7,2,1,SEA,49,149,352,2
0.333333333,0.625,24.88333333,12/17/2017,2017,15,21,21,away,3,PIT,283,270,4,56,27,24,Win,77,143,2,2,1,NEP,51,360,413,1
0.625,0.333333333,35.11666667,12/17/2017,2017,15,21,21,home,-3,NEP,270,283,63,63,24,27,Loss,143,77,2,2,1,PIT,51,413,360,1
0.5,0.5,27.41666667,12/17/2017,2017,15,23,23,away,-2,SFO,238,363,22,62,23,25,Loss,90,51,1,3,0,TEN,48,328,414,1
0.5,0.5,32.58333333,12/17/2017,2017,15,23,23,home,2,TEN,363,238,70,68,25,23,Win,51,90,3,1,1,SFO,48,414,328,0
0.2,0.533333333,32.33333333,12/17/2017,2017,15,21,19,away,3,OAK,204,171,100,60,20,17,Win,126,122,2,0,1,DAL,37,330,293,2
0.533333333,0.2,27.66666667,12/17/2017,2017,15,19,21,home,-3,DAL,171,204,105,61,17,20,Loss,122,126,0,2,2,OAK,37,293,330,1
0.6,0.5,33.25,12/18/2017,2017,15,24,22,away,3,TBB,209,289,60,67,24,21,Win,201,84,1,2,1,ATL,45,410,373,0
0.5,0.6,26.75,12/18/2017,2017,15,22,24,home,-3,ATL,289,209,53,55,21,24,Loss,84,201,2,1,0,TBB,45,373,410,1
0.384615385,0.428571429,24.2,12/23/2017,2017,16,17,23,away,-7,BAL,203,220,19,59,16,23,Loss,93,103,2,1,0,IND,39,296,323,0
0.428571429,0.384615385,35.8,12/23/2017,2017,16,23,17,home,7,IND,220,203,25,71,23,16,Win,103,93,1,2,0,BAL,39,323,296,0
0.266666667,0.266666667,31.61666667,12/23/2017,2017,16,15,12,away,16,GBP,124,126,10,61,16,0,Win,112,113,3,1,2,MIN,16,236,239,0
0.266666667,0.266666667,28.38333333,12/23/2017,2017,16,12,15,home,-16,MIN,126,124,79,65,0,16,Loss,113,112,1,3,0,GBP,16,239,236,2
0.153846154,0.230769231,26.2,12/24/2017,2017,16,15,15,away,-10,NOS,264,229,91,61,13,23,Loss,67,86,5,1,1,ATL,36,331,315,2
0.230769231,0.153846154,33.8,12/24/2017,2017,16,15,15,home,10,ATL,229,264,30,60,23,13,Win,86,67,1,5,2,NOS,36,315,331,1
0.470588235,0.454545455,28.26666667,12/24/2017,2017,16,17,28,away,-21,NEP,242,218,83,68,16,37,Loss,84,193,6,2,1,BUF,53,326,411,0
0.454545455,0.470588235,31.73333333,12/24/2017,2017,16,28,17,home,21,BUF,218,242,10,68,37,16,Win,193,84,2,6,0,NEP,53,411,326,1
0.545454545,0.307692308,29.5,12/24/2017,2017,16,20,20,away,-3,CAR,326,140,72,57,19,22,Loss,66,115,6,2,1,TBB,41,392,255,3
0.307692308,0.545454545,30.5,12/24/2017,2017,16,20,20,home,3,TBB,140,326,50,59,22,19,Win,115,66,2,6,3,CAR,41,255,392,1
0.307692308,0.4375,26.76666667,12/24/2017,2017,16,12,16,away,-17,CHI,178,161,60,57,3,20,Loss,76,97,1,5,0,CLE,23,254,258,3
0.4375,0.307692308,33.23333333,12/24/2017,2017,16,16,12,home,17,CLE,161,178,25,59,20,3,Win,97,76,5,1,3,CHI,23,258,254,0
0.4,0.5,27.51666667,12/24/2017,2017,16,15,28,away,-9,CIN,189,222,74,59,17,26,Loss,87,142,2,3,1,DET,43,276,364,1
0.5,0.4,32.48333333,12/24/2017,2017,16,28,15,home,9,DET,222,189,60,78,26,17,Win,142,87,3,2,1,CIN,43,364,276,1
0.294117647,0.384615385,30.45,12/24/2017,2017,16,18,19,away,-16,WAS,171,299,30,71,11,27,Loss,159,87,4,0,2,DEN,38,330,386,3
0.384615385,0.294117647,29.55,12/24/2017,2017,16,19,18,home,16,DEN,299,171,35,66,27,11,Win,87,159,0,4,3,WAS,38,386,330,2
0,0.5,22.11666667,12/24/2017,2017,16,15,23,away,-16,KCC,286,301,75,54,13,29,Loss,59,103,0,1,0,MIA,42,345,404,2
0.5,0,37.88333333,12/24/2017,2017,16,23,15,home,16,MIA,301,286,40,74,29,13,Win,103,59,1,0,2,KCC,42,404,345,0
0.333333333,0.214285714,32.96666667,12/24/2017,2017,16,21,13,away,7,NYJ,290,98,80,70,14,7,Win,89,197,0,3,3,LAC,21,379,295,0
0.214285714,0.333333333,27.03333333,12/24/2017,2017,16,13,21,home,-7,LAC,98,290,34,61,7,14,Loss,197,89,3,0,0,NYJ,21,295,379,3
0.428571429,0.25,30.06666667,12/24/2017,2017,16,20,19,away,4,TEN,286,269,44,66,27,23,Win,116,97,1,1,1,LAR,50,402,366,1
0.25,0.428571429,29.93333333,12/24/2017,2017,16,19,20,home,-4,LAR,269,286,54,66,23,27,Loss,97,116,1,1,1,TEN,50,366,402,1
0.384615385,0.666666667,30.81666667,12/24/2017,2017,16,32,26,away,-11,SFO,380,238,99,79,33,44,Loss,92,131,1,1,1,JAX,77,472,369,3
0.666666667,0.384615385,29.18333333,12/24/2017,2017,16,26,32,home,11,JAX,238,380,68,66,44,33,Win,131,92,1,1,3,SFO,77,369,472,1
0.071428571,0.357142857,26.78333333,12/24/2017,2017,16,12,19,away,-23,ARI,250,215,101,67,0,23,Loss,43,74,2,2,2,NYG,23,293,289,3
0.357142857,0.071428571,33.21666667,12/24/2017,2017,16,19,12,home,23,NYG,215,250,45,64,23,0,Win,74,43,2,2,3,ARI,23,289,293,2
0.363636364,0.461538462,27.16666667,12/24/2017,2017,16,15,21,away,9,DAL,60,154,142,54,21,12,Win,76,128,3,4,3,SEA,33,136,282,0
0.461538462,0.363636364,32.83333333,12/24/2017,2017,16,21,15,home,-9,SEA,154,60,75,68,12,21,Loss,128,76,4,3,0,DAL,33,282,136,3
0.583333333,0.25,30.93333333,12/25/2017,2017,16,20,13,away,28,HOU,226,51,24,58,34,6,Win,104,176,0,7,2,PIT,40,330,227,0
0.25,0.583333333,29.06666667,12/25/2017,2017,16,13,20,home,-28,PIT,51,226,80,52,6,34,Loss,176,104,7,0,0,HOU,40,227,330,2
0.230769231,0.071428571,34.35,12/25/2017,2017,16,13,12,away,-9,PHI,137,138,50,63,10,19,Loss,137,78,1,2,2,OAK,29,274,216,5
0.071428571,0.230769231,25.65,12/25/2017,2017,16,12,13,home,9,OAK,138,137,60,61,19,10,Win,78,137,2,1,5,PHI,29,216,274,2
0.083333333,0.384615385,24.08333333,12/31/2017,2017,17,12,21,away,-13,MIN,171,180,116,53,10,23,Loss,30,147,1,2,0,CHI,33,201,327,0
0.384615385,0.083333333,35.91666667,12/31/2017,2017,17,21,12,home,13,CHI,180,171,103,67,23,10,Win,147,30,2,1,0,MIN,33,327,201,0
0.466666667,0.3,30.91666667,12/31/2017,2017,17,17,20,away,-4,PIT,272,224,77,63,24,28,Loss,102,124,6,3,2,CLE,52,374,348,2
0.3,0.466666667,29.08333333,12/31/2017,2017,17,20,17,home,4,CLE,224,272,15,58,28,24,Win,124,102,3,6,2,PIT,52,348,374,2
0.333333333,0.181818182,30.08333333,12/31/2017,2017,17,16,12,away,6,PHI,172,149,64,63,6,0,Win,129,70,1,3,2,DAL,6,301,219,1
0.181818182,0.333333333,29.91666667,12/31/2017,2017,17,12,16,home,-6,DAL,149,172,49,55,0,6,Loss,70,129,3,1,1,PHI,6,219,301,2
0.285714286,0.333333333,31.78333333,12/31/2017,2017,17,17,18,away,-24,DET,153,305,68,63,11,35,Loss,103,51,4,2,0,GBP,46,256,356,4
0.333333333,0.285714286,28.21666667,12/31/2017,2017,17,18,17,home,24,GBP,305,153,62,54,35,11,Win,51,103,2,4,4,DET,46,356,256,0
0.454545455,0.461538462,28.78333333,12/31/2017,2017,17,15,20,away,-9,IND,124,104,34,53,13,22,Loss,85,146,2,1,0,HOU,35,209,250,1
0.461538462,0.454545455,31.21666667,12/31/2017,2017,17,20,15,home,9,HOU,104,124,20,62,22,13,Win,146,85,1,2,1,IND,35,250,209,0
0,0.266666667,25.18333333,12/31/2017,2017,17,14,28,away,-20,NEP,207,183,84,59,6,26,Loss,40,147,4,2,0,NYJ,32,247,330,0
0.266666667,0,34.81666667,12/31/2017,2017,17,28,14,home,20,NYJ,183,207,49,80,26,6,Win,147,40,2,4,0,NEP,32,330,247,0
0.076923077,0.25,28.11666667,12/31/2017,2017,17,10,17,away,-8,NYG,136,121,35,56,10,18,Loss,61,260,3,2,1,WAS,28,197,381,3
0.25,0.076923077,31.88333333,12/31/2017,2017,17,17,10,home,8,WAS,121,136,25,74,18,10,Win,260,61,2,3,3,NYG,28,381,197,1
0.285714286,0.083333333,32.26666667,12/31/2017,2017,17,19,13,away,2,SEA,143,195,25,68,26,24,Win,116,101,1,3,0,ARI,50,259,296,1
0.083333333,0.285714286,27.73333333,12/31/2017,2017,17,13,19,home,-2,ARI,195,143,100,54,24,26,Loss,101,116,3,1,1,SEA,50,296,259,0
0.333333333,0.375,25.3,12/31/2017,2017,17,15,20,away,-12,ATL,161,311,35,60,10,22,Loss,87,60,2,1,0,CAR,32,248,371,3
0.375,0.333333333,34.7,12/31/2017,2017,17,20,15,home,12,CAR,311,161,60,72,22,10,Win,60,87,1,2,3,ATL,32,371,248,0
0.333333333,0.294117647,28.65,12/31/2017,2017,17,22,19,away,4,BAL,213,194,60,75,31,27,Win,146,118,1,1,1,CIN,58,359,312,1
0.294117647,0.333333333,31.35,12/31/2017,2017,17,19,22,home,-4,CIN,194,213,47,74,27,31,Loss,118,146,1,1,1,BAL,58,312,359,1
0.416666667,0.384615385,31.06666667,12/31/2017,2017,17,23,21,away,6,MIA,186,263,45,63,22,16,Win,126,93,4,1,1,BUF,38,312,356,0
0.384615385,0.416666667,28.93333333,12/31/2017,2017,17,21,23,home,-6,BUF,263,186,145,67,16,22,Loss,93,126,1,4,0,MIA,38,356,312,1
0.363636364,0.416666667,29.05,12/31/2017,2017,17,23,22,away,3,DEN,269,226,40,65,27,24,Win,110,110,2,5,3,KCC,51,379,336,2
0.416666667,0.363636364,30.95,12/31/2017,2017,17,22,23,home,-3,KCC,226,269,30,65,24,27,Loss,110,110,5,2,2,DEN,51,336,379,3
0.375,0.1875,26.55,12/31/2017,2017,17,13,11,away,-5,TEN,146,116,41,60,10,15,Loss,83,116,2,3,1,JAX,25,229,232,4
0.1875,0.375,33.45,12/31/2017,2017,17,11,13,home,5,JAX,116,146,15,63,15,10,Win,116,83,3,2,4,TEN,25,232,229,1
0.363636364,0.538461538,26.66666667,12/31/2017,2017,17,14,26,away,-20,LAC,231,380,85,53,10,30,Loss,105,115,2,1,0,OAK,40,336,495,2
0.538461538,0.363636364,33.33333333,12/31/2017,2017,17,26,14,home,20,OAK,380,231,65,68,30,10,Win,115,105,1,2,2,LAC,40,495,336,0
0.5,0.333333333,29.15,12/31/2017,2017,17,25,15,away,21,LAR,292,149,23,63,34,13,Win,169,102,0,3,2,SFO,47,461,251,3
0.333333333,0.5,30.85,12/31/2017,2017,17,15,25,home,-21,SFO,149,292,46,63,13,34,Loss,102,169,3,0,3,LAR,47,251,461,2
0.5,0.722222222,28.45,12/31/2017,2017,17,18,28,away,-7,TBB,231,345,38,58,24,31,Loss,92,110,2,2,3,NOS,55,323,455,1
0.722222222,0.5,31.55,12/31/2017,2017,17,28,18,home,7,NOS,345,231,15,81,31,24,Win,110,92,2,2,1,TBB,55,455,323,3
0.615384615,0.363636364,32.46666667,1/6/2018,2017,PF,23,19,away,1,KCC,195,256,50,64,22,21,Win,202,69,2,4,0,TEN,43,397,325,2
0.363636364,0.615384615,27.53333333,1/6/2018,2017,PF,19,23,home,-1,TEN,256,195,68,53,21,22,Loss,69,202,4,2,2,KCC,43,325,397,0
0.333333333,0.357142857,37.58333333,1/6/2018,2017,PF,20,19,away,13,LAR,198,246,51,72,26,13,Win,124,115,3,3,2,ATL,39,322,361,0
0.357142857,0.333333333,22.41666667,1/6/2018,2017,PF,19,20,home,-13,ATL,246,198,45,64,13,26,Loss,115,124,3,3,0,LAR,39,361,322,2
0.388888889,0.166666667,32.61666667,1/7/2018,2017,PF,20,15,away,-7,JAX,133,75,52,74,3,10,Loss,130,155,2,2,0,BUF,13,263,230,2
0.166666667,0.388888889,27.38333333,1/7/2018,2017,PF,15,20,home,7,BUF,75,133,34,59,10,3,Win,155,130,2,2,2,JAX,13,230,263,0
0.470588235,0.25,33.81666667,1/7/2018,2017,PF,24,21,away,-5,NOS,306,369,18,71,26,31,Loss,107,41,4,1,1,CAR,57,413,410,0
0.25,0.470588235,26.18333333,1/7/2018,2017,PF,21,24,home,5,CAR,369,306,96,56,31,26,Win,41,107,1,4,0,NOS,57,410,413,1
0.307692308,0.461538462,27.9,1/13/2018,2017,PF,19,22,away,-5,PHI,195,238,73,59,10,15,Loss,86,96,3,1,2,ATL,25,281,334,0
0.461538462,0.307692308,32.1,1/13/2018,2017,PF,22,19,home,5,ATL,238,195,24,63,15,10,Win,96,86,1,3,0,PHI,25,334,281,2
0.333333333,0.647058824,27.06666667,1/13/2018,2017,PF,15,31,away,-21,NEP,202,337,62,61,14,35,Loss,65,101,8,0,0,TEN,49,267,438,0
0.647058824,0.333333333,32.93333333,1/13/2018,2017,PF,31,15,home,21,TEN,337,202,37,80,35,14,Win,101,65,0,8,0,NEP,49,438,267,0
0.571428571,0.4375,28.83333333,1/14/2018,2017,PF,22,28,away,3,PIT,214,462,40,61,45,42,Win,164,83,0,2,2,JAX,87,378,545,0
0.4375,0.571428571,31.16666667,1/14/2018,2017,PF,28,22,home,-3,JAX,462,214,25,78,42,45,Loss,83,164,2,0,0,PIT,87,545,378,2
0.222222222,0.588235294,26.71666667,1/14/2018,2017,PF,23,24,away,-5,MIN,278,308,97,67,24,29,Loss,80,95,2,2,1,NOS,53,358,403,2
0.588235294,0.222222222,33.28333333,1/14/2018,2017,PF,24,23,home,5,NOS,308,278,30,71,29,24,Win,95,80,2,2,2,MIN,53,403,358,1
0.4,0.25,35.13333333,1/21/2018,2017,PF,22,22,away,-4,NEP,273,298,98,71,20,24,Loss,101,46,3,3,1,JAX,44,374,344,0
0.25,0.4,24.86666667,1/21/2018,2017,PF,22,22,home,4,JAX,298,273,10,61,24,20,Win,46,101,3,3,0,NEP,44,344,374,1
0.461538462,0.714285714,25.93333333,1/21/2018,2017,PF,22,27,away,-31,PHI,263,346,19,67,7,38,Loss,70,110,1,1,0,MIN,45,333,456,3
0.714285714,0.461538462,34.06666667,1/21/2018,2017,PF,27,22,home,31,MIN,346,263,55,64,38,7,Win,110,70,1,1,3,PHI,45,456,333,0
0.625,0.5,34.06666667,2/4/2018,2017,PF,25,29,away,8,NEP,374,500,35,71,41,33,Win,164,113,0,1,1,PHI,74,538,613,1
0.5,0.625,25.93333333,2/4/2018,2017,PF,29,25,home,-8,PHI,500,374,5,72,33,41,Loss,113,164,1,0,1,NEP,74,613,538,1
