third_per,third_per_allowed,TOP,date,first_downs,first_downs_allowed,ha,margin,opp,pass_yards,pass_yards_allowed,penalty_yards,plays,points,points_allowed,result,rush_yards,rush_yards_allowed,sacked,sacks,takeaways,team,total_points,total_yards,total_yards_allowed,turnovers,pred_margin,pred_total,pred_pf,pred_pa
0.307692308,0.28571428600000004,28.35,9/10/2009,18,19,away,-3,PIT,234,321,28,61,0,3,Loss,86,36,1,4,3,TEN,3,320,357,2,-3.1906628303924016,40.71251246207166,18.76092481583963,21.951587646232028
0.28571428600000004,0.307692308,36.18333333,9/10/2009,19,18,home,3,TEN,321,234,60,70,3,0,Win,36,86,4,1,2,PIT,3,357,320,3,3.1906628303924016,40.71251246207166,21.951587646232028,18.76092481583963
0.363636364,0.4,29.11666667,9/13/2009,16,19,away,-12,ATL,163,213,27,56,7,19,Loss,96,68,4,2,0,MIA,26,259,281,4,3.2134163071693926,35.04892791212205,19.131172109645725,15.91775580247633
0.4,0.363636364,30.88333333,9/13/2009,19,16,home,12,MIA,213,163,35,65,19,7,Win,68,96,2,4,4,ATL,26,281,259,0,-3.2134163071693926,35.04892791212205,15.917755802476329,19.131172109645725
0.25,0.333333333,26.55,9/13/2009,10,16,away,5,CIN,227,221,39,51,12,7,Win,75,86,3,3,2,DEN,19,302,307,0,7.790479782828149,35.45660586891151,21.62354282586983,13.83306304304168
0.333333333,0.25,33.45,9/13/2009,16,10,home,-5,DEN,221,227,27,63,7,12,Loss,86,75,3,3,0,CIN,19,307,302,2,-7.790479782828149,35.45660586891151,13.83306304304168,21.62354282586983
0.428571429,0.25,33.36666667,9/13/2009,19,17,away,14,CLE,85,179,38,63,34,20,Win,225,89,4,5,2,MIN,54,310,268,0,-1.400167210674395,33.45484200478114,16.027337397053373,17.42750460772777
0.25,0.428571429,26.63333333,9/13/2009,17,19,home,-14,MIN,179,85,66,60,20,34,Loss,89,225,5,4,0,CLE,54,268,310,2,1.400167210674395,33.45484200478114,17.42750460772777,16.027337397053373
0.4,0.571428571,26.06666667,9/13/2009,12,21,away,-2,IND,114,294,24,55,12,14,Loss,114,71,1,1,2,JAX,26,228,365,0,-5.762606946708721,40.17444834565401,17.205920699472642,22.968527646181364
0.571428571,0.4,33.93333333,9/13/2009,21,12,home,2,JAX,294,114,17,70,14,12,Win,71,114,1,1,0,IND,26,365,228,2,5.762606946708721,40.17444834565401,22.968527646181364,17.205920699472642
0.214285714,0.692307692,23.5,9/13/2009,14,28,away,-18,NOS,198,358,80,58,27,45,Loss,33,157,1,0,3,DET,72,231,515,3,1.3889085888458226,53.67546242376525,27.532185506305535,26.143276917459712
0.692307692,0.214285714,36.5,9/13/2009,28,14,home,18,DET,358,198,36,69,45,27,Win,157,33,0,1,3,NOS,72,515,231,3,-1.3889085888458226,53.67546242376525,26.143276917459712,27.532185506305535
0.3,0.384615385,26.46666667,9/13/2009,18,26,away,13,TBB,344,276,41,52,34,21,Win,118,174,1,0,0,DAL,55,462,450,0,-1.9676522877099014,48.73820652910613,23.385277120698113,25.352929408408016
0.384615385,0.3,33.53333333,9/13/2009,26,18,home,-13,DAL,276,344,20,73,21,34,Loss,174,118,0,1,0,TBB,55,450,462,0,1.9676522877099014,48.73820652910613,25.352929408408016,23.385277120698113
0.384615385,0.1875,31.61666667,9/13/2009,17,14,away,28,CAR,82,83,76,63,38,10,Win,185,86,2,5,7,PHI,48,267,169,2,-7.308315890339426,37.43040947385411,15.061046791757342,22.36936268209677
0.1875,0.384615385,28.38333333,9/13/2009,14,17,home,-28,PHI,83,82,30,69,10,38,Loss,86,185,5,2,2,CAR,48,169,267,7,7.308315890339426,37.43040947385411,22.36936268209677,15.061046791757343
0.2,0.588235294,20.18333333,9/13/2009,11,32,away,-14,BAL,159,303,15,44,24,38,Loss,29,198,3,1,1,KCC,62,188,501,0,3.343481870031546,40.34340962162829,21.843445745829918,18.49996387579837
0.588235294,0.2,39.81666667,9/13/2009,32,11,home,14,KCC,303,159,65,85,38,24,Win,198,29,1,3,0,BAL,62,501,188,1,-3.343481870031546,40.34340962162829,18.49996387579837,21.843445745829918
0.5555555560000001,0.3,38.76666667,9/13/2009,22,11,away,17,HOU,272,145,80,73,24,7,Win,190,38,0,2,2,NYJ,31,462,183,1,-6.817851522143409,43.345196661841456,18.263672569849025,25.08152409199243
0.3,0.5555555560000001,21.23333333,9/13/2009,11,22,home,-17,NYJ,145,272,37,48,7,24,Loss,38,190,2,0,1,HOU,31,183,462,2,6.817851522143409,43.345196661841456,25.08152409199243,18.263672569849025
0.41666666700000005,0.46153846200000004,23.86666667,9/13/2009,15,18,away,-6,NYG,187,248,32,50,17,23,Loss,85,103,3,1,2,WAS,40,272,351,2,0.6382275223113769,43.62956799525305,22.13389775878221,21.495670236470836
0.46153846200000004,0.41666666700000005,36.13333333,9/13/2009,18,15,home,6,WAS,248,187,30,61,23,17,Win,103,85,1,3,2,NYG,40,351,272,2,-0.6382275223113769,43.62956799525305,21.495670236470836,22.13389775878221
0.38888888899999996,0.28571428600000004,31.61666667,9/13/2009,13,17,away,4,ARI,182,259,31,60,20,16,Win,21,40,4,3,2,SFO,36,203,299,1,-2.7817533597628086,30.414214753497067,13.81623069686713,16.597984056629937
0.28571428600000004,0.38888888899999996,28.38333333,9/13/2009,17,13,home,-4,SFO,259,182,82,64,16,20,Loss,40,21,3,4,1,ARI,36,299,203,2,2.7817533597628086,30.414214753497067,16.59798405662994,13.816230696867128
0.166666667,0.533333333,27.55,9/13/2009,13,25,away,-28,SEA,170,279,85,57,0,28,Loss,77,167,3,0,3,LAR,28,247,446,1,-2.1972556718421856,43.4032961333027,20.60302023073026,22.800275902572444
0.533333333,0.166666667,32.45,9/13/2009,25,13,home,28,LAR,279,170,25,70,28,0,Win,167,77,0,3,1,SEA,28,446,247,3,2.1972556718421856,43.4032961333027,22.800275902572444,20.60302023073026
0.26666666699999997,0.28571428600000004,33.05,9/13/2009,18,12,away,-6,GBP,266,150,25,69,15,21,Loss,86,76,2,4,0,CHI,36,352,226,4,-0.3037207515051765,36.87761075805773,18.286945003276276,18.59066575478145
0.28571428600000004,0.26666666699999997,26.95,9/13/2009,12,18,home,6,CHI,150,266,45,54,21,15,Win,76,86,4,2,4,GBP,36,226,352,0,0.3037207515051765,36.87761075805773,18.59066575478145,18.286945003276276
0.4,0.625,22.86666667,9/14/2009,17,28,away,-1,NEP,186,368,71,48,24,25,Loss,90,73,4,1,1,BUF,49,276,441,1,7.989653254428733,50.08180816981144,29.035730712120085,21.046077457691354
0.625,0.4,37.13333333,9/14/2009,28,17,home,1,BUF,368,186,55,77,25,24,Win,73,90,1,4,1,NEP,49,441,276,1,-7.989653254428733,50.08180816981144,21.046077457691354,29.035730712120085
0.41666666700000005,0.5,28.38333333,9/14/2009,19,19,away,4,OAK,240,218,60,62,24,20,Win,77,148,3,1,3,LAC,44,317,366,2,-5.7265430637951535,49.64828692748191,21.96087193184338,27.687414995638534
0.5,0.41666666700000005,31.61666667,9/14/2009,19,19,home,-4,LAC,218,240,40,65,20,24,Loss,148,77,1,3,2,OAK,44,366,317,3,5.7265430637951535,49.64828692748191,27.687414995638534,21.96087193184338
0.583333333,0.5,28.46666667,9/20/2009,24,23,away,-8,ATL,296,220,35,67,20,28,Loss,144,151,1,0,2,CAR,48,440,371,2,-5.213266409690711,55.45245565541256,25.119594622860923,30.332861032551634
0.5,0.583333333,31.53333333,9/20/2009,23,24,home,8,CAR,220,296,40,64,28,20,Win,151,144,0,1,2,ATL,48,371,440,2,5.213266409690711,55.45245565541256,30.332861032551634,25.119594622860923
0.272727273,0.384615385,29.58333333,9/20/2009,18,17,away,14,DET,153,136,43,56,27,13,Win,112,129,3,2,3,MIN,40,265,265,1,0.11582383735148216,37.08708926717556,18.60145655226352,18.485632714912036
0.384615385,0.272727273,30.41666667,9/20/2009,17,18,home,-14,MIN,136,153,45,66,13,27,Loss,129,112,2,3,1,DET,40,265,265,3,-0.11582383735148216,37.08708926717556,18.485632714912036,18.60145655226352
0.642857143,0.46153846200000004,33.8,9/20/2009,19,22,away,7,GBP,168,222,100,59,31,24,Win,151,89,2,6,1,CIN,55,319,311,2,0.9994552580023959,47.95906411947064,24.47925968873652,23.47980443073412
0.46153846200000004,0.642857143,26.2,9/20/2009,22,19,home,-7,CIN,222,168,76,63,24,31,Loss,89,151,6,2,2,GBP,55,311,319,1,-0.9994552580023959,47.95906411947064,23.47980443073412,24.47925968873652
0.3125,0.454545455,34.05,9/20/2009,19,19,away,3,TEN,357,209,40,68,34,31,Win,63,240,0,2,2,HOU,65,420,449,0,-9.24562413301273,50.953719127114816,20.85404749705104,30.099671630063774
0.454545455,0.3125,25.95,9/20/2009,19,19,home,-3,HOU,209,357,64,60,31,34,Loss,240,63,2,0,0,TEN,65,449,420,2,9.24562413301273,50.953719127114816,30.099671630063774,20.85404749705104
0.23076923100000002,0.333333333,21.35,9/20/2009,11,25,away,3,KCC,99,236,45,51,13,10,Win,67,173,2,2,2,OAK,23,166,409,0,-8.000795563586582,36.80130484968154,14.400254643047482,22.40105020663406
0.333333333,0.23076923100000002,38.65,9/20/2009,25,11,home,-3,OAK,236,99,70,79,10,13,Loss,173,67,2,2,0,KCC,23,409,166,2,8.000795563586582,36.80130484968154,22.40105020663406,14.40025464304748
0.333333333,0.272727273,30.83333333,9/20/2009,18,14,away,-7,NYJ,216,137,89,67,9,16,Loss,83,117,0,2,1,NEP,25,299,254,1,2.8908127459345643,34.19865465176853,18.544733698851545,15.653920952916982
0.272727273,0.333333333,29.16666667,9/20/2009,14,18,home,7,NEP,137,216,55,55,16,9,Win,117,83,2,0,1,NYJ,25,254,299,1,-2.8908127459345643,34.19865465176853,15.653920952916984,18.544733698851545
0.46153846200000004,0.4375,30.43333333,9/20/2009,23,23,away,26,PHI,288,384,13,65,48,22,Win,133,79,2,1,4,NOS,70,421,463,1,1.5440152846667505,58.066576765092236,29.805296024879492,28.261280740212744
0.4375,0.46153846200000004,29.56666667,9/20/2009,23,23,home,-26,NOS,384,288,45,75,22,48,Loss,79,133,1,2,1,PHI,70,463,421,4,-1.5440152846667505,58.066576765092236,28.261280740212744,29.805296024879492
0.5,0.46666666700000003,25.11666667,9/20/2009,14,21,away,-2,WAS,119,237,45,50,7,9,Loss,126,125,1,1,1,LAR,16,245,362,1,-8.790417979394551,39.72542156188697,15.467501791246207,24.25791977064076
0.46666666700000003,0.5,34.88333333,9/20/2009,21,14,home,2,LAR,237,119,35,70,9,7,Win,125,126,1,1,1,WAS,16,362,245,1,8.790417979394551,39.72542156188697,24.25791977064076,15.467501791246208
0.222222222,0.375,31.35,9/20/2009,22,18,away,14,JAX,265,275,58,60,31,17,Win,118,92,0,4,3,ARI,48,383,367,2,-0.7322769616831533,47.245834061532705,23.256778549924775,23.98905551160793
0.375,0.222222222,28.65,9/20/2009,18,22,home,-14,ARI,275,265,50,67,17,31,Loss,92,118,4,0,2,JAX,48,367,383,3,0.7322769616831533,47.245834061532705,23.98905551160793,23.256778549924775
0.28571428600000004,0.333333333,25.48333333,9/20/2009,19,16,away,-13,SFO,217,123,45,65,10,23,Loss,66,256,1,4,0,SEA,33,283,379,1,-0.616401047831415,34.60784842237529,16.995723687271937,17.612124735103354
0.333333333,0.28571428600000004,34.51666667,9/20/2009,16,19,home,13,SEA,123,217,54,60,23,10,Win,256,66,4,1,1,SFO,33,379,283,0,0.616401047831415,34.60784842237529,17.612124735103354,16.995723687271937
0.25,0.333333333,30.45,9/20/2009,19,25,away,-13,BUF,296,220,112,71,20,33,Loss,57,218,2,2,2,TBB,53,353,438,2,-10.986784419472645,48.577653014828456,18.795434297677907,29.78221871715055
0.333333333,0.25,29.55,9/20/2009,25,19,home,13,TBB,220,296,55,68,33,20,Win,218,57,2,2,2,BUF,53,438,353,2,10.986784419472645,48.577653014828456,29.78221871715055,18.795434297677907
0.5,0.5,30.43333333,9/20/2009,21,17,away,-3,CHI,203,231,52,59,14,17,Loss,105,44,2,2,0,PIT,31,308,275,2,-1.0185142740103998,41.856943377850435,20.419214551920017,21.437728825930417
0.5,0.5,29.56666667,9/20/2009,17,21,home,3,PIT,231,203,80,57,17,14,Win,44,105,2,2,2,CHI,31,275,308,0,1.0185142740103998,41.856943377850435,21.437728825930417,20.419214551920017
0.363636364,0.4375,28.68333333,9/20/2009,22,20,away,5,LAC,181,421,32,60,31,26,Win,130,53,1,2,2,BAL,57,311,474,1,2.5066911266650336,47.86434724084758,25.185519183756305,22.678828057091273
0.4375,0.363636364,31.31666667,9/20/2009,20,22,home,-5,BAL,421,181,85,68,26,31,Loss,53,130,2,1,1,LAC,57,474,311,2,-2.5066911266650336,47.86434724084758,22.678828057091273,25.185519183756305
0.214285714,0.533333333,27.26666667,9/20/2009,11,25,away,-21,DEN,146,263,43,56,6,27,Loss,54,186,4,0,1,CLE,33,200,449,3,-2.460826788696778,40.39533085698762,18.96725203414542,21.4280788228422
0.533333333,0.214285714,32.73333333,9/20/2009,25,11,home,21,CLE,263,146,50,74,27,6,Win,186,54,0,4,3,DEN,33,449,200,1,2.460826788696778,40.39533085698762,21.4280788228422,18.96725203414542
0.4,0.545454545,34.81666667,9/20/2009,19,23,away,2,DAL,330,127,40,64,33,31,Win,97,251,0,0,4,NYG,64,427,378,0,-1.5839374714063474,52.786973012732275,25.601517770662966,27.18545524206931
0.545454545,0.4,25.18333333,9/20/2009,23,19,home,-2,NYG,127,330,50,58,31,33,Loss,251,97,0,0,0,DAL,64,378,427,4,1.5839374714063474,52.786973012732275,27.18545524206931,25.601517770662966
0.428571429,0.7142857140000001,14.88333333,9/21/2009,14,27,away,4,MIA,295,164,20,35,27,23,Win,61,239,1,2,1,IND,50,356,403,0,4.2827100040104265,48.929958618122185,26.606334311066306,22.32362430705588
0.7142857140000001,0.428571429,45.11666667,9/21/2009,27,14,home,-4,IND,164,295,20,84,23,27,Loss,239,61,2,1,0,MIA,50,403,356,1,-4.2827100040104265,48.929958618122185,22.32362430705588,26.606334311066306
0.2,0.5555555560000001,23.2,9/27/2009,22,23,away,-5,DET,325,227,97,57,14,19,Loss,65,154,2,2,0,WAS,33,390,381,1,-8.266248515799997,47.51871687287546,19.62623417853773,27.89248269433773
0.5555555560000001,0.2,36.8,9/27/2009,23,22,home,5,WAS,227,325,58,74,19,14,Win,154,65,2,2,1,DET,33,381,390,0,8.266248515799997,47.51871687287546,27.89248269433773,19.62623417853773
0.0,0.46153846200000004,29.41666667,9/27/2009,11,21,away,-20,PHI,97,327,90,51,14,34,Loss,99,93,3,0,1,KCC,48,196,420,1,6.2262509744691314,37.37739541198643,21.80182319322778,15.575572218758648
0.46153846200000004,0.0,30.58333333,9/27/2009,21,11,home,20,KCC,327,97,20,63,34,14,Win,93,99,0,3,1,PHI,48,420,196,1,-6.2262509744691314,37.37739541198643,15.575572218758648,21.80182319322778
0.222222222,0.28571428600000004,30.31666667,9/27/2009,24,22,away,19,LAR,250,187,51,62,36,17,Win,152,149,2,1,3,GBP,53,402,336,0,0.41337222161186205,47.71271412395746,24.06304317278466,23.6496709511728
0.28571428600000004,0.222222222,29.68333333,9/27/2009,22,24,home,-19,GBP,187,250,40,69,17,36,Loss,149,152,1,2,0,LAR,53,336,402,3,-0.41337222161186205,47.71271412395746,23.6496709511728,24.06304317278466
0.0,0.5,27.85,9/27/2009,13,19,away,-3,MIN,188,283,60,52,24,27,Loss,58,94,1,2,1,SFO,51,246,377,1,-4.364620394909693,34.66486364393555,15.150121624512927,19.51474201942262
0.5,0.0,32.15,9/27/2009,19,13,home,3,SFO,283,188,52,75,27,24,Win,94,58,2,1,1,MIN,51,377,246,1,4.364620394909693,34.66486364393555,19.51474201942262,15.150121624512927
0.222222222,0.444444444,20.18333333,9/27/2009,13,28,away,-16,NEP,199,277,54,45,10,26,Loss,58,168,0,0,0,ATL,36,257,445,1,8.5627124819132,39.44075023539478,24.00173135865399,15.43901887674079
0.444444444,0.222222222,39.81666667,9/27/2009,28,13,home,16,ATL,277,199,10,81,26,10,Win,168,58,0,0,1,NEP,36,445,257,0,-8.5627124819132,39.44075023539478,15.43901887674079,24.00173135865399
0.625,0.0,43.63333333,9/27/2009,27,5,away,24,TBB,171,58,60,76,24,0,Win,226,28,0,0,1,NYG,24,397,86,0,-3.5107631898047593,31.91668496727997,14.202960888737607,17.713724078542363
0.0,0.625,16.36666667,9/27/2009,5,27,home,-24,NYG,58,171,25,36,0,24,Loss,28,226,0,0,0,TBB,24,86,397,1,3.5107631898047593,31.91668496727997,17.713724078542363,14.202960888737605
0.25,0.363636364,28.7,9/27/2009,11,28,away,-31,BAL,115,337,46,52,3,34,Loss,71,142,2,1,1,CLE,37,186,479,4,8.680828476266381,42.1195979710942,25.40021322368029,16.719384747413912
0.363636364,0.25,31.3,9/27/2009,28,11,home,31,CLE,337,115,84,66,34,3,Win,142,71,1,2,4,BAL,37,479,186,1,-8.680828476266381,42.1195979710942,16.719384747413912,25.40021322368029
0.454545455,0.4,30.86666667,9/27/2009,24,23,away,7,HOU,214,286,40,62,31,24,Win,185,111,0,2,2,JAX,55,399,397,1,-0.8678444557500047,55.19653810709826,27.16434682567413,28.032191281424133
0.4,0.454545455,29.13333333,9/27/2009,23,24,home,-7,JAX,286,214,60,59,24,31,Loss,111,185,2,0,1,HOU,55,397,399,2,0.8678444557500047,55.19653810709826,28.032191281424133,27.16434682567413
0.28571428600000004,0.25,27.36666667,9/27/2009,17,13,away,-7,NYJ,159,146,15,69,17,24,Loss,127,83,2,3,2,TEN,41,286,229,4,-7.92000600955272,33.78784136184412,12.9339176761457,20.853923685698422
0.25,0.28571428600000004,32.63333333,9/27/2009,13,17,home,7,TEN,146,159,25,64,24,17,Win,83,127,3,2,4,NYJ,41,229,286,2,7.92000600955272,33.78784136184412,20.853923685698422,12.9339176761457
0.333333333,0.41176470600000004,30.4,9/27/2009,14,19,away,6,SEA,233,243,60,57,25,19,Win,85,103,2,3,2,CHI,44,318,346,2,-6.690503528888852,39.149105178753906,16.229300824932526,22.91980435382138
0.41176470600000004,0.333333333,29.6,9/27/2009,19,14,home,-6,CHI,243,233,45,75,19,25,Loss,103,85,3,2,2,SEA,44,346,318,2,6.690503528888852,39.149105178753906,22.91980435382138,16.229300824932526
0.333333333,0.14285714300000002,33.56666667,9/27/2009,21,13,away,20,BUF,156,154,97,69,27,7,Win,222,89,2,4,2,NOS,34,378,243,1,-7.602113265198305,37.064181991870086,14.73103436333589,22.333147628534196
0.14285714300000002,0.333333333,26.43333333,9/27/2009,13,21,home,-20,NOS,154,156,116,61,7,27,Loss,89,222,4,2,1,BUF,34,243,378,2,7.602113265198305,37.064181991870086,22.333147628534196,14.73103436333589
0.5,0.25,34.7,9/27/2009,17,19,away,-3,CIN,271,173,51,60,20,23,Loss,102,100,1,2,0,PIT,43,373,273,1,5.123808681966069,38.960364944036876,22.04208681300147,16.918278131035404
0.25,0.5,25.3,9/27/2009,19,17,home,3,PIT,173,271,30,58,23,20,Win,100,102,2,1,1,CIN,43,273,373,0,-5.123808681966069,38.960364944036876,16.918278131035404,22.04208681300147
0.41666666700000005,0.3,36.25,9/27/2009,21,9,away,20,OAK,157,42,30,68,23,3,Win,215,95,0,3,3,DEN,26,372,137,1,0.4671373769254714,39.24114531935867,19.854141348142072,19.3870039712166
0.3,0.41666666700000005,23.75,9/27/2009,9,21,home,-20,DEN,42,157,53,47,3,23,Loss,95,215,3,0,1,OAK,26,137,372,3,-0.4671373769254714,39.24114531935867,19.3870039712166,19.854141348142072
0.41666666700000005,0.5,32.45,9/27/2009,19,19,away,-10,LAC,140,286,39,63,13,23,Loss,149,69,1,2,1,MIA,36,289,355,2,-1.7217983591732011,41.09034439789162,19.68427301935921,21.40607137853241
0.5,0.41666666700000005,27.55,9/27/2009,19,19,home,10,MIA,286,140,20,63,23,13,Win,69,149,2,1,2,LAC,36,355,289,1,1.7217983591732011,41.09034439789162,21.40607137853241,19.68427301935921
0.272727273,0.28571428600000004,31.7,9/27/2009,22,21,away,21,ARI,379,299,69,66,31,10,Win,126,24,0,4,3,IND,41,505,323,1,-0.09687734627433642,49.10893696020477,24.506029806965216,24.602907153239556
0.28571428600000004,0.272727273,28.3,9/27/2009,21,22,home,-21,IND,299,379,35,70,10,31,Loss,24,126,4,0,1,ARI,41,323,505,3,0.09687734627433642,49.10893696020477,24.602907153239556,24.506029806965216
0.125,0.384615385,22.93333333,9/28/2009,15,24,away,-14,DAL,198,237,60,52,7,21,Loss,73,212,3,2,0,CAR,28,271,449,3,-1.934766481762857,44.66497663948803,21.365105078862587,23.299871560625444
0.384615385,0.125,37.06666667,9/28/2009,24,15,home,14,CAR,237,198,80,67,21,7,Win,212,73,2,3,3,DAL,28,449,271,0,1.934766481762857,44.66497663948803,23.299871560625444,21.365105078862587
0.41176470600000004,0.2,36.5,10/4/2009,25,14,away,-24,CHI,308,125,51,78,24,48,Loss,90,151,5,2,0,DET,72,398,276,2,-2.428128995845447,40.85363983563539,19.21275541989497,21.64088441574042
0.2,0.41176470600000004,23.5,10/4/2009,14,25,home,24,DET,125,308,36,50,48,24,Win,151,90,2,5,2,CHI,72,276,398,0,2.428128995845447,40.85363983563539,21.64088441574042,19.21275541989497
0.27777777800000003,0.31578947399999996,36.01666667,10/4/2009,21,22,away,3,CLE,221,249,46,76,3,0,Win,154,146,2,2,2,CIN,3,375,395,2,-13.81198750202868,32.19873142616419,9.193371962067754,23.005359464096433
0.31578947399999996,0.27777777800000003,38.91666667,10/4/2009,22,21,home,-3,CIN,249,221,44,83,0,3,Loss,146,154,2,2,2,CLE,3,395,375,2,13.81198750202868,32.19873142616419,23.005359464096433,9.193371962067754
0.4,0.615384615,31.1,10/4/2009,20,24,away,-17,IND,230,353,45,69,17,34,Loss,49,78,5,0,1,SEA,51,279,431,2,0.41107502719585653,48.509263790235885,24.46016940871587,24.049094381520014
0.615384615,0.4,28.9,10/4/2009,24,20,home,17,SEA,353,230,48,63,34,17,Win,78,49,0,5,2,IND,51,431,279,1,-0.41107502719585653,48.509263790235885,24.049094381520014,24.46016940871587
0.4,0.133333333,31.25,10/4/2009,21,15,away,11,KCC,273,88,54,71,27,16,Win,156,124,2,5,1,NYG,43,429,212,2,-6.811921155627232,37.19866593588861,15.19337239013069,22.005293545757922
0.133333333,0.4,28.75,10/4/2009,15,21,home,-11,NYG,88,273,55,62,16,27,Loss,124,156,5,2,2,KCC,43,212,429,1,6.811921155627232,37.19866593588861,22.005293545757922,15.19337239013069
0.642857143,0.4,25.06666667,10/4/2009,24,25,away,-6,NEP,247,234,85,66,21,27,Loss,116,85,2,3,1,BAL,48,363,319,2,10.479773796786821,47.70471927746841,29.092246537127618,18.612472740340795
0.4,0.642857143,34.93333333,10/4/2009,25,24,home,6,BAL,234,247,41,65,27,21,Win,85,116,3,2,2,NEP,48,319,363,1,-10.479773796786821,47.70471927746841,18.612472740340795,29.092246537127618
0.153846154,0.28571428600000004,31.06666667,10/4/2009,12,14,away,-3,WAS,100,152,40,55,13,16,Loss,129,125,3,3,4,TBB,29,229,277,2,-4.922698519244248,30.410023225030024,12.743662352892887,17.666360872137137
0.28571428600000004,0.153846154,28.93333333,10/4/2009,14,12,home,3,TBB,152,100,40,60,16,13,Win,125,129,3,3,2,WAS,29,277,229,4,4.922698519244248,30.410023225030024,17.666360872137137,12.743662352892887
0.5,0.46153846200000004,25.88333333,10/4/2009,19,27,away,-20,JAX,284,305,68,67,17,37,Loss,95,137,0,2,1,TEN,54,379,442,3,-9.93639444263421,55.743120433154644,22.903362995260217,32.83975743789443
0.46153846200000004,0.5,34.11666667,10/4/2009,27,19,home,20,TEN,305,284,30,69,37,17,Win,137,95,2,0,3,JAX,54,442,379,1,9.93639444263421,55.743120433154644,32.83975743789443,22.903362995260217
0.133333333,0.1875,25.78333333,10/4/2009,8,16,away,-23,HOU,120,209,60,57,6,29,Loss,45,120,3,4,2,OAK,35,165,329,3,-6.645667598010011,32.35649478077226,12.855413591381122,19.501081189391137
0.1875,0.133333333,34.21666667,10/4/2009,16,8,home,23,OAK,209,120,5,67,29,6,Win,120,45,4,3,3,HOU,35,329,165,2,6.645667598010011,32.35649478077226,19.501081189391137,12.855413591381124
0.25,0.307692308,27.35,10/4/2009,14,18,away,-14,NOS,112,190,21,58,10,24,Loss,132,153,4,0,1,NYJ,34,244,343,4,1.262974354529483,37.77632231626182,19.51964833539565,18.256673980866168
0.307692308,0.25,32.65,10/4/2009,18,14,home,14,NYJ,190,112,70,64,24,10,Win,153,132,0,4,4,NOS,34,343,244,1,-1.262974354529483,37.77632231626182,18.256673980866168,19.51964833539565
0.090909091,0.529411765,22.85,10/4/2009,10,25,away,-28,MIA,160,86,19,49,10,38,Loss,46,250,6,6,0,BUF,48,206,336,3,3.692294664026111,33.96438516972699,18.82833991687655,15.136045252850439
0.529411765,0.090909091,37.15,10/4/2009,25,10,home,28,BUF,86,160,45,73,38,10,Win,250,46,6,6,3,MIA,48,336,206,0,-3.692294664026111,33.96438516972699,15.136045252850437,18.82833991687655
0.214285714,0.2,33.11666667,10/4/2009,20,18,away,-7,DEN,241,221,70,72,10,17,Loss,74,116,5,3,1,DAL,27,315,337,2,-1.019415024418059,38.7470699967338,18.86382748615787,19.88324251057593
0.2,0.214285714,26.88333333,10/4/2009,18,20,home,7,DAL,221,241,81,57,17,10,Win,116,74,3,5,2,DEN,27,337,315,1,1.019415024418059,38.7470699967338,19.88324251057593,18.86382748615787
0.3125,0.307692308,29.8,10/4/2009,9,13,away,-35,SFO,82,132,73,57,0,35,Loss,95,96,5,4,0,LAR,35,177,228,3,-4.105414078642983,24.932227704026857,10.413406812691937,14.51882089133492
0.307692308,0.3125,30.2,10/4/2009,13,9,home,35,LAR,132,82,33,57,35,0,Win,96,95,4,5,3,SFO,35,228,177,0,4.105414078642983,24.932227704026857,14.51882089133492,10.413406812691937
0.333333333,0.666666667,19.66666667,10/4/2009,17,32,away,-10,PIT,235,320,20,47,28,38,Loss,16,177,3,3,1,LAC,66,251,497,1,6.978307365279777,51.14661078452177,29.062459074900772,22.084151709620997
0.666666667,0.333333333,40.33333333,10/4/2009,32,17,home,10,LAC,320,235,59,73,38,28,Win,177,16,3,3,1,PIT,66,497,251,1,-6.978307365279777,51.14661078452177,22.084151709620997,29.062459074900772
0.538461538,0.571428571,28.26666667,10/5/2009,19,22,away,-7,MIN,342,271,57,62,23,30,Loss,82,63,8,0,1,GBP,53,424,334,2,3.807409156868422,53.20154310650722,28.504476131687824,24.6970669748194
0.571428571,0.538461538,31.73333333,10/5/2009,22,19,home,7,GBP,271,342,10,62,30,23,Win,63,82,0,8,2,MIN,53,334,424,1,-3.807409156868422,53.20154310650722,24.6970669748194,28.504476131687824
0.25,0.352941176,28.43333333,10/11/2009,9,13,away,3,BUF,22,143,29,59,6,3,Win,171,145,1,2,3,CLE,9,193,288,1,-11.253257550752984,25.754232409021938,7.250487429134477,18.50374497988746
0.352941176,0.25,31.56666667,10/11/2009,13,9,home,-3,CLE,143,22,75,68,3,6,Loss,145,171,2,1,1,BUF,9,288,193,3,11.253257550752984,25.754232409021938,18.50374497988746,7.250487429134477
0.375,0.611111111,27.41666667,10/11/2009,18,21,away,8,DET,262,225,59,54,28,20,Win,82,110,3,7,1,PIT,48,344,335,1,-0.06390638540884996,45.29056440867504,22.613329011633095,22.677235397041944
0.611111111,0.375,32.58333333,10/11/2009,21,18,home,-8,PIT,225,262,66,69,20,28,Loss,110,82,7,3,1,DET,48,335,344,1,0.06390638540884996,45.29056440867504,22.677235397041944,22.613329011633095
0.41666666700000005,0.294117647,32.0,10/11/2009,20,20,away,6,KCC,348,232,90,61,6,0,Win,150,72,1,4,0,DAL,6,498,304,2,-7.83913940635904,40.21957654358077,16.190218568610867,24.029357974969905
0.294117647,0.41666666700000005,34.63333333,10/11/2009,20,20,home,-6,DAL,232,348,50,74,0,6,Loss,72,150,4,1,2,KCC,6,304,498,0,7.83913940635904,40.21957654358077,24.029357974969905,16.190218568610867
0.636363636,0.41666666700000005,27.35,10/11/2009,21,27,away,28,LAR,288,278,44,53,38,10,Win,89,122,2,2,4,MIN,48,377,400,1,1.0037579175743616,57.98769982337672,29.495728870475542,28.49197095290118
0.41666666700000005,0.636363636,32.65,10/11/2009,27,21,home,-28,MIN,278,288,82,70,10,38,Loss,122,89,2,2,1,LAR,48,400,377,4,-1.0037579175743616,57.98769982337672,28.49197095290118,29.495728870475542
0.090909091,0.5,23.93333333,10/11/2009,7,27,away,-37,NYG,64,263,67,44,7,44,Loss,60,220,6,0,1,OAK,51,124,483,3,4.375578851772524,45.39678209009388,24.8861804709332,20.510601619160678
0.5,0.090909091,36.06666667,10/11/2009,27,7,home,37,OAK,263,64,37,65,44,7,Win,220,60,0,6,3,NYG,51,483,124,1,-4.375578851772524,45.39678209009388,20.510601619160678,24.8861804709332
0.5,0.4,34.55,10/11/2009,22,16,away,-19,PHI,218,249,30,75,14,33,Loss,85,76,3,3,0,TBB,47,303,325,3,-3.4012814593613143,44.90086111669117,20.749789828664927,24.15107128802624
0.4,0.5,25.45,10/11/2009,16,22,home,19,TBB,249,218,111,48,33,14,Win,76,85,3,3,3,PHI,47,325,303,0,3.4012814593613143,44.90086111669117,24.15107128802624,20.749789828664927
0.222222222,0.333333333,28.71666667,10/11/2009,15,16,away,-3,CAR,124,162,20,52,17,20,Loss,74,86,5,3,2,WAS,37,198,248,1,-0.912243096398571,31.424271420171372,15.256014161886402,16.16825725828497
0.333333333,0.222222222,31.28333333,10/11/2009,16,15,home,3,WAS,162,124,27,60,20,17,Win,86,74,3,5,1,CAR,37,248,198,2,0.912243096398571,31.424271420171372,16.16825725828497,15.256014161886402
0.384615385,0.272727273,34.31666667,10/11/2009,22,12,away,3,BAL,261,175,39,66,17,14,Win,142,82,1,2,2,CIN,31,403,257,2,9.459970735271543,40.83450168419784,25.147236209734693,15.687265474463148
0.272727273,0.384615385,25.68333333,10/11/2009,12,22,home,-3,CIN,175,261,76,51,14,17,Loss,82,142,2,1,2,BAL,31,257,403,2,-9.459970735271543,40.83450168419784,15.687265474463146,25.147236209734693
0.571428571,0.28571428600000004,36.48333333,10/11/2009,28,13,away,35,SFO,329,179,90,72,45,10,Win,148,100,0,3,3,ATL,55,477,279,2,-5.547999064073082,48.0590724696462,21.25553670278656,26.803535766859643
0.28571428600000004,0.571428571,23.51666667,10/11/2009,13,28,home,-35,ATL,179,329,92,58,10,45,Loss,100,148,3,0,2,SFO,55,279,477,3,5.547999064073082,48.0590724696462,26.803535766859643,21.25553670278656
0.153846154,0.428571429,25.26666667,10/11/2009,10,24,away,-41,SEA,161,236,73,52,0,41,Loss,38,143,5,1,0,JAX,41,199,379,2,-0.46382723198087206,34.76813012327643,17.152151445647778,17.61597867762865
0.428571429,0.153846154,34.73333333,10/11/2009,24,10,home,41,JAX,236,161,10,71,41,0,Win,143,38,1,5,2,SEA,41,379,199,0,0.46382723198087206,34.76813012327643,17.61597867762865,17.152151445647778
0.307692308,0.222222222,33.41666667,10/11/2009,23,19,away,-7,ARI,371,296,53,71,21,28,Loss,45,44,0,1,1,HOU,49,416,340,1,0.34782054255709827,45.508730758944225,22.92827565075066,22.580455108193565
0.222222222,0.307692308,26.58333333,10/11/2009,19,23,home,7,HOU,296,371,40,55,28,21,Win,44,45,1,0,1,ARI,49,340,416,1,-0.34782054255709827,45.508730758944225,22.580455108193565,22.92827565075066
0.35714285700000004,0.428571429,28.36666667,10/11/2009,18,27,away,-3,DEN,209,321,46,61,0,3,Loss,96,103,1,2,2,NEP,3,305,424,1,8.021335662929472,44.646935865599254,26.334135764264364,18.31280010133489
0.428571429,0.35714285700000004,36.48333333,10/11/2009,27,18,home,3,NEP,321,209,20,75,3,0,Win,103,96,2,1,1,DEN,3,424,305,2,-8.021335662929472,44.646935865599254,18.31280010133489,26.334135764264364
0.571428571,0.35714285700000004,33.63333333,10/11/2009,23,12,away,22,TEN,309,155,48,67,31,9,Win,58,90,0,1,2,IND,40,367,245,2,-7.21870858209718,44.770397680718936,18.77584454931088,25.994553131408058
0.35714285700000004,0.571428571,26.36666667,10/11/2009,12,23,home,-22,IND,155,309,89,57,9,31,Loss,90,58,1,0,2,TEN,40,245,367,2,7.21870858209718,44.770397680718936,25.994553131408058,18.77584454931088
0.363636364,0.642857143,26.41666667,10/12/2009,20,23,away,-4,MIA,171,262,56,55,27,31,Loss,138,151,1,0,0,NYJ,58,309,413,0,-2.1253713800334113,47.60780668467392,22.741217652320252,24.866589032353666
0.642857143,0.363636364,33.58333333,10/12/2009,23,20,home,4,NYJ,262,171,112,64,31,27,Win,151,138,0,1,0,MIA,58,413,309,0,2.1253713800334113,47.60780668467392,24.866589032353666,22.741217652320252
0.5,0.41666666700000005,36.25,10/18/2009,26,14,away,11,CIN,385,250,60,73,28,17,Win,87,46,2,1,3,HOU,45,472,296,2,-0.22134316567242962,52.91835182515997,26.34850432974377,26.569847495416198
0.41666666700000005,0.5,23.75,10/18/2009,14,26,home,-11,HOU,250,385,45,53,17,28,Loss,46,87,1,2,2,CIN,45,296,472,3,0.22134316567242962,52.91835182515997,26.569847495416198,26.34850432974377
0.0,0.5,19.2,10/18/2009,10,23,away,-26,GBP,71,328,40,48,0,26,Loss,78,107,5,5,2,DET,26,149,435,3,2.5045593454151565,41.234954311153615,21.869756828284387,19.365197482869227
0.5,0.0,40.8,10/18/2009,23,10,home,26,DET,328,71,130,72,26,0,Win,107,78,5,5,3,GBP,26,435,149,2,-2.5045593454151565,41.234954311153615,19.365197482869227,21.869756828284387
0.384615385,0.35714285700000004,25.25,10/18/2009,20,19,away,-2,MIN,367,259,74,64,31,33,Loss,81,167,3,3,0,BAL,64,448,426,0,3.7763093707842827,46.50641746988833,25.141363420336308,21.365054049552025
0.35714285700000004,0.384615385,34.75,10/18/2009,19,20,home,2,BAL,259,367,15,63,33,31,Win,167,81,3,3,0,MIN,64,426,448,0,-3.7763093707842827,46.50641746988833,21.365054049552025,25.141363420336308
0.3,0.538461538,23.88333333,10/18/2009,17,28,away,-21,NOS,241,369,110,57,27,48,Loss,84,124,2,0,0,NYG,75,325,493,2,-1.7775790419315385,53.953674405731945,26.088047681900203,27.865626723831742
0.538461538,0.3,36.11666667,10/18/2009,28,17,home,21,NYG,369,241,55,70,48,27,Win,124,84,0,2,2,NOS,75,493,325,0,1.7775790419315385,53.953674405731945,27.865626723831742,26.088047681900203
0.571428571,0.545454545,32.35,10/18/2009,22,12,away,7,TBB,55,121,30,66,28,21,Win,267,124,1,4,2,CAR,49,322,245,3,-5.129250480404144,43.956755926419824,19.41375272300784,24.543003203411985
0.545454545,0.571428571,27.65,10/18/2009,12,22,home,-7,CAR,121,55,40,46,21,28,Loss,124,267,4,1,3,TBB,49,245,322,2,5.129250480404144,43.956755926419824,24.543003203411985,19.41375272300784
0.235294118,0.14285714300000002,37.16666667,10/18/2009,16,7,away,8,WAS,158,147,30,72,14,6,Win,110,118,5,3,2,KCC,20,268,265,0,-9.918668102923716,23.380022885735656,6.730677391405969,16.649345494329687
0.14285714300000002,0.235294118,22.83333333,10/18/2009,7,16,home,-8,KCC,147,158,63,53,6,14,Loss,118,110,3,5,0,WAS,20,265,268,2,9.918668102923716,23.380022885735656,16.649345494329687,6.73067739140597
0.333333333,0.6875,24.8,10/18/2009,13,33,away,-3,JAX,207,326,52,53,0,3,Loss,55,166,1,3,3,LAR,3,262,492,1,-8.61356363961145,49.04240063874847,20.21441849956851,28.82798213917996
0.6875,0.333333333,42.2,10/18/2009,33,13,home,3,LAR,326,207,15,84,3,0,Win,166,55,3,1,1,JAX,3,492,262,3,8.61356363961145,49.04240063874847,28.82798213917996,20.21441849956851
0.384615385,0.363636364,23.23333333,10/18/2009,12,28,away,-13,PIT,106,403,45,51,14,27,Loss,91,140,2,3,4,CLE,41,197,543,4,5.004287195593992,48.846954167105764,26.925620681349876,21.921333485755888
0.363636364,0.384615385,36.76666667,10/18/2009,28,12,home,13,CLE,403,106,30,74,27,14,Win,140,91,3,2,4,PIT,41,543,197,4,-5.004287195593992,48.846954167105764,21.921333485755888,26.925620681349876
0.5,0.0,42.83333333,10/18/2009,21,7,away,24,SEA,282,114,76,71,27,3,Win,62,14,2,5,2,ARI,30,344,128,2,3.312362126994005,28.646596690541795,15.9794794087679,12.667117281773894
0.0,0.5,17.16666667,10/18/2009,7,21,home,-24,ARI,114,282,56,46,3,27,Loss,14,62,5,2,2,SEA,30,128,344,2,-3.312362126994005,28.646596690541795,12.667117281773894,15.9794794087679
0.125,0.28571428600000004,26.96666667,10/18/2009,14,18,away,-4,OAK,216,209,38,66,9,13,Loss,67,116,6,2,2,PHI,22,283,325,0,-2.479752281199625,37.87445597348916,17.69735184614477,20.177104127344393
0.28571428600000004,0.125,33.03333333,10/18/2009,18,14,home,4,PHI,209,216,23,65,13,9,Win,116,67,2,6,0,OAK,22,325,283,2,2.479752281199625,37.87445597348916,20.177104127344393,17.69735184614477
0.3125,0.2,39.05,10/18/2009,20,15,away,3,NYJ,154,96,64,73,3,0,Win,142,318,1,2,6,BUF,3,296,414,2,-14.386900649336305,37.53874859694176,11.575923973802727,25.96282462313903
0.2,0.3125,33.21666667,10/18/2009,15,20,home,-3,BUF,96,154,96,72,0,3,Loss,318,142,2,1,2,NYJ,3,414,296,6,14.386900649336305,37.53874859694176,25.96282462313903,11.575923973802727
0.2,0.454545455,21.0,10/18/2009,9,32,away,-59,NEP,-7,426,55,50,0,59,Loss,193,193,0,2,0,TEN,59,186,619,5,5.699881879983174,49.26130204329246,27.480591961637817,21.780710081654643
0.454545455,0.2,39.0,10/18/2009,32,9,home,59,TEN,426,-7,40,77,59,0,Win,193,193,2,0,5,NEP,59,619,186,0,-5.699881879983174,49.26130204329246,21.780710081654643,27.480591961637817
0.5625,0.41666666700000005,33.9,10/18/2009,21,16,away,-7,ATL,290,185,65,68,14,21,Loss,83,68,2,0,2,CHI,35,373,253,3,-5.412193307810458,44.07537469965032,19.331590695919928,24.74378400373039
0.41666666700000005,0.5625,26.1,10/18/2009,16,21,home,7,CHI,185,290,70,56,21,14,Win,68,83,0,2,3,ATL,35,253,373,2,5.412193307810458,44.07537469965032,24.74378400373039,19.331590695919928
0.5625,0.181818182,30.71666667,10/19/2009,19,20,away,11,LAC,227,238,48,63,34,23,Win,101,73,1,5,1,DEN,57,328,311,0,2.641962475514914,40.983930663089104,21.81294656930201,19.170984093787094
0.181818182,0.5625,29.28333333,10/19/2009,20,19,home,-11,DEN,238,227,44,59,23,34,Loss,73,101,5,1,0,LAC,57,311,328,1,-2.641962475514914,40.983930663089104,19.170984093787094,21.81294656930201
0.545454545,0.166666667,35.9,10/25/2009,25,12,away,28,CLE,258,81,70,63,31,3,Win,202,58,0,2,2,GBP,34,460,139,0,3.9017735704868137,39.22526650301879,21.5635200367528,17.66174646626599
0.166666667,0.545454545,24.1,10/25/2009,12,25,home,-28,GBP,81,258,40,52,3,31,Loss,58,202,2,0,0,CLE,34,139,460,2,-3.9017735704868137,39.22526650301879,17.66174646626599,21.5635200367528
0.470588235,0.2,32.75,10/25/2009,17,10,away,30,KCC,268,82,59,66,37,7,Win,135,121,0,5,3,LAC,44,403,203,0,-8.50043897211544,31.995664406707547,11.747612717296054,20.248051689411493
0.2,0.470588235,27.25,10/25/2009,10,17,home,-30,LAC,82,268,41,61,7,37,Loss,121,135,5,0,0,KCC,44,203,403,3,8.50043897211544,31.995664406707547,20.248051689411493,11.747612717296054
0.363636364,0.46153846200000004,29.51666667,10/25/2009,17,18,away,-3,HOU,238,246,65,54,21,24,Loss,59,90,2,2,1,SFO,45,297,336,2,-0.20987280703256062,43.67736640880854,21.73374680088799,21.94361960792055
0.46153846200000004,0.363636364,30.48333333,10/25/2009,18,17,home,3,SFO,246,238,77,59,24,21,Win,90,59,2,2,2,HOU,45,336,297,1,0.20987280703256062,43.67736640880854,21.94361960792055,21.73374680088799
0.666666667,0.307692308,30.65,10/25/2009,24,14,away,36,LAR,235,117,51,60,42,6,Win,156,155,0,3,2,IND,48,391,272,0,-3.362242873980808,45.44087723086758,21.039317178443383,24.401560052424195
0.307692308,0.666666667,29.35,10/25/2009,14,24,home,-36,IND,117,235,73,59,6,42,Loss,155,156,3,0,0,LAR,48,272,391,2,3.362242873980808,45.44087723086758,24.401560052424195,21.039317178443383
0.5,0.333333333,36.96666667,10/25/2009,21,14,away,-10,PIT,297,152,78,77,17,27,Loss,89,107,4,4,1,MIN,44,386,259,2,-1.7856510181889518,40.32993199854178,19.272140490176415,21.057791508365366
0.333333333,0.5,23.03333333,10/25/2009,14,21,home,10,MIN,152,297,15,49,27,17,Win,107,89,4,4,2,PIT,44,259,386,1,1.7856510181889518,40.32993199854178,21.057791508365366,19.272140490176415
0.5,0.26666666699999997,33.25,10/25/2009,18,10,away,28,TBB,307,151,66,61,35,7,Win,107,89,1,3,3,NEP,42,414,240,2,1.5315187553637024,39.880901805120594,20.706210280242146,19.174691524878448
0.26666666699999997,0.5,26.75,10/25/2009,10,18,home,-28,NEP,151,307,55,59,7,35,Loss,89,107,3,1,2,TBB,42,240,414,3,-1.5315187553637024,39.880901805120594,19.174691524878448,20.706210280242146
0.214285714,0.153846154,25.33333333,10/25/2009,9,20,away,11,CAR,114,309,22,54,20,9,Win,53,116,2,2,4,BUF,29,167,425,0,-5.322190285168741,37.08345803112182,15.880633872976539,21.202824158145283
0.153846154,0.214285714,34.66666667,10/25/2009,20,9,home,-11,BUF,309,114,67,71,9,20,Loss,116,53,2,2,0,CAR,29,425,167,4,5.322190285168741,37.08345803112182,21.202824158145283,15.88063387297654
0.5625,0.41666666700000005,35.95,10/25/2009,26,13,away,38,OAK,131,144,8,71,38,0,Win,316,119,1,3,4,NYJ,38,447,263,0,-1.4445629713005665,50.39330469280104,24.474370860750234,25.918933832050804
0.41666666700000005,0.5625,24.05,10/25/2009,13,26,home,-38,NYJ,144,131,24,52,0,38,Loss,119,316,3,1,0,OAK,38,263,447,4,1.4445629713005665,50.39330469280104,25.918933832050804,24.474370860750234
0.5,0.666666667,23.63333333,10/25/2009,15,30,away,-35,CIN,244,233,44,52,10,45,Loss,35,215,1,0,0,CHI,55,279,448,4,3.797891163257912,52.86217871524038,28.330034939249146,24.532143775991237
0.666666667,0.5,36.36666667,10/25/2009,30,15,home,35,CHI,233,244,20,69,45,10,Win,215,35,0,1,4,CIN,55,448,279,0,-3.797891163257912,52.86217871524038,24.532143775991237,28.330034939249146
0.5,0.46153846200000004,31.13333333,10/25/2009,21,18,away,-16,DAL,174,299,30,65,21,37,Loss,124,115,4,2,1,ATL,58,298,414,3,-0.4659027403284366,44.18520617869983,21.859651719185695,22.325554459514134
0.46153846200000004,0.5,28.86666667,10/25/2009,18,21,home,16,ATL,299,174,50,59,37,21,Win,115,124,2,4,3,DAL,58,414,298,1,0.4659027403284366,44.18520617869983,22.325554459514134,21.859651719185695
0.333333333,0.444444444,33.03333333,10/25/2009,22,17,away,12,MIA,276,197,25,70,46,34,Win,138,137,5,2,3,NOS,80,414,334,4,-2.495138267318529,46.97695021577563,22.24090597422855,24.73604424154708
0.444444444,0.333333333,26.96666667,10/25/2009,17,22,home,-12,NOS,197,276,55,69,34,46,Loss,137,138,2,5,4,MIA,80,334,414,3,2.495138267318529,46.97695021577563,24.73604424154708,22.24090597422855
0.214285714,0.26666666699999997,29.73333333,10/25/2009,15,15,away,7,NYG,216,220,60,60,24,17,Win,72,107,2,3,4,ARI,41,288,327,2,-1.9784366586243012,37.90983452927253,17.965698935324113,19.944135593948417
0.26666666699999997,0.214285714,30.26666667,10/25/2009,15,15,home,-7,ARI,220,216,30,66,17,24,Loss,107,72,3,2,2,NYG,41,327,288,4,1.9784366586243012,37.90983452927253,19.944135593948417,17.965698935324113
0.26666666699999997,0.25,28.3,10/26/2009,11,21,away,10,WAS,140,246,66,56,27,17,Win,122,62,3,6,4,PHI,44,262,308,0,-3.0035230218177755,36.37588985596382,16.68618341707302,19.6897064388908
0.25,0.26666666699999997,31.7,10/26/2009,21,11,home,-10,PHI,246,140,60,68,17,27,Loss,62,122,6,3,0,WAS,44,308,262,4,3.0035230218177755,36.37588985596382,19.6897064388908,16.68618341707302
0.538461538,0.2,39.13333333,11/1/2009,24,9,away,21,BUF,257,107,45,76,31,10,Win,182,97,1,2,2,HOU,41,439,204,3,-2.7848167969721667,43.72345050526212,20.469316854144978,23.254133651117144
0.2,0.538461538,20.86666667,11/1/2009,9,24,home,-21,HOU,107,257,36,45,10,31,Loss,97,182,2,1,3,BUF,41,204,439,2,2.7848167969721667,43.72345050526212,23.254133651117144,20.469316854144978
0.090909091,0.375,22.58333333,11/1/2009,9,20,away,-24,CHI,74,199,30,50,6,30,Loss,117,170,1,4,1,CLE,36,191,369,5,-0.9610671347299373,32.37039698600357,15.704664925636816,16.665732060366754
0.375,0.090909091,37.41666667,11/1/2009,20,9,home,24,CLE,199,74,35,71,30,6,Win,170,117,4,1,5,CHI,36,369,191,1,0.9610671347299373,32.37039698600357,16.665732060366754,15.704664925636816
0.428571429,0.538461538,25.25,11/1/2009,18,26,away,-21,DAL,229,249,53,64,17,38,Loss,79,113,3,2,1,SEA,55,308,362,2,-1.870812517799969,43.55770959291141,20.84344853755572,22.71426105535569
0.538461538,0.428571429,34.75,11/1/2009,26,18,home,21,SEA,249,229,43,67,38,17,Win,113,79,2,3,2,DAL,55,362,308,1,1.870812517799969,43.55770959291141,22.71426105535569,20.84344853755572
0.25,0.375,27.95,11/1/2009,21,17,away,7,DET,212,162,27,62,17,10,Win,150,127,0,2,1,LAR,27,362,289,1,-6.863249811923959,40.19368994295879,16.665220065517417,23.528469877441374
0.375,0.25,32.05,11/1/2009,17,21,home,-7,LAR,162,212,67,68,10,17,Loss,127,150,2,0,1,DET,27,289,362,1,6.863249811923959,40.19368994295879,23.528469877441374,16.665220065517417
0.2,0.42105263200000004,26.43333333,11/1/2009,16,20,away,-4,IND,182,349,50,54,14,18,Loss,113,61,4,3,0,SFO,32,295,410,2,0.42259078926507065,40.84207613454082,20.632333461902945,20.209742672637873
0.42105263200000004,0.2,33.56666667,11/1/2009,20,16,home,4,SFO,349,182,38,73,18,14,Win,61,113,3,4,2,IND,32,410,295,0,-0.42259078926507065,40.84207613454082,20.209742672637873,20.632333461902945
0.28571428600000004,0.214285714,25.9,11/1/2009,10,23,away,5,NYJ,52,251,25,51,30,25,Win,52,127,6,2,1,MIA,55,104,378,1,-1.8156937552076347,28.537082293207405,13.360694268999886,15.176388024207519
0.214285714,0.28571428600000004,34.1,11/1/2009,23,10,home,-5,MIA,251,52,40,77,25,30,Loss,127,52,2,6,1,NYJ,55,378,104,1,1.8156937552076347,28.537082293207405,15.176388024207519,13.360694268999886
0.23076923100000002,0.611111111,26.38333333,11/1/2009,17,16,away,-23,BAL,134,167,35,58,7,30,Loss,66,125,2,2,0,DEN,37,200,292,1,2.1789559395161557,33.19144839717708,17.68520216834662,15.506246228830463
0.611111111,0.23076923100000002,33.61666667,11/1/2009,16,17,home,23,DEN,167,134,94,62,30,7,Win,125,66,2,2,1,BAL,37,292,200,0,-2.1789559395161557,33.19144839717708,15.506246228830463,17.68520216834662
0.5,0.545454545,35.55,11/1/2009,21,17,away,-23,PHI,215,211,25,73,17,40,Loss,141,180,2,2,2,NYG,57,356,391,3,1.9540471796711554,53.94708528235118,27.95056623101117,25.996519051340012
0.545454545,0.5,24.45,11/1/2009,17,21,home,23,NYG,211,215,45,49,40,17,Win,180,141,2,2,3,PHI,57,391,356,2,-1.9540471796711554,53.94708528235118,25.996519051340012,27.95056623101117
0.333333333,0.533333333,20.28333333,11/1/2009,12,20,away,-17,TEN,113,125,27,49,13,30,Loss,217,305,4,0,0,JAX,43,330,430,2,-4.760639622973862,44.13648353948239,19.687921958254265,24.448561581228127
0.533333333,0.333333333,39.71666667,11/1/2009,20,12,home,17,JAX,125,113,20,67,30,13,Win,305,217,0,4,2,TEN,43,430,330,0,4.760639622973862,44.13648353948239,24.448561581228127,19.687921958254265
0.384615385,0.636363636,29.51666667,11/1/2009,13,20,away,-8,LAC,81,246,31,54,16,24,Loss,99,100,5,1,2,OAK,40,180,346,1,1.2145625902529407,42.06424000646431,21.639401298358624,20.424838708105685
0.636363636,0.384615385,30.48333333,11/1/2009,20,13,home,8,OAK,246,81,40,56,24,16,Win,100,99,1,5,1,LAC,40,346,180,2,-1.2145625902529407,42.06424000646431,20.424838708105685,21.639401298358624
0.428571429,0.4375,27.46666667,11/1/2009,19,21,away,12,GBP,244,261,29,60,38,26,Win,111,90,0,6,0,MIN,64,355,351,2,1.0664173688206038,46.551210314933286,23.808813841876944,22.742396473056342
0.4375,0.428571429,32.53333333,11/1/2009,21,19,home,-12,MIN,261,244,45,67,26,38,Loss,90,111,6,0,2,GBP,64,351,355,0,-1.0664173688206038,46.551210314933286,22.742396473056342,23.808813841876944
0.5,0.4,32.96666667,11/1/2009,13,23,away,13,ARI,85,226,72,60,34,21,Win,270,94,1,2,6,CAR,55,355,320,0,-6.674522603853465,46.28241581913558,19.80394660764106,26.47846921149452
0.4,0.5,27.03333333,11/1/2009,23,13,home,-13,CAR,226,85,35,65,21,34,Loss,94,270,2,1,0,ARI,55,320,355,6,6.674522603853465,46.28241581913558,26.47846921149452,19.80394660764106
0.272727273,0.583333333,26.76666667,11/2/2009,21,23,away,-8,NOS,281,291,25,69,27,35,Loss,161,146,3,2,4,ATL,62,442,437,3,-1.4432176418556164,54.35821002187588,26.45749619001013,27.900713831865747
0.583333333,0.272727273,33.23333333,11/2/2009,23,21,home,8,ATL,291,281,65,70,35,27,Win,146,161,2,3,3,NOS,62,437,442,4,1.4432176418556164,54.35821002187588,27.900713831865747,26.45749619001013
0.5625,0.363636364,33.53333333,11/8/2009,17,18,away,-14,ATL,176,125,88,64,17,31,Loss,136,181,5,3,1,WAS,48,312,306,1,-6.166043467996067,37.27093352261509,15.55244502730951,21.71848849530558
0.363636364,0.5625,26.46666667,11/8/2009,18,17,home,14,WAS,125,176,54,54,31,17,Win,181,136,3,5,1,ATL,48,306,312,1,6.166043467996067,37.27093352261509,21.71848849530558,15.55244502730951
0.571428571,0.384615385,33.26666667,11/8/2009,27,20,away,20,CHI,256,347,15,65,41,21,Win,182,70,1,4,1,ARI,62,438,417,1,-0.6962777066522765,52.62344371413654,25.963583003742134,26.65986071039441
0.384615385,0.571428571,26.73333333,11/8/2009,20,27,home,-20,ARI,347,256,89,63,21,41,Loss,70,182,4,1,1,CHI,62,417,438,1,0.6962777066522765,52.62344371413654,26.65986071039441,25.963583003742134
0.1,0.444444444,20.0,11/8/2009,16,20,away,-10,CIN,160,223,80,53,7,17,Loss,55,146,4,1,1,BAL,24,215,369,2,5.147567247151626,34.95156767773547,20.049567462443548,14.90200021529192
0.444444444,0.1,40.0,11/8/2009,20,16,home,10,BAL,223,160,40,73,17,7,Win,146,55,1,4,2,CIN,24,369,215,1,-5.147567247151626,34.95156767773547,14.90200021529192,20.049567462443548
0.625,0.5,34.55,11/8/2009,22,27,away,-3,IND,301,306,103,71,17,20,Loss,81,72,2,2,2,HOU,37,382,378,3,-10.8210806321266,56.964063478358106,23.071491423115752,33.892572055242354
0.5,0.625,25.45,11/8/2009,27,22,home,3,HOU,306,301,40,71,20,17,Win,72,81,2,2,3,IND,37,378,382,2,10.8210806321266,56.964063478358106,33.892572055242354,23.071491423115752
0.529411765,0.46153846200000004,31.11666667,11/8/2009,21,22,away,-10,NEP,201,323,35,70,17,27,Loss,133,109,2,2,1,MIA,44,334,432,0,3.8682904873519686,45.55471602977946,24.711503258565717,20.843212771213746
0.46153846200000004,0.529411765,28.88333333,11/8/2009,22,21,home,10,MIA,323,201,49,63,27,17,Win,109,133,2,2,0,NEP,44,432,334,1,-3.8682904873519686,45.55471602977946,20.843212771213746,24.711503258565717
0.35714285700000004,0.25,35.28333333,11/8/2009,20,17,away,-10,TBB,234,198,35,73,28,38,Loss,170,81,6,1,1,GBP,66,404,279,3,-2.0098415429430467,42.03859371140983,20.01437608423339,22.02421762717644
0.25,0.35714285700000004,24.71666667,11/8/2009,17,20,home,10,GBP,198,234,15,57,38,28,Win,81,170,1,6,3,TBB,66,279,404,1,2.0098415429430467,42.03859371140983,22.02421762717644,20.01437608423339
0.307692308,0.5625,23.78333333,11/8/2009,14,21,away,-3,JAX,241,253,10,56,21,24,Loss,60,173,3,1,1,KCC,45,301,426,0,-4.0386638715340855,42.02686013679057,18.994098132628242,23.032762004162326
0.5625,0.307692308,36.21666667,11/8/2009,21,14,home,3,KCC,253,241,31,69,24,21,Win,173,60,1,3,0,JAX,45,426,301,1,4.0386638715340855,42.02686013679057,23.032762004162326,18.994098132628242
0.375,0.46666666700000003,29.3,11/8/2009,17,25,away,-12,SEA,186,342,77,65,20,32,Loss,114,55,2,1,2,DET,52,300,397,5,-2.65963473788619,49.55129264164646,23.445828951880138,26.105463689766324
0.46666666700000003,0.375,30.7,11/8/2009,25,17,home,12,DET,342,186,45,71,32,20,Win,55,114,1,2,5,SEA,52,397,300,2,2.65963473788619,49.55129264164646,26.105463689766324,23.445828951880138
0.5,0.5,32.43333333,11/8/2009,21,18,away,-10,NOS,189,330,37,71,20,30,Loss,182,84,2,1,2,CAR,50,371,414,3,-5.871043464856823,53.462838875548826,23.795897705346,29.666941170202826
0.5,0.5,27.56666667,11/8/2009,18,21,home,10,CAR,330,189,55,59,30,20,Win,84,182,1,2,3,NOS,50,414,371,2,5.871043464856823,53.462838875548826,29.666941170202826,23.795897705346
0.3,0.35714285700000004,22.21666667,11/8/2009,18,19,away,1,NYG,192,188,20,53,21,20,Win,34,116,2,5,1,LAC,41,226,304,2,-0.947632376221339,37.90132331168677,18.476845467732716,19.42447784395405
0.35714285700000004,0.3,37.78333333,11/8/2009,19,18,home,-1,LAC,188,192,104,67,20,21,Loss,116,34,5,2,2,NYG,41,304,226,1,0.947632376221339,37.90132331168677,19.42447784395405,18.476845467732716
0.333333333,0.307692308,26.16666667,11/8/2009,14,25,away,7,SFO,163,250,58,55,34,27,Win,152,108,1,4,4,TEN,61,315,358,0,-0.4593696738867479,42.76462808808719,21.152629207100222,21.61199888098697
0.307692308,0.333333333,33.83333333,11/8/2009,25,14,home,-7,TEN,250,163,25,69,27,34,Loss,108,152,4,1,0,SFO,61,358,315,4,0.4593696738867479,42.76462808808719,21.61199888098697,21.152629207100222
0.46666666700000003,0.333333333,31.73333333,11/8/2009,18,17,away,4,PHI,282,209,70,61,20,16,Win,76,88,4,3,2,DAL,36,358,297,1,1.3995676247485296,43.835474278805364,22.617520951776946,21.217953327028418
0.333333333,0.46666666700000003,28.26666667,11/8/2009,17,18,home,-4,DAL,209,282,82,57,16,20,Loss,88,76,3,4,1,PHI,36,297,358,2,-1.3995676247485296,43.835474278805364,21.217953327028418,22.617520951776946
0.583333333,0.35714285700000004,33.05,11/9/2009,21,12,away,18,DEN,202,215,28,61,28,10,Win,173,27,3,2,3,PIT,38,375,242,2,7.400595384700399,44.28308793141704,25.84184165805872,18.441246273358324
0.35714285700000004,0.583333333,26.95,11/9/2009,12,21,home,-18,PIT,215,202,25,54,10,28,Loss,27,173,2,3,2,DEN,38,242,375,3,-7.400595384700399,44.28308793141704,18.441246273358324,25.84184165805872
0.470588235,0.428571429,28.45,11/12/2009,19,12,away,-4,SFO,307,106,75,73,6,10,Loss,43,110,0,2,1,CHI,16,350,216,5,-9.795224596232678,40.151374065763356,15.178074734765339,24.973299330998017
0.428571429,0.470588235,31.55,11/12/2009,12,19,home,4,CHI,106,307,77,53,10,6,Win,110,43,2,0,5,SFO,16,216,350,1,9.795224596232678,40.151374065763356,24.973299330998017,15.178074734765339
0.35714285700000004,0.647058824,28.66666667,11/15/2009,14,20,away,-24,TEN,207,210,65,58,17,41,Loss,89,168,2,0,1,BUF,58,296,378,2,-6.0618843686529935,46.82524114229751,20.38167838682226,26.44356275547525
0.647058824,0.35714285700000004,31.33333333,11/15/2009,20,14,home,24,BUF,210,207,75,60,41,17,Win,168,89,0,2,2,TEN,58,378,296,1,6.0618843686529935,46.82524114229751,26.44356275547525,20.38167838682226
0.28571428600000004,0.2,29.13333333,11/15/2009,14,16,away,6,PIT,157,146,87,61,18,12,Win,61,80,2,4,1,CIN,30,218,226,0,-1.7296132695438016,25.520843357128633,11.895615043792416,13.625228313336217
0.2,0.28571428600000004,30.86666667,11/15/2009,16,14,home,-6,CIN,146,157,50,62,12,18,Loss,80,61,4,2,0,PIT,30,226,218,1,1.7296132695438016,25.520843357128633,13.625228313336217,11.895615043792416
0.6,0.384615385,27.96666667,11/15/2009,19,23,away,5,LAR,217,293,40,56,28,23,Win,203,141,1,2,1,NOS,51,420,434,3,-0.03234134032637348,54.24776638427901,27.107712521976318,27.140053862302693
0.384615385,0.6,32.03333333,11/15/2009,23,19,home,-5,NOS,293,217,20,71,23,28,Loss,141,203,2,1,3,LAR,51,434,420,1,0.03234134032637348,54.24776638427901,27.140053862302693,27.107712521976318
0.307692308,0.35714285700000004,28.76666667,11/15/2009,16,23,away,-2,MIA,180,175,77,62,23,25,Loss,121,199,4,0,2,TBB,48,301,374,2,-6.468109885182271,40.642872026108805,17.087381070463266,23.55549095564554
0.35714285700000004,0.307692308,31.23333333,11/15/2009,23,16,home,2,TBB,175,180,30,68,25,23,Win,199,121,0,4,2,MIA,48,374,301,2,6.468109885182271,40.642872026108805,23.55549095564554,17.087381070463266
0.352941176,0.272727273,29.61666667,11/15/2009,19,19,away,-17,MIN,204,340,40,76,10,27,Loss,93,152,3,1,2,DET,37,297,492,1,-9.310489072546183,45.79950122410228,18.244506075778048,27.55499514832423
0.272727273,0.352941176,30.38333333,11/15/2009,19,19,home,17,DET,340,204,91,63,27,10,Win,152,93,1,3,1,MIN,37,492,297,2,9.310489072546183,45.79950122410228,27.55499514832423,18.244506075778048
0.538461538,0.538461538,31.11666667,11/15/2009,18,19,away,2,NYJ,208,212,40,60,24,22,Win,139,110,2,0,3,JAX,46,347,322,1,-2.742251060888381,48.81152516831054,23.03463705371108,25.77688811459946
0.538461538,0.538461538,28.88333333,11/15/2009,19,18,home,-2,JAX,212,208,26,60,22,24,Loss,110,139,0,2,1,NYJ,46,322,347,3,2.742251060888381,48.81152516831054,25.77688811459946,23.03463705371108
0.41666666700000005,0.5,24.28333333,11/15/2009,14,22,away,-10,WAS,185,214,45,56,17,27,Loss,120,174,3,3,0,DEN,44,305,388,2,-4.621105290599017,42.32518069744143,18.852037703421207,23.473142994020225
0.5,0.41666666700000005,35.71666667,11/15/2009,22,14,home,10,DEN,214,185,19,70,27,17,Win,174,120,3,3,2,WAS,44,388,305,0,4.621105290599017,42.32518069744143,23.473142994020225,18.852037703421207
0.428571429,0.538461538,31.85,11/15/2009,22,19,away,-9,CAR,224,195,26,70,19,28,Loss,176,185,0,0,0,ATL,47,400,380,2,-7.498546732127754,48.33886780354259,20.420160535707417,27.918707267835174
0.538461538,0.428571429,28.15,11/15/2009,19,22,home,9,ATL,195,224,48,58,28,19,Win,185,176,0,0,2,CAR,47,380,400,0,7.498546732127754,48.33886780354259,27.918707267835174,20.420160535707417
0.066666667,0.125,28.9,11/15/2009,14,11,away,6,OAK,206,90,35,67,16,10,Win,112,182,2,2,2,KCC,26,318,272,3,-10.142836785850912,32.19502767481071,11.0260954444799,21.16893223033081
0.125,0.066666667,31.1,11/15/2009,11,14,home,-6,KCC,90,206,88,64,10,16,Loss,182,112,2,2,3,OAK,26,272,318,2,10.142836785850912,32.19502767481071,21.16893223033081,11.0260954444799
0.4,0.166666667,28.5,11/15/2009,29,22,away,-11,ARI,308,340,113,81,20,31,Loss,164,122,4,0,0,SEA,51,472,462,2,-10.873852414778074,51.0276298245916,20.076888704906764,30.950741119684835
0.166666667,0.4,31.5,11/15/2009,22,29,home,11,SEA,340,308,136,68,31,20,Win,122,164,0,4,2,ARI,51,462,472,0,10.873852414778074,51.0276298245916,30.950741119684835,20.076888704906764
0.25,0.46666666700000003,24.03333333,11/15/2009,17,20,away,-10,GBP,217,178,67,58,7,17,Loss,61,105,5,4,0,DAL,24,278,283,3,-3.6953416639290406,38.36920824835694,17.33693329221395,21.03227495614299
0.46666666700000003,0.25,35.96666667,11/15/2009,20,17,home,10,DAL,178,217,100,68,17,7,Win,105,61,4,5,3,GBP,24,283,278,0,3.6953416639290406,38.36920824835694,21.03227495614299,17.33693329221395
0.384615385,0.375,29.61666667,11/15/2009,26,22,away,-8,LAC,433,212,70,71,23,31,Loss,29,119,2,2,0,PHI,54,462,331,1,5.230073201434529,52.01488991979543,28.62248156061498,23.39240835918045
0.375,0.384615385,30.38333333,11/15/2009,22,26,home,8,PHI,212,433,31,55,31,23,Win,119,29,2,2,1,LAC,54,331,462,0,-5.230073201434529,52.01488991979543,23.39240835918045,28.62248156061498
0.5,0.41666666700000005,35.03333333,11/15/2009,24,25,away,-1,IND,364,316,72,72,34,35,Loss,113,91,2,1,2,NEP,69,477,407,2,8.46396060105015,57.65014695386494,33.05705377745755,24.593093176407393
0.41666666700000005,0.5,24.96666667,11/15/2009,25,24,home,1,NEP,316,364,20,63,35,34,Win,91,113,1,2,2,IND,69,407,477,2,-8.46396060105015,57.65014695386494,24.593093176407393,33.05705377745755
0.28571428600000004,0.3125,31.53333333,11/16/2009,14,11,away,16,CLE,146,74,43,58,16,0,Win,128,86,2,4,2,BAL,16,274,160,0,0.26818777395629034,22.087138968362297,11.177663371159294,10.909475597203002
0.3125,0.28571428600000004,28.46666667,11/16/2009,11,14,home,-16,BAL,74,146,52,61,0,16,Loss,86,128,4,2,0,CLE,16,160,274,2,-0.26818777395629034,22.087138968362297,10.909475597203002,11.177663371159294
0.46666666700000003,0.23076923100000002,30.55,11/19/2009,17,22,away,7,CAR,172,201,30,60,24,17,Win,154,182,0,4,1,MIA,41,326,383,0,-8.214655542952634,40.94078218053398,16.363063318790672,24.577718861743307
0.23076923100000002,0.46666666700000003,29.45,11/19/2009,22,17,home,-7,MIA,201,172,35,73,17,24,Loss,182,154,4,0,0,CAR,41,383,326,1,8.214655542952634,40.94078218053398,24.577718861743307,16.363063318790672
0.46666666700000003,0.272727273,28.56666667,11/22/2009,14,17,away,-1,DAL,246,152,27,58,6,7,Loss,78,153,1,1,2,WAS,13,324,305,1,-5.579936701354653,35.993877748120156,15.20697052338275,20.786907224737405
0.272727273,0.46666666700000003,31.43333333,11/22/2009,17,14,home,1,WAS,152,246,35,61,7,6,Win,153,78,1,1,1,DAL,13,305,324,2,5.579936701354653,35.993877748120156,20.786907224737405,15.20697052338275
0.526315789,0.5,34.76666667,11/22/2009,22,26,away,-1,DET,308,416,69,75,37,38,Loss,131,57,1,2,2,CLE,75,439,473,0,-4.185186941075104,56.32067235218513,26.067742705555013,30.252929646630115
0.5,0.526315789,25.23333333,11/22/2009,26,22,home,1,CLE,416,308,41,61,38,37,Win,57,131,2,1,0,DET,75,473,439,2,4.185186941075104,56.32067235218513,30.252929646630115,26.067742705555013
0.272727273,0.5555555560000001,18.35,11/22/2009,11,26,away,-6,GBP,215,326,30,46,24,30,Loss,69,158,3,2,0,SFO,54,284,484,1,0.0030413086097560438,45.811813963929886,22.907427636269823,22.904386327660063
0.5555555560000001,0.272727273,41.65,11/22/2009,26,11,home,6,SFO,326,215,64,79,30,24,Win,158,69,2,3,1,GBP,54,484,284,0,-0.0030413086097560438,45.811813963929886,22.904386327660063,22.907427636269823
0.307692308,0.4,44.11666667,11/22/2009,27,13,away,-3,KCC,402,214,81,77,0,3,Loss,114,68,2,5,1,PIT,3,516,282,3,-0.5735915530158935,43.47116074612252,21.448784596553313,22.022376149569208
0.4,0.307692308,22.41666667,11/22/2009,13,27,home,3,PIT,214,402,28,55,3,0,Win,68,114,5,2,3,KCC,3,282,516,1,0.5735915530158935,43.47116074612252,22.022376149569208,21.448784596553313
0.5625,0.5,31.8,11/22/2009,27,26,away,-3,NYG,262,368,16,78,0,3,Loss,90,88,2,1,1,ATL,3,352,456,1,-7.136330623372287,51.58692981587384,22.225299596250775,29.361630219623063
0.5,0.5625,32.1,11/22/2009,26,27,home,3,ATL,368,262,64,66,3,0,Win,88,90,1,2,1,NYG,3,456,352,1,7.136330623372287,51.58692981587384,29.361630219623063,22.225299596250775
0.428571429,0.4,32.4,11/22/2009,21,14,away,31,TBB,187,100,55,65,38,7,Win,183,119,0,3,4,NOS,45,370,219,0,-4.2387588392770255,38.2776535696334,17.019447365178188,21.258206204455213
0.4,0.428571429,27.6,11/22/2009,14,21,home,-31,NOS,100,187,18,59,7,38,Loss,119,183,3,0,0,TBB,45,219,370,4,4.2387588392770255,38.2776535696334,21.258206204455213,17.019447365178188
0.272727273,0.6,23.6,11/22/2009,14,19,away,-3,JAX,290,208,43,51,15,18,Loss,53,102,2,2,2,BUF,33,343,310,3,-0.22305528474508662,47.39577365517764,23.586359185216278,23.809414469961364
0.6,0.272727273,36.4,11/22/2009,19,14,home,3,BUF,208,290,50,66,18,15,Win,102,53,2,2,3,JAX,33,310,343,2,0.22305528474508662,47.39577365517764,23.809414469961364,23.586359185216278
0.5555555560000001,0.384615385,27.4,11/22/2009,20,20,away,2,BAL,299,256,40,56,17,15,Win,76,98,0,0,2,IND,32,375,354,3,8.498625540911325,50.36915823782789,29.433891889369608,20.93526634845828
0.384615385,0.5555555560000001,32.6,11/22/2009,20,20,home,-2,IND,256,299,20,66,15,17,Loss,98,76,0,0,3,BAL,32,354,375,2,-8.498625540911325,50.36915823782789,20.93526634845828,29.433891889369608
0.1,0.615384615,17.81666667,11/22/2009,10,28,away,-26,MIN,208,271,64,43,9,35,Loss,4,160,2,2,0,SEA,44,212,431,2,7.5065016782959475,41.16311108155964,24.334806379927794,16.828304701631847
0.615384615,0.1,42.18333333,11/22/2009,28,10,home,26,SEA,271,208,31,72,35,9,Win,160,4,2,2,2,MIN,44,431,212,0,-7.5065016782959475,41.16311108155964,16.828304701631847,24.334806379927794
0.545454545,0.25,31.63333333,11/22/2009,24,16,away,8,LAR,261,191,40,65,21,13,Win,183,123,2,3,1,ARI,34,444,314,2,-5.754288114833331,44.656574933985425,19.451143409576048,25.205431524409377
0.25,0.545454545,28.36666667,11/22/2009,16,24,home,-8,ARI,191,261,50,67,13,21,Loss,123,183,3,2,2,LAR,34,314,444,1,5.754288114833331,44.656574933985425,25.205431524409377,19.451143409576048
0.2,0.470588235,20.1,11/22/2009,12,27,away,-17,NEP,122,299,28,49,14,31,Loss,104,111,2,2,1,NYJ,45,226,410,5,9.026809261924676,43.82740692036523,26.42710809114495,17.400298829220276
0.470588235,0.2,39.9,11/22/2009,27,12,home,17,NYJ,299,122,51,78,31,14,Win,111,104,2,2,5,NEP,45,410,226,1,-9.026809261924676,43.82740692036523,17.400298829220276,26.42710809114495
0.46153846200000004,0.363636364,38.4,11/22/2009,23,16,away,-3,OAK,171,183,59,68,17,20,Loss,177,92,3,0,3,CIN,37,348,275,4,1.0351039211257105,48.91280494847021,24.97395443479796,23.93885051367225
0.363636364,0.46153846200000004,21.6,11/22/2009,16,23,home,3,CIN,183,171,13,58,20,17,Win,92,177,0,3,4,OAK,37,275,348,3,-1.0351039211257105,48.91280494847021,23.93885051367225,24.97395443479796
0.384615385,0.222222222,37.86666667,11/22/2009,21,14,away,29,DEN,145,156,15,65,32,3,Win,203,115,0,3,3,LAC,35,348,271,0,3.646241034778015,38.914303827918125,21.28027243134807,17.634031396570055
0.222222222,0.384615385,22.13333333,11/22/2009,14,21,home,-29,LAC,156,145,65,53,3,32,Loss,115,203,3,0,0,DEN,35,271,348,3,-3.646241034778015,38.914303827918125,17.634031396570055,21.28027243134807
0.46666666700000003,0.1875,30.95,11/22/2009,18,14,away,4,CHI,220,158,46,66,24,20,Win,157,126,3,1,1,PHI,44,377,284,3,-6.28695109698351,40.833350872545275,17.273199887780883,23.56015098476439
0.1875,0.46666666700000003,29.05,11/22/2009,14,18,home,-4,PHI,158,220,64,64,20,24,Loss,126,157,1,3,3,CHI,44,284,377,1,6.28695109698351,40.833350872545275,23.56015098476439,17.273199887780883
0.46153846200000004,0.46666666700000003,32.31666667,11/23/2009,22,17,away,3,HOU,116,283,25,64,20,17,Win,228,57,0,4,0,TEN,37,344,340,1,-8.605483101241788,44.38487297022851,17.88969493449336,26.495178035735147
0.46666666700000003,0.46153846200000004,27.68333333,11/23/2009,17,22,home,-3,TEN,283,116,72,60,17,20,Loss,57,228,4,0,1,HOU,37,340,344,0,8.605483101241788,44.38487297022851,26.495178035735147,17.88969493449336
0.5625,0.375,33.98333333,11/26/2009,20,16,away,22,DET,342,199,57,67,34,12,Win,80,73,1,2,5,GBP,46,422,272,2,-4.52488139247825,50.8159441004404,23.145531353981074,27.670412746459323
0.375,0.5625,26.01666667,11/26/2009,16,20,home,-22,GBP,199,342,28,68,12,34,Loss,73,80,2,1,2,DET,46,272,422,5,4.52488139247825,50.8159441004404,27.670412746459323,23.145531353981074
0.28571428600000004,0.333333333,28.76666667,11/26/2009,14,18,away,-17,DAL,181,299,70,62,7,24,Loss,124,195,3,2,0,OAK,31,305,494,1,-3.618733227782574,44.9425272526769,20.661897012447163,24.28063024022974
0.333333333,0.28571428600000004,31.23333333,11/26/2009,18,14,home,17,OAK,299,181,48,56,24,7,Win,195,124,2,3,1,DAL,31,494,305,0,3.618733227782574,44.9425272526769,24.28063024022974,20.661897012447163
0.25,0.307692308,24.5,11/26/2009,15,23,away,-20,DEN,210,235,45,59,6,26,Loss,57,138,3,1,1,NYG,32,267,373,3,-0.2038714435292519,43.78233635442133,21.78923245544604,21.993103898975292
0.307692308,0.25,35.5,11/26/2009,23,15,home,20,NYG,235,210,61,69,26,6,Win,138,57,1,3,3,DEN,32,373,267,1,0.2038714435292519,43.78233635442133,21.993103898975292,21.78923245544604
0.25,0.3125,28.4,11/29/2009,13,21,away,-3,ATL,245,222,52,57,17,20,Loss,73,75,1,6,1,TBB,37,318,297,1,-8.619599679681457,32.294465875483326,11.837433097900934,20.45703277758239
0.3125,0.25,31.6,11/29/2009,21,13,home,3,TBB,222,245,29,76,20,17,Win,75,73,6,1,1,ATL,37,297,318,1,8.619599679681457,32.294465875483326,20.45703277758239,11.837433097900934
0.384615385,0.3,31.76666667,11/29/2009,23,20,away,-17,BUF,168,207,50,70,14,31,Loss,157,129,1,6,1,MIA,45,325,336,4,4.4613764970003995,44.97381838402195,24.717597440511177,20.256220943510776
0.3,0.384615385,28.23333333,11/29/2009,20,23,home,17,MIA,207,168,20,57,31,14,Win,129,157,6,1,4,BUF,45,336,325,1,-4.4613764970003995,44.97381838402195,20.256220943510776,24.717597440511177
0.28571428600000004,0.470588235,21.81666667,11/29/2009,11,21,away,-9,CIN,111,96,30,54,7,16,Loss,58,210,1,3,0,CLE,23,169,306,0,-6.026034802365637,25.789528362674645,9.881746780154504,15.90778158252014
0.470588235,0.28571428600000004,38.18333333,11/29/2009,21,11,home,9,CLE,96,111,75,72,16,7,Win,210,58,3,1,0,CIN,23,306,169,0,6.026034802365637,25.789528362674645,15.90778158252014,9.881746780154504
0.333333333,0.444444444,26.46666667,11/29/2009,15,23,away,10,LAR,95,251,52,57,27,17,Win,170,113,1,4,2,SEA,44,265,364,1,-7.490759300010906,38.2016669259535,15.355453812971298,22.846213112982205
0.444444444,0.333333333,33.53333333,11/29/2009,23,15,home,-10,SEA,251,95,35,78,17,27,Loss,113,170,4,1,1,LAR,44,364,265,2,7.490759300010906,38.2016669259535,22.846213112982205,15.355453812971298
0.25,0.384615385,26.7,11/29/2009,11,16,away,-11,NYJ,104,144,30,62,6,17,Loss,75,139,3,3,3,CAR,23,179,283,4,-4.736536273889234,35.64426536655497,15.453864546332866,20.190400820222102
0.384615385,0.25,33.3,11/29/2009,16,11,home,11,CAR,144,104,24,60,17,6,Win,139,75,3,3,4,NYJ,23,283,179,3,4.736536273889234,35.64426536655497,20.190400820222102,15.453864546332866
0.470588235,0.333333333,29.7,11/29/2009,15,17,away,-3,PHI,221,258,39,63,24,27,Loss,82,123,1,2,1,WAS,51,303,381,2,-9.18534689017996,41.77805810237222,16.296355606096128,25.481702496276093
0.333333333,0.470588235,30.3,11/29/2009,17,15,home,3,WAS,258,221,60,67,27,24,Win,123,82,2,1,2,PHI,51,381,303,1,9.18534689017996,41.77805810237222,25.481702496276093,16.296355606096128
0.333333333,0.5,28.13333333,11/29/2009,28,27,away,8,HOU,228,274,25,60,35,27,Win,114,122,2,2,3,IND,62,342,396,2,1.6583889304525705,57.61902293769455,29.638705934073563,27.98031700362099
0.5,0.333333333,31.86666667,11/29/2009,27,28,home,-8,IND,274,228,129,68,27,35,Loss,122,114,2,2,2,HOU,62,396,342,3,-1.6583889304525705,57.61902293769455,27.98031700362099,29.638705934073563
0.272727273,0.444444444,24.66666667,11/29/2009,16,26,away,-29,LAC,170,332,25,57,14,43,Loss,114,94,1,0,1,KCC,57,284,426,4,4.9004739355342934,47.07244073630863,25.98645733592146,21.085983400387168
0.444444444,0.272727273,35.33333333,11/29/2009,26,16,home,29,KCC,332,170,55,63,43,14,Win,94,114,0,1,4,LAC,57,426,284,1,-4.9004739355342934,47.07244073630863,21.085983400387168,25.98645733592146
0.25,0.5,29.26666667,11/29/2009,18,15,away,-17,SFO,261,232,60,61,3,20,Loss,96,52,6,0,0,JAX,23,357,284,2,-2.1314868261340205,39.17648468269596,18.522498928280967,20.65398575441499
0.5,0.25,30.73333333,11/29/2009,15,18,home,17,JAX,232,261,5,61,20,3,Win,52,96,0,6,2,SFO,23,284,357,0,2.1314868261340205,39.17648468269596,20.65398575441499,18.522498928280967
0.41666666700000005,0.375,28.88333333,11/29/2009,15,20,away,-3,TEN,217,369,25,52,17,20,Loss,75,163,1,4,1,ARI,37,292,532,0,-1.2043683571943091,45.10415712840495,21.94989438560532,23.15426274279963
0.375,0.41666666700000005,31.11666667,11/29/2009,20,15,home,3,ARI,369,217,38,70,20,17,Win,163,75,4,1,0,TEN,37,532,292,1,1.2043683571943091,45.10415712840495,23.15426274279963,21.94989438560532
0.25,0.666666667,19.08333333,11/29/2009,8,31,away,-26,MIN,126,378,44,38,10,36,Loss,43,159,4,1,1,CHI,46,169,537,3,-0.9411361070382291,48.25884267700701,23.65885328498439,24.59998939202262
0.666666667,0.25,40.91666667,11/29/2009,31,8,home,26,CHI,378,126,70,83,36,10,Win,159,43,1,4,3,MIN,46,537,169,1,0.9411361070382291,48.25884267700701,24.59998939202262,23.65885328498439
0.375,0.35714285700000004,35.93333333,11/29/2009,16,21,away,-3,BAL,145,261,59,64,0,3,Loss,153,132,0,5,2,PIT,3,298,393,1,-2.4238612495382483,35.13295620726262,16.354547478862187,18.778408728400436
0.35714285700000004,0.375,32.36666667,11/29/2009,21,16,home,3,PIT,261,145,80,69,3,0,Win,132,153,5,0,1,BAL,3,393,298,2,2.4238612495382483,35.13295620726262,18.778408728400436,16.354547478862187
0.307692308,0.4,33.26666667,11/30/2009,23,18,away,-21,NOS,244,367,0,70,17,38,Loss,122,113,2,1,1,NEP,55,366,480,3,18.469467809594438,51.2894119269617,34.87943986827807,16.40997205868363
0.4,0.307692308,26.73333333,11/30/2009,18,23,home,21,NEP,367,244,36,50,38,17,Win,113,122,1,2,3,NOS,55,480,366,1,-18.469467809594438,51.2894119269617,16.40997205868363,34.87943986827807
0.3125,0.090909091,35.16666667,12/3/2009,17,10,away,6,BUF,82,71,18,65,19,13,Win,249,123,5,3,2,NYJ,32,331,194,0,4.100795259634134,28.91598495535264,16.508390107493387,12.407594847859254
0.090909091,0.3125,24.83333333,12/3/2009,10,17,home,-6,NYJ,71,82,5,50,13,19,Loss,123,249,3,5,0,BUF,32,194,331,2,-4.100795259634134,28.91598495535264,12.407594847859254,16.508390107493387
0.363636364,0.28571428600000004,29.18333333,12/6/2009,20,22,away,27,ATL,277,234,61,55,34,7,Win,103,61,2,2,3,PHI,41,380,295,0,6.71314646008171,44.763966553235186,25.738556506658448,19.025410046576738
0.28571428600000004,0.363636364,30.81666667,12/6/2009,22,20,home,-27,PHI,234,277,30,68,7,34,Loss,61,103,2,2,0,ATL,41,295,380,3,-6.71314646008171,44.763966553235186,19.025410046576738,25.738556506658448
0.14285714300000002,0.307692308,32.0,12/6/2009,14,14,away,-8,CHI,98,128,85,65,9,17,Loss,135,120,3,2,1,LAR,26,233,248,2,-9.296207132493539,28.45201682612106,9.577904846813759,18.8741119793073
0.307692308,0.14285714300000002,28.0,12/6/2009,14,14,home,8,LAR,128,98,35,58,17,9,Win,120,135,2,3,2,CHI,26,248,233,1,9.296207132493539,28.45201682612106,18.8741119793073,9.57790484681376
0.181818182,0.375,21.2,12/6/2009,14,22,away,-10,CIN,165,202,45,52,13,23,Loss,80,119,3,2,3,DET,36,245,321,2,0.8448245875217313,38.71615726847139,19.78049092799656,18.93566634047483
0.375,0.181818182,38.8,12/6/2009,22,14,home,10,DET,202,165,75,75,23,13,Win,119,80,2,3,2,CIN,36,321,245,3,-0.8448245875217313,38.71615726847139,18.93566634047483,19.78049092799656
0.533333333,0.642857143,32.98333333,12/6/2009,24,23,away,-10,IND,233,270,50,77,17,27,Loss,142,88,1,0,0,TEN,44,375,358,2,-12.322550413391419,51.03331615022761,19.355382868418097,31.677933281809516
0.642857143,0.533333333,27.01666667,12/6/2009,23,24,home,10,TEN,270,233,40,64,27,17,Win,88,142,0,1,2,IND,44,358,375,0,12.322550413391419,51.03331615022761,31.677933281809516,19.355382868418097
0.307692308,0.352941176,35.91666667,12/6/2009,24,14,away,31,KCC,168,128,20,73,44,13,Win,245,94,3,2,3,DEN,57,413,222,3,-6.457819841727497,39.18069774526843,16.361438951770467,22.819258793497966
0.352941176,0.307692308,24.08333333,12/6/2009,14,24,home,-31,DEN,128,168,25,71,13,44,Loss,94,245,2,3,3,KCC,57,222,413,3,6.457819841727497,39.18069774526843,22.819258793497966,16.361438951770467
0.428571429,0.583333333,35.1,12/6/2009,25,28,away,3,WAS,408,367,102,74,3,0,Win,55,88,1,0,4,NOS,3,463,455,1,-5.490023504134527,58.13289991224467,26.32143820405507,31.811461708189597
0.583333333,0.428571429,31.38333333,12/6/2009,28,25,home,-3,NOS,367,408,15,67,0,3,Loss,88,55,0,1,1,WAS,3,455,463,4,5.490023504134527,58.13289991224467,31.811461708189597,26.32143820405507
0.28571428600000004,0.272727273,31.06666667,12/6/2009,22,15,away,-10,CAR,315,152,50,72,6,16,Loss,154,157,2,1,2,TBB,22,469,309,5,-5.734761057685051,50.21119974120308,22.238219341759017,27.972980399444065
0.272727273,0.28571428600000004,28.93333333,12/6/2009,15,22,home,10,TBB,152,315,37,54,16,6,Win,157,154,1,2,5,CAR,22,309,469,2,5.734761057685051,50.21119974120308,27.972980399444065,22.238219341759017
0.333333333,0.5,29.88333333,12/6/2009,19,19,away,-5,JAX,233,216,37,61,18,23,Loss,72,107,2,4,1,HOU,41,305,323,3,-7.957411027503948,44.30492973885327,18.17375935567466,26.131170383178606
0.5,0.333333333,30.11666667,12/6/2009,19,19,home,5,HOU,216,233,45,68,23,18,Win,107,72,4,2,3,JAX,41,323,305,1,7.957411027503948,44.30492973885327,26.131170383178606,18.17375935567466
0.375,0.333333333,32.81666667,12/6/2009,19,19,away,3,PIT,287,269,70,65,27,24,Win,109,132,3,1,1,OAK,51,396,401,0,1.9155562852372707,49.934255417844334,25.924905851540803,24.00934956630353
0.333333333,0.375,27.18333333,12/6/2009,19,19,home,-3,OAK,269,287,41,52,24,27,Loss,132,109,1,3,0,PIT,51,401,396,1,-1.9155562852372707,49.934255417844334,24.00934956630353,25.924905851540803
0.4,0.526315789,27.38333333,12/6/2009,18,24,away,-1,MIA,352,328,82,54,21,22,Loss,96,88,0,1,1,NEP,43,448,416,2,4.413530700562104,51.623532122531884,28.018531411546995,23.60500071098489
0.526315789,0.4,32.61666667,12/6/2009,24,18,home,1,NEP,328,352,10,80,22,21,Win,88,96,1,0,2,MIA,43,416,448,1,-4.413530700562104,51.623532122531884,23.60500071098489,28.018531411546995
0.5,0.5,29.38333333,12/6/2009,21,24,away,7,CLE,386,257,5,59,30,23,Win,91,115,1,2,1,LAC,53,477,372,0,0.59962135012751,49.578566890575324,25.08909412035142,24.489472770223905
0.5,0.5,30.61666667,12/6/2009,24,21,home,-7,LAC,257,386,30,69,23,30,Loss,115,91,2,1,0,CLE,53,372,477,1,-0.59962135012751,49.578566890575324,24.489472770223905,25.08909412035142
0.076923077,0.25,28.81666667,12/6/2009,14,17,away,-3,SEA,303,185,57,58,17,20,Loss,53,107,1,5,1,SFO,37,356,292,2,0.798206526373604,32.96910503638125,16.883655781377428,16.085449255003823
0.25,0.076923077,31.18333333,12/6/2009,17,14,home,3,SFO,185,303,48,69,20,17,Win,107,53,5,1,2,SEA,37,292,356,1,-0.798206526373604,32.96910503638125,16.085449255003823,16.883655781377428
0.529411765,0.4,38.83333333,12/6/2009,27,15,away,-7,NYG,379,237,30,80,24,31,Loss,45,100,2,1,2,DAL,55,424,337,1,-1.8212926619232312,49.49229009732655,23.83549871770166,25.65679137962489
0.4,0.529411765,21.16666667,12/6/2009,15,27,home,7,DAL,237,379,10,49,31,24,Win,100,45,1,2,1,NYG,55,337,424,2,1.8212926619232312,49.49229009732655,25.65679137962489,23.83549871770166
0.333333333,0.4,31.28333333,12/6/2009,22,20,away,-13,ARI,253,285,50,68,17,30,Loss,62,113,3,0,1,MIN,47,315,398,2,1.977164256535561,45.14951501002514,23.56333963328035,21.58617537674479
0.4,0.333333333,28.71666667,12/6/2009,20,22,home,13,MIN,285,253,50,57,30,17,Win,113,62,0,3,2,ARI,47,398,315,1,-1.977164256535561,45.14951501002514,21.58617537674479,23.56333963328035
0.46153846200000004,0.46153846200000004,24.63333333,12/7/2009,17,25,away,-13,GBP,119,256,135,60,14,27,Loss,66,94,3,1,3,BAL,41,185,350,4,-4.170839771883612,47.56707306245492,21.69811664528565,25.868956417169265
0.46153846200000004,0.46153846200000004,35.36666667,12/7/2009,25,17,home,13,BAL,256,119,175,68,27,14,Win,94,66,1,3,4,GBP,41,350,185,3,4.170839771883612,47.56707306245492,25.868956417169265,21.69811664528565
0.214285714,0.375,30.75,12/10/2009,16,12,away,-7,CLE,141,84,40,62,6,13,Loss,77,171,8,1,0,PIT,19,218,255,0,-2.360129647722509,22.87603034163498,10.257950346956235,12.618079994678745
0.375,0.214285714,29.25,12/10/2009,12,16,home,7,PIT,84,141,55,57,13,6,Win,171,77,1,8,0,CLE,19,255,218,0,2.360129647722509,22.87603034163498,12.618079994678745,10.257950346956235
0.666666667,0.5,36.73333333,12/13/2009,24,19,away,3,ATL,296,303,59,67,26,23,Win,95,89,0,1,1,NOS,49,391,392,0,0.20545507604933455,50.32830816823182,25.266881622140577,25.061426546091244
0.5,0.666666667,23.26666667,12/13/2009,19,24,home,-3,NOS,303,296,55,56,23,26,Loss,89,95,1,0,0,ATL,49,392,391,1,-0.20545507604933455,50.32830816823182,25.061426546091244,25.266881622140577
0.384615385,0.384615385,31.2,12/13/2009,16,14,away,7,CHI,157,195,30,57,21,14,Win,158,59,3,3,2,GBP,35,315,254,2,0.41416660999961596,40.34843397165317,20.381300290826395,19.967133680826777
0.384615385,0.384615385,28.8,12/13/2009,14,16,home,-7,GBP,195,157,109,56,14,21,Loss,59,158,3,3,2,CHI,35,254,315,2,-0.41416660999961596,40.34843397165317,19.967133680826777,20.381300290826395
0.352941176,0.5625,31.45,12/13/2009,20,21,away,-12,IND,262,220,65,74,16,28,Loss,95,92,3,0,3,DEN,44,357,312,1,-8.143293303214623,46.05521565865197,18.95596117771867,27.099254480933297
0.5625,0.352941176,28.55,12/13/2009,21,20,home,12,DEN,220,262,20,70,28,16,Win,92,95,0,3,1,IND,44,312,357,3,8.143293303214623,46.05521565865197,27.099254480933297,18.95596117771867
0.25,0.38888888899999996,30.56666667,12/13/2009,13,16,away,6,KCC,73,209,40,57,16,10,Win,200,145,2,3,4,BUF,26,273,354,3,-5.514556729535987,38.29543774202687,16.39044050624544,21.90499723578143
0.38888888899999996,0.25,29.43333333,12/13/2009,16,13,home,-6,BUF,209,73,43,73,10,16,Loss,145,200,3,2,3,KCC,26,354,273,4,5.514556729535987,38.29543774202687,21.90499723578143,16.39044050624544
0.27777777800000003,0.0,34.1,12/13/2009,14,6,away,23,TBB,135,81,63,66,26,3,Win,175,43,1,3,3,NYJ,29,310,124,1,-9.648498066109841,22.674574571255153,6.513038252572656,16.161536318682497
0.0,0.27777777800000003,25.9,12/13/2009,6,14,home,-23,NYJ,81,135,34,56,3,26,Loss,43,175,3,1,1,TBB,29,124,310,3,9.648498066109841,22.674574571255153,16.161536318682497,6.513038252572656
0.533333333,0.214285714,35.1,12/13/2009,22,10,away,4,JAX,208,122,27,71,14,10,Win,146,95,2,3,0,MIA,24,354,217,3,-3.6050492406020784,35.39763545351458,15.896293106456252,19.50134234705833
0.214285714,0.533333333,24.9,12/13/2009,10,22,home,-4,MIA,122,208,10,54,10,14,Loss,95,146,3,2,3,JAX,24,217,354,0,3.6050492406020784,35.39763545351458,19.50134234705833,15.896293106456252
0.294117647,0.46153846200000004,30.25,12/13/2009,13,24,away,-45,BAL,126,240,40,67,3,48,Loss,103,308,1,0,1,DET,51,229,548,2,-0.9349067404913605,44.30555159015837,21.685322424833508,22.620229165324865
0.46153846200000004,0.294117647,29.75,12/13/2009,24,13,home,45,DET,240,126,50,63,48,3,Win,308,103,0,1,2,BAL,51,548,229,1,0.9349067404913605,44.30555159015837,22.620229165324865,21.685322424833508
0.071428571,0.384615385,26.4,12/13/2009,13,23,away,-27,HOU,220,365,63,63,7,34,Loss,62,85,3,0,2,SEA,41,282,450,1,-2.568899463844673,41.47986544866535,19.45548299241034,22.02438245625501
0.384615385,0.071428571,33.6,12/13/2009,23,13,home,27,SEA,365,220,35,67,34,7,Win,85,62,0,3,1,HOU,41,450,282,2,2.568899463844673,41.47986544866535,22.02438245625501,19.45548299241034
0.428571429,0.571428571,27.75,12/13/2009,13,21,away,-20,MIN,91,180,85,53,10,30,Loss,119,142,1,2,1,CIN,40,210,322,1,-5.356510011048892,37.08087621943066,15.862183104190883,21.218693115239773
0.571428571,0.428571429,32.25,12/13/2009,21,13,home,20,CIN,180,91,69,69,30,10,Win,142,119,2,1,1,MIN,40,322,210,1,5.356510011048892,37.08087621943066,21.218693115239773,15.862183104190883
0.23076923100000002,0.272727273,25.75,12/13/2009,14,26,away,-10,NEP,179,192,92,56,10,20,Loss,126,185,2,0,3,CAR,30,305,377,0,2.2489964392066106,42.365302760705134,22.30714959995587,20.058153160749264
0.272727273,0.23076923100000002,34.25,12/13/2009,26,14,home,10,CAR,192,179,25,72,20,10,Win,185,126,0,2,0,NEP,30,377,305,3,-2.2489964392066106,42.365302760705134,20.058153160749264,22.30714959995587
0.333333333,0.307692308,31.95,12/13/2009,15,19,away,-40,TEN,160,286,82,65,7,47,Loss,80,160,1,0,1,LAR,54,240,446,5,-5.887731109195784,46.211535521641885,20.16190220622305,26.049633315418834
0.307692308,0.333333333,28.05,12/13/2009,19,15,home,40,LAR,286,160,40,57,47,7,Win,160,80,0,1,5,TEN,54,446,240,1,5.887731109195784,46.211535521641885,26.049633315418834,20.16190220622305
0.41666666700000005,0.26666666699999997,27.88333333,12/13/2009,21,15,away,21,OAK,195,162,45,58,34,13,Win,100,65,3,8,1,WAS,47,295,227,1,-9.660242070522354,37.33622809517175,13.837993012324695,23.498235082847053
0.26666666699999997,0.41666666700000005,32.11666667,12/13/2009,15,21,home,-21,WAS,162,195,118,66,13,34,Loss,65,100,8,3,1,OAK,47,227,295,1,9.660242070522354,37.33622809517175,23.498235082847053,13.837993012324697
0.41666666700000005,0.125,30.08333333,12/13/2009,21,22,away,3,DAL,268,239,24,64,20,17,Win,73,108,1,1,0,LAC,37,341,347,1,1.719297094751639,40.23103404610232,20.97516557042698,19.255868475675342
0.125,0.41666666700000005,29.91666667,12/13/2009,22,21,home,-3,LAC,239,268,68,58,17,20,Loss,108,73,1,1,1,DAL,37,347,341,0,-1.719297094751639,40.23103404610232,19.255868475675342,20.97516557042698
0.375,0.41666666700000005,25.23333333,12/13/2009,20,27,away,7,NYG,297,379,45,53,45,38,Win,77,133,1,3,4,PHI,83,374,512,1,7.249646115831396,62.22151293685325,34.73557952634232,27.485933410510928
0.41666666700000005,0.375,34.76666667,12/13/2009,27,20,home,-7,PHI,379,297,54,72,38,45,Loss,133,77,3,1,1,NYG,83,512,374,4,-7.249646115831396,62.22151293685325,27.48593341051093,34.73557952634232
0.363636364,0.5,23.25,12/14/2009,11,18,away,-15,SFO,160,138,78,51,9,24,Loss,85,189,4,1,2,ARI,33,245,327,7,-3.6042218620430333,39.947943944541606,18.171861041249286,21.77608290329232
0.5,0.363636364,36.75,12/14/2009,18,11,home,15,ARI,138,160,55,72,24,9,Win,189,85,1,4,7,SFO,33,327,245,2,3.6042218620430333,39.947943944541606,21.77608290329232,18.171861041249286
0.666666667,0.625,24.56666667,12/17/2009,18,25,away,4,JAX,308,206,40,53,35,31,Win,61,139,0,2,1,IND,66,369,345,1,-5.943539292520514,51.89234794308784,22.974404325283665,28.917943617804177
0.625,0.666666667,35.43333333,12/17/2009,25,18,home,-4,IND,206,308,22,76,31,35,Loss,139,61,2,0,1,JAX,66,345,369,1,5.943539292520514,51.89234794308784,28.917943617804177,22.974404325283665
0.533333333,0.14285714300000002,36.43333333,12/19/2009,24,23,away,7,NOS,294,271,49,73,24,17,Win,145,65,3,4,3,DAL,41,439,336,0,1.1351702049177632,46.69655414032606,23.91586217262191,22.780691967704147
0.14285714300000002,0.533333333,23.56666667,12/19/2009,23,24,home,-7,DAL,271,294,30,62,17,24,Loss,65,145,4,3,0,NOS,41,336,439,3,-1.1351702049177632,46.69655414032606,22.780691967704147,23.91586217262191
0.41666666700000005,0.166666667,26.46666667,12/20/2009,19,16,away,7,BUF,115,136,52,57,17,10,Win,109,105,0,6,1,NEP,27,224,241,1,9.40886031517791,33.11186723777284,21.260363776475376,11.851503461297465
0.166666667,0.41666666700000005,33.53333333,12/20/2009,16,19,home,-7,NEP,136,115,124,56,10,17,Loss,105,109,6,0,1,BUF,27,241,224,1,-9.40886031517791,33.11186723777284,11.851503461297465,21.260363776475376
0.333333333,0.333333333,29.71666667,12/20/2009,21,15,away,7,DET,218,121,65,65,31,24,Win,122,161,2,2,3,ARI,55,340,282,3,-0.40405455598268825,41.339795643893666,20.467870543955488,20.871925099938178
0.333333333,0.333333333,30.28333333,12/20/2009,15,21,home,-7,ARI,121,218,45,60,24,31,Loss,161,122,2,2,3,DET,55,282,340,3,0.40405455598268825,41.339795643893666,20.871925099938178,20.467870543955488
0.4,0.46153846200000004,34.38333333,12/20/2009,23,19,away,-3,TEN,347,236,60,77,0,3,Loss,121,128,1,2,2,MIA,3,468,364,4,-7.028184657349393,51.516263584212545,22.244039463431577,29.27222412078097
0.46153846200000004,0.4,29.31666667,12/20/2009,19,23,home,3,MIA,236,347,46,60,3,0,Win,128,121,2,1,4,TEN,3,364,468,2,7.028184657349393,51.516263584212545,29.27222412078097,22.244039463431577
0.384615385,0.307692308,34.41666667,12/20/2009,20,22,away,7,KCC,66,323,20,67,41,34,Win,351,168,0,1,1,CLE,75,417,491,3,-5.430786278053022,46.890986060679985,20.730099891313483,26.160886169366503
0.307692308,0.384615385,25.58333333,12/20/2009,22,20,home,-7,CLE,323,66,34,71,34,41,Loss,168,351,1,0,3,KCC,75,491,417,1,5.430786278053022,46.890986060679985,26.160886169366503,20.730099891313483
0.35714285700000004,0.533333333,30.66666667,12/20/2009,22,15,away,3,LAR,367,149,30,64,16,13,Win,52,88,0,3,2,HOU,29,419,237,2,-1.6494444567146305,46.6658903437794,22.508222943532385,24.157667400247018
0.533333333,0.35714285700000004,29.33333333,12/20/2009,15,22,home,-3,HOU,149,367,15,56,13,16,Loss,88,52,3,0,2,LAR,29,237,419,2,1.6494444567146305,46.6658903437794,24.157667400247018,22.508222943532385
0.38888888899999996,0.333333333,29.6,12/20/2009,12,17,away,3,NYJ,152,215,25,62,10,7,Win,86,99,0,2,3,ATL,17,238,314,0,-8.521407556963316,32.4733590726764,11.975975757856542,20.49738331481986
0.333333333,0.38888888899999996,30.4,12/20/2009,17,12,home,-3,ATL,215,152,65,67,7,10,Loss,99,86,2,0,0,NYJ,17,314,238,3,8.521407556963316,32.4733590726764,20.49738331481986,11.975975757856542
0.46666666700000003,0.454545455,31.76666667,12/20/2009,19,20,away,-3,LAC,293,296,55,63,24,27,Loss,114,70,2,2,2,CIN,51,407,366,1,2.8763383759444836,48.6113615033598,25.743849939652144,22.86751156370766
0.454545455,0.46666666700000003,28.23333333,12/20/2009,20,19,home,3,CIN,296,293,30,60,27,24,Win,70,114,2,2,1,LAC,51,366,407,2,-2.8763383759444836,48.6113615033598,22.86751156370766,25.743849939652144
0.307692308,0.26666666699999997,31.43333333,12/20/2009,22,19,away,1,DEN,102,257,62,64,20,19,Win,241,80,1,3,0,OAK,39,343,337,2,-3.2207703564280172,45.780676157051985,21.279952900311983,24.500723256740002
0.26666666699999997,0.307692308,28.56666667,12/20/2009,19,22,home,-1,OAK,257,102,67,65,19,20,Loss,80,241,3,1,2,DEN,39,337,343,0,3.2207703564280172,45.780676157051985,24.500723256740002,21.279952900311983
0.0,0.428571429,28.95,12/20/2009,13,21,away,-14,PHI,154,306,55,58,13,27,Loss,107,116,3,0,2,SFO,40,261,422,4,1.3741775162657355,43.26953876857103,22.321858142418385,20.947680626152646
0.428571429,0.0,31.05,12/20/2009,21,13,home,14,SFO,306,154,69,69,27,13,Win,116,107,0,3,4,PHI,40,422,261,2,-1.3741775162657355,43.26953876857103,20.947680626152646,22.321858142418385
0.625,0.4375,24.63333333,12/20/2009,18,28,away,-1,PIT,376,472,53,61,36,37,Loss,60,65,1,5,0,GBP,73,436,537,0,-0.36255992124860437,59.92326708296784,29.780353580859618,30.14291350210822
0.4375,0.625,35.36666667,12/20/2009,28,18,home,1,GBP,472,376,84,70,37,36,Win,65,60,5,1,0,PIT,73,537,436,0,0.36255992124860437,59.92326708296784,30.14291350210822,29.780353580859618
0.333333333,0.333333333,27.7,12/20/2009,13,18,away,-24,BAL,98,222,9,64,7,31,Loss,122,124,2,2,1,CHI,38,220,346,6,-0.19920956934850054,35.776119427985975,17.78845492931874,17.987664498667236
0.333333333,0.333333333,32.3,12/20/2009,18,13,home,24,CHI,222,98,26,66,31,7,Win,124,122,2,2,6,BAL,38,346,220,1,0.19920956934850054,35.776119427985975,17.987664498667236,17.78845492931874
0.4375,0.384615385,32.06666667,12/20/2009,15,23,away,17,SEA,205,252,35,60,24,7,Win,134,128,0,1,5,TBB,31,339,380,1,-5.8973484547182835,45.42478370851151,19.763717626896614,25.661066081614898
0.384615385,0.4375,27.93333333,12/20/2009,23,15,home,-17,TBB,252,205,50,72,7,24,Loss,128,134,1,0,1,SEA,31,380,339,5,5.8973484547182835,45.42478370851151,25.661066081614898,19.763717626896614
0.1,0.470588235,22.01666667,12/20/2009,10,23,away,-19,CAR,196,273,45,45,7,26,Loss,41,124,4,2,0,MIN,33,237,397,2,-2.5691480338249555,39.92443588485126,18.677643925513152,21.24679195933811
0.470588235,0.1,37.98333333,12/20/2009,23,10,home,19,MIN,273,196,49,75,26,7,Win,124,41,2,4,2,CAR,33,397,237,0,2.5691480338249555,39.92443588485126,21.24679195933811,18.677643925513152
0.7333333329999999,0.41666666700000005,34.25,12/21/2009,23,15,away,33,WAS,273,213,15,62,45,12,Win,114,89,2,5,3,NYG,57,387,302,0,-2.2337742611189064,48.59047301598368,23.17834937743239,25.412123638551293
0.41666666700000005,0.7333333329999999,25.75,12/21/2009,15,23,home,-33,NYG,213,273,52,55,12,45,Loss,89,114,5,2,0,WAS,57,302,387,3,2.2337742611189064,48.59047301598368,25.412123638551293,23.17834937743239
0.727272727,0.25,39.11666667,12/25/2009,30,17,away,25,TEN,259,88,45,69,42,17,Win,166,182,1,1,3,LAC,59,425,270,1,0.21444760752731185,51.13703307684008,25.675740342183698,25.461292734656386
0.25,0.727272727,20.88333333,12/25/2009,17,30,home,-25,LAC,88,259,74,49,17,42,Loss,182,166,1,1,1,TEN,59,270,425,3,-0.21444760752731185,51.13703307684008,25.461292734656386,25.675740342183698
0.2,0.470588235,25.58333333,12/27/2009,11,24,away,-28,ATL,138,234,60,49,3,31,Loss,40,157,2,3,0,BUF,34,178,391,3,-2.5309236808807505,36.42167597973969,16.94537614942947,19.476299830310218
0.470588235,0.2,34.41666667,12/27/2009,24,11,home,28,BUF,234,138,70,75,31,3,Win,157,40,3,2,3,ATL,34,391,178,0,2.5309236808807505,36.42167597973969,19.476299830310218,16.94537614942947
0.46666666700000003,0.46666666700000003,26.13333333,12/27/2009,17,17,away,-7,CIN,172,130,40,66,10,17,Loss,123,144,1,1,1,KCC,27,295,274,2,-4.194869925214901,35.94266831737015,15.873899196077623,20.068769121292526
0.46666666700000003,0.46666666700000003,33.86666667,12/27/2009,17,17,home,7,KCC,130,172,36,62,17,10,Win,144,123,1,1,2,CIN,27,274,295,1,4.194869925214901,35.94266831737015,20.068769121292526,15.873899196077623
0.23076923100000002,0.375,29.63333333,12/27/2009,19,16,away,-14,CLE,301,118,126,68,9,23,Loss,88,164,4,2,1,OAK,32,389,282,3,-12.101648737435063,42.22985536339742,15.064103312981178,27.16575205041624
0.375,0.23076923100000002,30.36666667,12/27/2009,16,19,home,14,OAK,118,301,64,65,23,9,Win,164,88,2,4,3,CLE,32,282,389,1,12.101648737435063,42.22985536339742,27.16575205041624,15.064103312981178
0.352941176,0.571428571,27.76666667,12/27/2009,17,20,away,-38,GBP,176,264,86,69,10,48,Loss,115,153,3,1,0,SEA,58,291,417,4,-3.8116940434174857,46.23502424209245,21.21166509933748,25.02335914275497
0.571428571,0.352941176,32.23333333,12/27/2009,20,17,home,38,SEA,264,176,50,62,48,10,Win,153,115,1,3,4,GBP,58,417,291,0,3.8116940434174857,46.23502424209245,25.02335914275497,21.21166509933748
0.384615385,0.384615385,32.55,12/27/2009,20,17,away,-3,PIT,148,238,113,67,20,23,Loss,175,48,4,4,2,BAL,43,323,286,3,2.5539445353047574,39.77419081482252,21.164067675063638,18.61012313975888
0.384615385,0.384615385,27.45,12/27/2009,17,20,home,3,BAL,238,148,20,60,23,20,Win,48,175,4,4,3,PIT,43,286,323,2,-2.5539445353047574,39.77419081482252,18.61012313975888,21.164067675063638
0.363636364,0.5,32.63333333,12/27/2009,21,23,away,7,MIA,280,303,15,64,27,20,Win,126,60,1,3,1,HOU,47,406,363,1,-6.0564456386831145,47.15448920825241,20.549021784784646,26.60546742346776
0.5,0.363636364,27.36666667,12/27/2009,23,21,home,-7,HOU,303,280,30,74,20,27,Loss,60,126,3,1,1,MIA,47,363,406,1,6.0564456386831145,47.15448920825241,26.60546742346776,20.549021784784646
0.363636364,0.6,27.58333333,12/27/2009,16,26,away,-28,NEP,177,267,5,52,7,35,Loss,98,197,2,0,1,JAX,42,275,464,2,14.7747298842926,49.97400006171476,32.37436497300368,17.599635088711082
0.6,0.363636364,32.41666667,12/27/2009,26,16,home,28,JAX,267,177,10,62,35,7,Win,197,98,0,2,2,NEP,42,464,275,1,-14.7747298842926,49.97400006171476,17.599635088711082,32.37436497300368
0.583333333,0.545454545,36.25,12/27/2009,24,23,away,3,NOS,263,249,42,68,3,0,Win,176,124,3,1,1,TBB,3,439,373,2,-1.0135344360341705,49.71648842112759,24.35147699254671,25.365011428580882
0.545454545,0.583333333,30.65,12/27/2009,23,24,home,-3,TBB,249,263,14,61,0,3,Loss,124,176,1,3,2,NOS,3,373,439,1,1.0135344360341705,49.71648842112759,25.365011428580882,24.35147699254671
0.666666667,0.384615385,32.26666667,12/27/2009,25,22,away,32,NYG,169,257,20,67,41,9,Win,247,60,1,4,4,CAR,50,416,317,0,-6.23694118839817,54.27681212224579,24.019935466923812,30.25687665532198
0.384615385,0.666666667,27.73333333,12/27/2009,22,25,home,-32,CAR,257,169,29,66,9,41,Loss,60,247,4,1,0,NYG,50,317,416,4,6.23694118839817,54.27681212224579,30.25687665532198,24.019935466923812
0.428571429,0.35714285700000004,25.81666667,12/27/2009,14,26,away,-21,ARI,150,297,20,57,10,31,Loss,88,110,4,2,1,LAR,41,238,407,4,0.019479944734964505,42.67406049186961,21.34677021830229,21.32729027356732
0.35714285700000004,0.428571429,34.18333333,12/27/2009,26,14,home,21,LAR,297,150,15,72,31,10,Win,110,88,2,4,4,ARI,41,407,238,1,-0.019479944734964505,42.67406049186961,21.32729027356732,21.34677021830229
0.166666667,0.294117647,29.36666667,12/27/2009,16,13,away,-14,SFO,175,226,10,66,6,20,Loss,114,84,2,1,1,DET,26,289,310,6,-1.6380073268475748,36.6403378392876,17.501165256220013,19.139172583067584
0.294117647,0.166666667,30.63333333,12/27/2009,13,16,home,14,DET,226,175,29,64,20,6,Win,84,114,1,2,6,SFO,26,310,289,1,1.6380073268475748,36.6403378392876,19.139172583067584,17.501165256220013
0.333333333,0.307692308,29.28333333,12/27/2009,13,22,away,-3,PHI,171,289,95,62,27,30,Loss,70,105,3,4,3,DEN,57,241,394,1,-0.24572398253576422,43.800295453096254,21.777285735280245,22.02300971781601
0.307692308,0.333333333,30.71666667,12/27/2009,22,13,home,3,DEN,289,171,59,67,30,27,Win,105,70,4,3,1,PHI,57,394,241,3,0.24572398253576422,43.800295453096254,22.02300971781601,21.777285735280245
0.4375,0.181818182,33.1,12/27/2009,17,18,away,14,IND,91,222,52,65,29,15,Win,202,64,2,2,2,NYJ,44,293,286,0,0.8262212812308345,36.88419747287772,18.85520937705428,18.028988095823443
0.181818182,0.4375,26.9,12/27/2009,18,17,home,-14,NYJ,222,91,15,57,15,29,Loss,64,202,2,2,0,IND,44,286,293,2,-0.8262212812308345,36.88419747287772,18.028988095823443,18.85520937705428
0.538461538,0.28571428600000004,35.03333333,12/27/2009,22,15,away,17,WAS,285,165,21,69,17,0,Win,108,43,1,4,1,DAL,17,393,208,1,-8.350611591211486,35.72839708762439,13.688892748206449,22.039504339417938
0.28571428600000004,0.538461538,24.96666667,12/27/2009,15,22,home,-17,DAL,165,285,33,60,0,17,Loss,43,108,4,1,1,WAS,17,208,393,1,8.350611591211486,35.72839708762439,22.039504339417938,13.68889274820645
0.35714285700000004,0.35714285700000004,36.41666667,12/28/2009,26,19,away,-6,CHI,300,258,47,76,0,6,Loss,123,105,3,2,1,MIN,6,423,363,2,-6.816141273003976,44.35982750279198,18.771843114894,25.58798438789798
0.35714285700000004,0.35714285700000004,29.33333333,12/28/2009,19,26,home,6,MIN,258,300,31,65,6,0,Win,105,123,2,3,2,CHI,6,363,423,1,6.816141273003976,44.35982750279198,25.58798438789798,18.771843114894
0.272727273,0.35714285700000004,22.43333333,1/3/2010,11,19,away,-23,BUF,132,155,15,52,7,30,Loss,25,248,1,0,0,IND,37,157,403,3,0.6791255029921714,35.95486818050622,18.316996841749194,17.637871338757023
0.35714285700000004,0.272727273,37.56666667,1/3/2010,19,11,home,23,IND,155,132,40,67,30,7,Win,248,25,0,1,3,BUF,37,403,157,0,-0.6791255029921714,35.95486818050622,17.637871338757023,18.316996841749194
0.529411765,0.35714285700000004,27.03333333,1/3/2010,18,18,away,-6,CLE,197,86,20,66,17,23,Loss,131,214,3,0,1,JAX,40,328,300,1,-5.82749545771823,37.4611262031919,15.816815372736837,21.644310830455066
0.35714285700000004,0.529411765,32.96666667,1/3/2010,18,18,home,6,JAX,86,197,15,60,23,17,Win,214,131,0,3,1,CLE,40,300,328,1,5.82749545771823,37.4611262031919,21.644310830455066,15.816815372736837
0.46666666700000003,0.35714285700000004,29.21666667,1/3/2010,22,18,away,14,DET,268,249,35,66,37,23,Win,150,100,2,2,2,CHI,60,418,349,0,-2.3634336806385132,47.299239180937526,22.467902750149506,24.83133643078802
0.35714285700000004,0.46666666700000003,30.78333333,1/3/2010,18,22,home,-14,CHI,249,268,35,61,23,37,Loss,100,150,2,2,0,DET,60,349,418,2,2.3634336806385132,47.299239180937526,24.83133643078802,22.467902750149506
0.46666666700000003,0.46666666700000003,35.48333333,1/3/2010,24,13,away,10,TBB,214,166,15,73,20,10,Win,183,40,1,1,2,ATL,30,397,206,3,-6.849774520642159,40.086630422075416,16.61842795071663,23.468202471358786
0.46666666700000003,0.46666666700000003,24.51666667,1/3/2010,13,24,home,-10,ATL,166,214,51,55,10,20,Loss,40,183,1,1,3,TBB,30,206,397,2,6.849774520642159,40.086630422075416,23.468202471358786,16.61842795071663
0.153846154,0.2,29.36666667,1/3/2010,14,15,away,-13,CAR,102,149,35,61,10,23,Loss,111,178,0,2,0,NOS,33,213,327,3,-3.6546708712173626,31.501349095905688,13.923339112344163,17.578009983561525
0.2,0.153846154,30.63333333,1/3/2010,15,14,home,13,NOS,149,102,29,62,23,10,Win,178,111,2,0,3,CAR,33,327,213,0,3.6546708712173626,31.501349095905688,17.578009983561525,13.923339112344163
0.4,0.428571429,28.43333333,1/3/2010,21,29,away,-7,HOU,243,295,55,59,27,34,Loss,74,144,2,1,1,NEP,61,317,439,2,9.631943600647544,52.09103151075586,30.861487555701704,21.229543955054158
0.428571429,0.4,31.56666667,1/3/2010,29,21,home,7,NEP,295,243,35,67,34,27,Win,144,74,1,2,2,HOU,61,439,317,1,-9.631943600647544,52.09103151075586,21.229543955054158,30.861487555701704
0.26666666699999997,0.111111111,33.13333333,1/3/2010,16,6,away,22,LAR,204,22,40,63,28,6,Win,125,87,3,8,0,SFO,34,329,109,0,-9.15250669988536,18.55526207426322,4.701377687188931,13.853884387074288
0.111111111,0.26666666699999997,26.86666667,1/3/2010,6,16,home,-22,SFO,22,204,50,62,6,28,Loss,87,125,8,3,0,LAR,34,109,329,0,9.15250669988536,18.55526207426322,13.853884387074288,4.70137768718893
0.5,0.583333333,32.15,1/3/2010,22,20,away,6,MIA,201,204,40,67,30,24,Win,202,99,3,3,3,PIT,54,403,303,2,1.7646699406437119,48.652247674353205,25.20845880749846,23.443788866854746
0.583333333,0.5,27.85,1/3/2010,20,22,home,-6,PIT,204,201,45,58,24,30,Loss,99,202,3,3,2,MIA,54,303,403,3,-1.7646699406437119,48.652247674353205,23.443788866854746,25.20845880749846
0.125,0.333333333,23.13333333,1/3/2010,11,28,away,-37,MIN,146,358,95,43,7,44,Loss,35,129,3,0,0,NYG,51,181,487,2,6.037019215957436,44.375365153347126,25.20619218465228,19.169172968694845
0.333333333,0.125,36.86666667,1/3/2010,28,11,home,37,NYG,358,146,45,69,44,7,Win,129,35,0,3,2,MIN,51,487,181,0,-6.037019215957436,44.375365153347126,19.169172968694845,25.20619218465228
0.25,0.384615385,19.61666667,1/3/2010,10,21,away,-24,DAL,191,295,58,50,0,24,Loss,37,179,4,2,1,PHI,24,228,474,1,0.540111254116475,41.04448693010859,20.792299092112533,20.252187837996058
0.384615385,0.25,40.38333333,1/3/2010,21,10,home,24,PHI,295,191,80,68,24,0,Win,179,37,2,4,1,DAL,24,474,228,1,-0.540111254116475,41.04448693010859,20.252187837996058,20.792299092112533
0.41666666700000005,0.5,37.45,1/3/2010,24,13,away,26,ARI,236,139,19,64,33,7,Win,109,48,1,0,3,GBP,40,345,187,1,8.57402863477439,42.62800274630695,25.60101569054067,17.026987055766277
0.5,0.41666666700000005,22.55,1/3/2010,13,24,home,-26,GBP,139,236,76,45,7,33,Loss,48,109,0,1,1,ARI,40,187,345,3,-8.57402863477439,42.62800274630695,17.026987055766277,25.60101569054067
0.5,0.46153846200000004,32.55,1/3/2010,18,19,away,-3,LAC,275,314,14,65,20,23,Loss,66,50,1,1,1,WAS,43,341,364,0,-7.634262129369507,41.58628214880616,16.97601000971833,24.610272139087833
0.46153846200000004,0.5,27.45,1/3/2010,19,18,home,3,WAS,314,275,17,63,23,20,Win,50,66,1,1,0,LAC,43,364,341,1,7.634262129369507,41.58628214880616,24.610272139087833,16.97601000971833
0.428571429,0.307692308,32.36666667,1/3/2010,19,16,away,4,SEA,171,169,76,67,17,13,Win,133,140,0,3,1,TEN,30,304,309,2,-6.157783331468899,37.8177934064173,15.830005037474201,21.9877883689431
0.307692308,0.428571429,27.63333333,1/3/2010,16,19,home,-4,TEN,169,171,40,60,13,17,Loss,140,133,3,0,2,SEA,30,309,304,1,6.157783331468899,37.8177934064173,21.9877883689431,15.830005037474201
0.428571429,0.46153846200000004,27.76666667,1/3/2010,16,20,away,8,OAK,90,274,37,58,21,13,Win,240,51,4,3,2,BAL,34,330,325,0,3.488403811036342,43.391245798994056,23.4398248050152,19.951420993978857
0.46153846200000004,0.428571429,32.23333333,1/3/2010,20,16,home,-8,BAL,274,90,30,62,13,21,Loss,51,240,3,4,0,OAK,34,325,330,2,-3.488403811036342,43.391245798994056,19.951420993978857,23.4398248050152
0.3,0.46666666700000003,26.95,1/3/2010,22,30,away,20,DEN,207,428,76,60,44,24,Win,317,84,0,2,3,KCC,68,524,512,2,-0.46792789070703655,63.384391894281706,31.458232001787334,31.926159892494372
0.46666666700000003,0.3,33.05,1/3/2010,30,22,home,-20,KCC,428,207,54,80,24,44,Loss,84,317,2,0,2,DEN,68,512,524,3,0.46792789070703655,63.384391894281706,31.926159892494372,31.458232001787334
0.090909091,0.611111111,18.76666667,1/3/2010,5,21,away,-37,NYJ,0,63,44,40,0,37,Loss,72,257,3,0,0,CIN,37,72,320,3,1.4146733202723283,26.749173292131882,14.081923306202105,12.667249985929777
0.611111111,0.090909091,41.23333333,1/3/2010,21,5,home,37,CIN,63,0,20,73,37,0,Win,257,72,0,3,3,NYJ,37,320,72,0,-1.4146733202723283,26.749173292131882,12.667249985929777,14.081923306202105
0.25,0.35714285700000004,33.03333333,1/9/2010,15,18,away,10,CIN,182,110,76,56,24,14,Win,171,171,0,3,2,NYJ,38,353,281,0,1.405496631074442,38.075184289847215,19.74034046046083,18.334843829386386
0.35714285700000004,0.25,26.96666667,1/9/2010,18,15,home,-10,NYJ,110,182,55,61,14,24,Loss,171,171,3,0,0,CIN,38,281,353,2,-1.405496631074442,38.075184289847215,18.334843829386386,19.74034046046083
0.181818182,0.5625,20.43333333,1/9/2010,17,27,away,-20,DAL,284,228,116,56,14,34,Loss,56,198,4,2,1,PHI,48,340,426,4,-2.4633907158084796,52.59848105122191,25.067545167706715,27.530935883515195
0.5625,0.181818182,39.56666667,1/9/2010,27,17,home,20,PHI,228,284,112,72,34,14,Win,198,56,2,4,4,DAL,48,426,340,1,2.4633907158084796,52.59848105122191,27.530935883515195,25.067545167706715
0.625,0.25,32.35,1/10/2010,16,15,away,19,NEP,34,132,15,62,33,14,Win,234,64,0,3,4,BAL,47,268,196,2,8.343417771368578,32.08943765874728,20.21642771505793,11.87300994368935
0.25,0.625,27.65,1/10/2010,15,16,home,-19,BAL,132,34,41,63,14,33,Loss,64,234,3,0,2,NEP,47,196,268,4,-8.343417771368578,32.08943765874728,11.87300994368935,20.21642771505793
0.454545455,0.6,29.85,1/10/2010,32,30,away,-6,ARI,404,375,76,67,0,6,Loss,89,156,5,1,1,GBP,6,493,531,3,13.667574028980265,71.51793317745899,42.59275360321963,28.92517957423936
0.6,0.454545455,31.45,1/10/2010,30,32,home,6,GBP,375,404,56,57,6,0,Win,156,89,1,5,3,ARI,6,531,493,1,-13.667574028980265,71.51793317745899,28.92517957423936,42.59275360321963
0.125,0.538461538,23.55,1/16/2010,15,27,away,-31,NOS,258,247,22,52,14,45,Loss,101,171,1,0,0,ARI,59,359,418,2,9.079091099939358,45.92539402506236,27.50224256250086,18.4231514625615
0.538461538,0.125,36.45,1/16/2010,27,15,home,31,ARI,247,258,44,66,45,14,Win,171,101,0,1,2,NOS,59,418,359,0,-9.079091099939358,45.92539402506236,18.4231514625615,27.50224256250086
0.384615385,0.4,26.03333333,1/16/2010,12,22,away,-17,IND,183,233,64,55,3,20,Loss,87,42,1,2,1,BAL,23,270,275,4,2.672738347134951,38.39300193353052,20.532870140332736,17.860131793197784
0.4,0.384615385,33.96666667,1/16/2010,22,12,home,17,BAL,233,183,25,71,20,3,Win,42,87,2,1,4,IND,23,275,270,1,-2.672738347134951,38.39300193353052,17.860131793197784,20.532870140332736
0.23076923100000002,0.307692308,30.56666667,1/17/2010,16,16,away,-31,MIN,156,214,10,66,3,34,Loss,92,109,6,3,0,DAL,37,248,323,3,-1.7942676544952647,31.877526995313765,15.04162967040925,16.835897324904515
0.307692308,0.23076923100000002,29.43333333,1/17/2010,16,16,home,31,DAL,214,156,50,60,34,3,Win,109,92,3,6,3,MIN,37,323,248,0,1.7942676544952647,31.877526995313765,16.835897324904515,15.04162967040925
0.375,0.307692308,31.51666667,1/17/2010,14,18,away,3,LAC,93,283,37,63,17,14,Win,169,61,1,2,2,NYJ,31,262,344,1,-5.543085959508003,37.68377836431176,16.07034620240188,21.613432161909884
0.307692308,0.375,28.48333333,1/17/2010,18,14,home,-3,NYJ,283,93,87,60,14,17,Loss,61,169,2,1,1,LAC,31,344,262,2,5.543085959508003,37.68377836431176,21.613432161909884,16.07034620240188
0.428571429,0.363636364,28.58333333,1/24/2010,17,27,away,-13,IND,302,360,46,60,17,30,Loss,86,101,0,2,1,NYJ,47,388,461,1,5.099845042778905,53.96312908968636,29.531487066232632,24.43164202345373
0.363636364,0.428571429,31.41666667,1/24/2010,27,17,home,13,NYJ,360,302,5,65,30,17,Win,101,86,2,0,1,IND,47,461,388,1,-5.099845042778905,53.96312908968636,24.43164202345373,29.531487066232632
0.583333333,0.25,36.81666667,1/24/2010,31,15,away,-3,NOS,310,189,32,82,0,3,Loss,165,68,0,1,1,MIN,3,475,257,5,-2.880145869759839,48.787530403596,22.953692266918083,25.83383813667792
0.25,0.583333333,27.93333333,1/24/2010,15,31,home,3,MIN,189,310,88,55,3,0,Win,68,165,1,0,5,NOS,3,257,475,1,2.880145869759839,48.787530403596,25.83383813667792,22.953692266918083
0.333333333,0.46153846200000004,30.18333333,2/7/2010,20,23,away,14,IND,281,333,19,58,31,17,Win,51,99,1,0,1,NOS,48,332,432,0,6.822723535696458,48.83020504347004,27.82646428958325,21.003740753886788
0.46153846200000004,0.333333333,29.81666667,2/7/2010,23,20,home,-14,NOS,333,281,45,64,17,31,Loss,99,51,0,1,0,IND,48,432,332,1,-6.822723535696458,48.83020504347004,21.003740753886788,27.82646428958325
0.384615385,0.272727273,26.28333333,9/9/2010,12,18,away,-5,NOS,162,229,60,51,9,14,Loss,91,79,1,1,0,MIN,23,253,308,1,3.7451955435715556,34.104615403562086,18.92490547356682,15.179709929995266
0.272727273,0.384615385,33.71666667,9/9/2010,18,12,home,5,MIN,229,162,20,62,14,9,Win,79,91,1,1,1,NOS,23,308,253,0,-3.7451955435715556,34.104615403562086,15.179709929995266,18.92490547356682
0.444444444,0.214285714,36.88333333,9/12/2010,19,9,away,5,BUF,164,116,15,73,15,10,Win,132,50,3,3,0,MIA,25,296,166,0,-5.5201557940557855,25.191763653729776,9.835803929836995,15.35595972389278
0.214285714,0.444444444,23.11666667,9/12/2010,9,19,home,-5,MIA,116,164,35,54,10,15,Loss,50,132,3,3,0,BUF,25,166,296,0,5.5201557940557855,25.191763653729776,15.35595972389278,9.835803929836995
0.375,0.28571428600000004,30.48333333,9/12/2010,18,14,away,-6,PIT,237,211,24,71,0,6,Loss,58,143,2,3,1,ATL,6,295,354,1,-3.7956736723277285,32.08949521243097,14.146910770051619,17.94258444237935
0.28571428600000004,0.375,32.1,9/12/2010,14,18,home,6,ATL,211,237,25,60,6,0,Win,143,58,3,2,1,PIT,6,354,295,1,3.7956736723277285,32.08949521243097,17.94258444237935,14.146910770051619
0.3,0.3,30.5,9/12/2010,21,18,away,-7,JAX,274,165,70,61,17,24,Loss,89,134,3,1,0,DEN,41,363,299,2,3.7636464101499243,44.53798616109311,24.150816285621516,20.387169875471592
0.3,0.3,29.5,9/12/2010,18,21,home,7,DEN,165,274,47,56,24,17,Win,134,89,1,3,2,JAX,41,299,363,0,-3.7636464101499243,44.53798616109311,20.387169875471592,24.150816285621516
0.333333333,0.545454545,29.11666667,9/12/2010,25,23,away,-10,HOU,419,98,73,69,24,34,Loss,44,257,2,2,1,IND,58,463,355,1,-3.392178433117337,53.94709014451479,25.277455855698726,28.669634288816063
0.545454545,0.333333333,30.88333333,9/12/2010,23,25,home,10,IND,98,419,50,61,34,24,Win,257,44,2,2,1,HOU,58,355,463,1,3.392178433117337,53.94709014451479,28.669634288816063,25.277455855698726
0.384615385,0.41176470600000004,27.65,9/12/2010,15,13,away,-3,TBB,236,169,47,61,14,17,Loss,104,119,0,3,2,CLE,31,340,288,3,-8.149513852982388,37.15116897929508,14.500827563156346,22.650341416138733
0.41176470600000004,0.384615385,32.35,9/12/2010,13,15,home,3,CLE,169,236,55,61,17,14,Win,119,104,3,0,3,TBB,31,288,340,2,8.149513852982388,37.15116897929508,22.650341416138733,14.500827563156346
0.470588235,0.35714285700000004,25.35,9/12/2010,14,21,away,-13,NYG,148,258,63,63,18,31,Loss,89,118,4,1,4,CAR,49,237,376,5,-11.052798007372866,50.140175170719026,19.54368858167308,30.596486589045945
0.35714285700000004,0.470588235,34.65,9/12/2010,21,14,home,13,CAR,258,148,95,67,31,18,Win,118,89,1,4,5,NYG,49,376,237,4,11.052798007372866,50.140175170719026,30.596486589045945,19.54368858167308
0.533333333,0.692307692,31.83333333,9/12/2010,26,20,away,-14,NEP,341,258,5,76,24,38,Loss,87,118,1,0,0,CIN,62,428,376,2,7.294308012457794,52.08450245575101,29.6894052341044,22.39509722164661
0.692307692,0.533333333,28.16666667,9/12/2010,20,26,home,14,CIN,258,341,30,58,38,24,Win,118,87,0,1,2,NEP,62,376,428,0,-7.294308012457794,52.08450245575101,22.39509722164661,29.6894052341044
0.214285714,0.533333333,28.93333333,9/12/2010,21,17,away,-25,TEN,150,140,77,67,13,38,Loss,136,205,4,2,1,OAK,51,286,345,2,-9.615398074886158,44.92104882586615,17.652825375489996,27.268223450376155
0.533333333,0.214285714,31.06666667,9/12/2010,17,21,home,25,OAK,140,150,81,58,38,13,Win,205,136,2,4,2,TEN,51,345,286,1,9.615398074886158,44.92104882586615,27.268223450376155,17.652825375489996
0.28571428600000004,0.428571429,25.3,9/12/2010,13,23,away,-5,CHI,148,362,40,57,14,19,Loss,20,101,2,4,4,DET,33,168,463,3,-3.5266272356080126,46.045072702598794,21.259222733495392,24.785849969103403
0.428571429,0.28571428600000004,34.7,9/12/2010,23,13,home,5,DET,362,148,100,70,19,14,Win,101,20,4,2,3,CHI,33,463,168,4,3.5266272356080126,46.045072702598794,24.785849969103403,21.259222733495392
0.384615385,0.4,27.15,9/12/2010,21,20,away,4,LAR,266,240,72,64,17,13,Win,112,85,2,2,4,ARI,30,378,325,4,-11.374045720812948,47.29737976500937,17.96166702209821,29.335712742911156
0.4,0.384615385,32.85,9/12/2010,20,21,home,-4,ARI,240,266,40,81,13,17,Loss,85,112,2,2,4,LAR,30,325,378,4,11.374045720812948,47.29737976500937,29.335712742911156,17.96166702209821
0.428571429,0.384615385,31.91666667,9/12/2010,22,16,away,7,PHI,167,171,15,67,27,20,Win,132,149,3,6,1,GBP,47,299,320,2,2.2316999626689853,43.82686888963415,23.029284426151566,20.797584463482583
0.384615385,0.428571429,28.08333333,9/12/2010,16,22,home,-7,GBP,171,167,80,60,20,27,Loss,149,132,6,3,2,PHI,47,320,299,1,-2.2316999626689853,43.82686888963415,20.797584463482583,23.029284426151566
0.066666667,0.454545455,32.75,9/12/2010,14,14,away,-25,SEA,214,165,60,66,6,31,Loss,49,77,2,1,1,SFO,37,263,242,2,5.10252166792834,30.057389348476036,17.57995550820219,12.477433840273848
0.454545455,0.066666667,27.25,9/12/2010,14,14,home,25,SFO,165,214,35,47,31,6,Win,77,49,1,2,2,SEA,37,242,263,1,-5.10252166792834,30.057389348476036,12.477433840273846,17.57995550820219
0.384615385,0.23076923100000002,34.05,9/12/2010,24,17,away,-6,WAS,277,161,81,71,7,13,Loss,103,89,1,1,0,DAL,20,380,250,1,-8.20102113797931,36.685755706978746,14.242367284499718,22.44338842247903
0.23076923100000002,0.384615385,25.95,9/12/2010,17,24,home,6,DAL,161,277,42,56,13,7,Win,89,103,1,1,1,WAS,20,250,380,0,8.20102113797931,36.685755706978746,22.44338842247903,14.242367284499718
0.578947368,0.090909091,38.53333333,9/13/2010,20,6,away,1,NYJ,233,60,38,75,10,9,Win,49,116,2,2,1,BAL,19,282,176,3,-1.9341081672210856,30.761889404333022,14.413890618555968,16.347998785777055
0.090909091,0.578947368,21.46666667,9/13/2010,6,20,home,-1,BAL,60,233,125,44,9,10,Loss,116,49,2,2,3,NYJ,19,176,282,1,1.9341081672210856,30.761889404333022,16.347998785777055,14.413890618555968
0.26666666699999997,0.090909091,37.46666667,9/13/2010,18,9,away,-7,KCC,280,62,30,70,14,21,Loss,109,135,2,1,0,LAC,35,389,197,1,-1.1940159577055605,27.329698435871876,13.067841239083158,14.261857196788718
0.090909091,0.26666666699999997,22.53333333,9/13/2010,9,18,home,7,LAC,62,280,35,49,21,14,Win,135,109,1,2,1,KCC,35,197,389,0,1.1940159577055605,27.329698435871876,14.261857196788718,13.067841239083158
0.133333333,0.28571428600000004,33.66666667,9/19/2010,7,14,away,8,TEN,21,192,35,54,19,11,Win,106,46,4,4,7,PIT,30,127,238,1,-1.317665545060537,27.060346380855602,12.871340417897532,14.18900596295807
0.28571428600000004,0.133333333,26.33333333,9/19/2010,14,7,home,-8,PIT,192,21,72,61,11,19,Loss,46,106,4,4,1,TEN,30,238,127,7,1.317665545060537,27.060346380855602,14.18900596295807,12.871340417897532
0.428571429,0.3125,30.81666667,9/19/2010,14,16,away,13,CAR,178,159,30,59,20,7,Win,95,119,0,4,3,TBB,27,273,278,0,-12.526167565012859,35.635358696134425,11.554595565560781,24.080763130573644
0.3125,0.428571429,29.18333333,9/19/2010,16,14,home,-13,TBB,159,178,48,66,7,20,Loss,119,95,4,0,0,CAR,27,278,273,3,12.526167565012859,35.635358696134425,24.080763130573644,11.554595565560783
0.333333333,0.307692308,33.21666667,9/19/2010,16,13,away,2,CLE,172,226,30,68,16,14,Win,140,73,1,1,2,KCC,30,312,299,2,-6.181322141486227,33.40123321958692,13.609955539050347,19.791277680536574
0.307692308,0.333333333,26.78333333,9/19/2010,13,16,home,-2,KCC,226,172,78,58,14,16,Loss,73,140,1,1,2,CLE,30,299,312,2,6.181322141486227,33.40123321958692,19.791277680536574,13.609955539050347
0.454545455,0.35714285700000004,24.2,9/19/2010,12,22,away,4,MIN,106,208,15,46,14,10,Win,120,156,2,3,4,MIA,24,226,364,2,4.216377298783094,40.97785141450034,22.59711435664172,18.380737057858624
0.35714285700000004,0.454545455,35.8,9/19/2010,22,12,home,-4,MIA,208,106,44,72,10,14,Loss,156,120,3,2,2,MIN,24,364,226,4,-4.216377298783094,40.97785141450034,18.380737057858624,22.59711435664172
0.0,0.647058824,20.78333333,9/19/2010,11,33,away,-34,ATL,149,223,109,48,7,41,Loss,118,221,2,1,1,ARI,48,267,444,3,-1.3104723215753573,43.53855157401121,21.114039626217924,22.424511947793285
0.647058824,0.0,39.21666667,9/19/2010,33,11,home,34,ARI,223,149,75,78,41,7,Win,221,118,1,2,3,ATL,48,444,267,1,1.3104723215753573,43.53855157401121,22.424511947793285,21.114039626217924
0.428571429,0.4,30.86666667,9/19/2010,24,22,away,3,DET,248,329,75,68,35,32,Win,162,115,5,2,2,PHI,67,410,444,0,-4.699600967876391,53.696257230221676,24.49832813117264,29.197929099049034
0.4,0.428571429,29.13333333,9/19/2010,22,24,home,-3,PHI,329,248,51,73,32,35,Loss,115,162,2,5,0,DET,67,444,410,2,4.699600967876391,53.696257230221676,29.197929099049034,24.49832813117264
0.090909091,0.46153846200000004,26.33333333,9/19/2010,14,23,away,7,DAL,270,374,10,49,27,20,Win,38,36,1,0,3,CHI,47,308,410,0,2.301877800242074,42.86124390999001,22.58156085511604,20.279683054873967
0.46153846200000004,0.090909091,33.66666667,9/19/2010,23,14,home,-7,CHI,374,270,50,71,20,27,Loss,36,38,0,1,0,DAL,47,410,308,3,-2.301877800242074,42.86124390999001,20.279683054873967,22.58156085511604
0.26666666699999997,0.166666667,25.73333333,9/19/2010,14,14,away,-5,CIN,150,159,45,63,10,15,Loss,109,94,1,1,0,BAL,25,259,253,4,-0.4149585860424363,27.976473395457933,13.78075740470775,14.195715990750184
0.166666667,0.26666666699999997,34.26666667,9/19/2010,14,14,home,5,BAL,159,150,56,67,15,10,Win,94,109,1,1,4,CIN,25,253,259,0,0.4149585860424363,27.976473395457933,14.195715990750184,13.78075740470775
0.333333333,0.583333333,29.06666667,9/19/2010,14,18,away,-27,GBP,62,255,35,54,7,34,Loss,124,91,4,0,0,BUF,41,186,346,2,4.94858458021309,40.10965364302805,22.529119111620567,17.58053453140748
0.583333333,0.333333333,30.93333333,9/19/2010,18,14,home,27,BUF,255,62,49,56,34,7,Win,91,124,0,4,2,GBP,41,346,186,0,-4.94858458021309,40.10965364302805,17.58053453140748,22.529119111620567
0.2,0.41176470600000004,23.18333333,9/19/2010,16,25,away,-2,OAK,135,231,92,49,14,16,Loss,75,173,3,2,2,LAR,30,210,404,1,-8.597024573216178,45.03490924595984,18.218942336371832,26.815966909588006
0.41176470600000004,0.2,36.81666667,9/19/2010,25,16,home,2,LAR,231,135,90,78,16,14,Win,173,75,2,3,1,OAK,30,404,210,2,8.597024573216178,45.03490924595984,26.815966909588006,18.218942336371832
0.636363636,0.7,22.55,9/19/2010,17,23,away,-17,DEN,230,304,64,56,14,31,Loss,109,65,1,1,0,SEA,45,339,369,4,-2.4368471674922887,51.512498940775274,24.537825886641492,26.97467305413378
0.7,0.636363636,37.45,9/19/2010,23,17,home,17,SEA,304,230,35,74,31,14,Win,65,109,1,1,4,DEN,45,369,339,0,2.4368471674922887,51.512498940775274,26.97467305413378,24.537825886641492
0.428571429,0.2,39.81666667,9/19/2010,29,21,away,3,WAS,468,403,45,81,3,0,Win,58,18,5,3,0,HOU,3,526,421,1,-6.05459554254621,48.77040462714045,21.35790454229712,27.41250008484333
0.2,0.428571429,31.78333333,9/19/2010,21,29,home,-3,HOU,403,468,58,58,0,3,Loss,18,58,3,5,1,WAS,3,421,526,0,6.05459554254621,48.77040462714045,27.41250008484333,21.35790454229712
0.454545455,0.46153846200000004,27.46666667,9/19/2010,20,23,away,-14,NYJ,239,200,79,57,14,28,Loss,52,136,1,3,0,NEP,42,291,336,3,7.977086154246402,45.73979358600614,26.85843987012627,18.881353715879868
0.46153846200000004,0.454545455,32.53333333,9/19/2010,23,20,home,14,NEP,200,239,58,65,28,14,Win,136,52,3,1,3,NYJ,42,336,291,0,-7.977086154246402,45.73979358600614,18.881353715879868,26.85843987012627
0.5,0.5,30.4,9/19/2010,20,25,away,-25,LAC,279,326,33,68,13,38,Loss,71,151,2,1,3,JAX,51,350,477,6,1.0224965061820583,60.841455408667045,30.93197595742455,29.909479451242493
0.5,0.5,29.6,9/19/2010,25,20,home,25,JAX,326,279,25,60,38,13,Win,151,71,1,2,6,LAC,51,477,350,3,-1.0224965061820583,60.841455408667045,29.909479451242493,30.93197595742455
0.272727273,0.363636364,24.9,9/19/2010,13,24,away,-24,IND,137,250,25,53,14,38,Loss,120,160,4,1,1,NYG,52,257,410,3,1.3630220417629353,44.33900600131267,22.8510140215378,21.48799197977487
0.363636364,0.272727273,35.1,9/19/2010,24,13,home,24,NYG,250,137,55,70,38,14,Win,160,120,1,4,3,IND,52,410,257,1,-1.3630220417629353,44.33900600131267,21.48799197977487,22.8510140215378
0.428571429,0.5555555560000001,32.66666667,9/20/2010,17,24,away,3,SFO,237,275,54,64,25,22,Win,50,142,2,0,4,NOS,47,287,417,0,3.299519224786461,48.49643165554448,25.897975440165467,22.59845621537901
0.5555555560000001,0.428571429,27.33333333,9/20/2010,24,17,home,-3,NOS,275,237,40,58,22,25,Loss,142,50,0,2,0,SFO,47,417,287,4,-3.299519224786461,48.49643165554448,22.59845621537901,25.897975440165467
0.5,0.583333333,27.8,9/26/2010,19,25,away,-8,NEP,240,245,45,53,30,38,Loss,134,200,1,1,1,BUF,68,374,445,2,11.98705130950066,54.85412051977827,33.42058591463947,21.433534605138803
0.583333333,0.5,32.2,9/26/2010,25,19,home,8,BUF,245,240,35,66,38,30,Win,200,134,1,1,2,NEP,68,445,374,1,-11.98705130950066,54.85412051977827,21.433534605138803,33.42058591463947
0.25,0.272727273,28.13333333,9/26/2010,17,21,away,-14,MIN,232,185,67,63,10,24,Loss,63,183,1,2,3,DET,34,295,368,3,-3.7535063212271407,44.894590277262274,20.570541978017566,24.32404829924471
0.272727273,0.25,31.86666667,9/26/2010,21,17,home,14,DET,185,232,100,66,24,10,Win,183,63,2,1,3,MIN,34,368,295,3,3.7535063212271407,44.894590277262274,24.32404829924471,20.570541978017566
0.294117647,0.181818182,36.36666667,9/26/2010,21,17,away,13,CAR,185,180,74,75,20,7,Win,120,87,1,1,4,CIN,27,305,267,2,-5.58217827032912,40.64168176411097,17.529751746890923,23.111930017220047
0.181818182,0.294117647,23.63333333,9/26/2010,17,21,home,-13,CIN,180,185,45,58,7,20,Loss,87,120,1,1,2,CAR,27,267,305,4,5.58217827032912,40.64168176411097,23.111930017220047,17.529751746890923
0.5,0.545454545,45.83333333,9/26/2010,25,20,away,3,NOS,215,355,40,82,3,0,Win,202,43,2,2,3,ATL,3,417,398,1,-2.477062308469323,44.14122840295936,20.832083047245018,23.30914535571434
0.545454545,0.5,27.25,9/26/2010,20,25,home,-3,ATL,355,215,38,56,0,3,Loss,43,202,2,2,1,NOS,3,398,417,3,2.477062308469323,44.14122840295936,23.30914535571434,20.832083047245018
0.444444444,0.428571429,26.9,9/26/2010,17,18,away,25,TBB,186,228,20,49,38,13,Win,201,75,0,4,2,PIT,51,387,303,2,3.871058264071623,44.615250864021924,24.243154564046772,20.37209629997515
0.428571429,0.444444444,33.1,9/26/2010,18,17,home,-25,PIT,228,186,45,62,13,38,Loss,75,201,4,0,2,TBB,51,303,387,2,-3.871058264071623,44.615250864021924,20.37209629997515,24.243154564046772
0.363636364,0.5,29.86666667,9/26/2010,18,19,away,-7,BAL,131,256,60,55,17,24,Loss,173,109,2,0,0,CLE,41,304,365,0,5.156058172776817,38.218739820632955,21.687398996704886,16.53134082392807
0.5,0.363636364,30.13333333,9/26/2010,19,18,home,7,CLE,256,131,60,59,24,17,Win,109,173,0,2,0,BAL,41,365,304,0,-5.156058172776817,38.218739820632955,16.53134082392807,21.687398996704886
0.46153846200000004,0.5,28.36666667,9/26/2010,17,26,away,19,NYG,110,364,80,58,29,10,Win,161,107,1,2,3,TEN,39,271,471,0,-9.505473845450489,52.115601187984254,21.305063671266883,30.81053751671737
0.5,0.46153846200000004,31.63333333,9/26/2010,26,17,home,-19,TEN,364,110,86,70,10,29,Loss,107,161,2,1,0,NYG,39,471,271,3,9.505473845450489,52.115601187984254,30.81053751671737,21.305063671266883
0.235294118,0.5,26.16666667,9/26/2010,11,21,away,-21,KCC,208,250,55,62,10,31,Loss,43,207,5,0,1,SFO,41,251,457,1,-5.368485729613305,37.61045517068317,16.12098472053493,21.489470450148236
0.5,0.235294118,33.83333333,9/26/2010,21,11,home,21,SFO,250,208,40,66,31,10,Win,207,43,0,5,1,KCC,41,457,251,1,5.368485729613305,37.61045517068317,21.489470450148236,16.12098472053493
0.363636364,0.444444444,32.33333333,9/26/2010,21,24,away,14,HOU,284,216,49,57,27,13,Win,101,124,0,4,3,DAL,40,385,340,0,4.9928063172545745,49.36708874268383,27.179947529969205,22.18714121271463
0.444444444,0.363636364,27.66666667,9/26/2010,24,21,home,-14,DAL,216,284,32,58,13,27,Loss,124,101,4,0,0,HOU,40,340,385,3,-4.9928063172545745,49.36708874268383,22.18714121271463,27.179947529969205
0.1,0.4375,25.16666667,9/26/2010,15,24,away,-14,LAR,233,232,65,50,16,30,Loss,116,133,1,1,2,WAS,46,349,365,2,-8.432937425133126,44.475647118502174,18.021354846684524,26.45429227181765
0.4375,0.1,34.83333333,9/26/2010,24,15,home,14,WAS,232,233,99,75,30,16,Win,133,116,1,1,2,LAR,46,365,349,2,8.432937425133126,44.475647118502174,26.45429227181765,18.021354846684524
0.384615385,0.294117647,27.11666667,9/26/2010,15,16,away,25,JAX,267,52,84,55,28,3,Win,106,139,3,7,1,PHI,31,373,191,0,-6.2244582354105,35.77187238498102,14.77370707478526,20.998165310195763
0.294117647,0.384615385,32.88333333,9/26/2010,16,15,home,-25,PHI,52,267,67,69,3,28,Loss,139,106,7,3,0,JAX,31,191,373,1,6.2244582354105,35.77187238498102,20.998165310195763,14.77370707478526
0.428571429,0.46153846200000004,36.06666667,9/26/2010,27,13,away,-7,SEA,429,203,83,78,20,27,Loss,89,68,4,3,2,LAC,47,518,271,5,-1.5950433112793707,51.314778798642486,24.85986774368156,26.454911054960927
0.46153846200000004,0.428571429,23.93333333,9/26/2010,13,27,home,7,LAC,203,429,32,56,27,20,Win,68,89,3,4,5,SEA,47,271,518,2,1.5950433112793707,51.314778798642486,26.454911054960927,24.85986774368156
0.26666666699999997,0.384615385,32.96666667,9/26/2010,20,18,away,-1,ARI,231,108,123,70,23,24,Loss,133,119,3,2,3,OAK,47,364,227,1,-7.297659344361611,42.89299274383967,17.79766669973903,25.09532604410064
0.384615385,0.26666666699999997,27.03333333,9/26/2010,18,20,home,1,OAK,108,231,104,54,24,23,Win,119,133,2,3,1,ARI,47,227,364,3,7.297659344361611,42.89299274383967,25.09532604410064,17.79766669973903
0.428571429,0.333333333,30.13333333,9/26/2010,18,23,away,14,DEN,325,472,27,65,27,13,Win,40,47,0,1,2,IND,40,365,519,0,-4.1953567647145995,53.21862310874946,24.511633172017433,28.70698993673203
0.333333333,0.428571429,29.86666667,9/26/2010,23,18,home,-14,IND,472,325,60,76,13,27,Loss,47,40,1,0,0,DEN,40,519,365,2,4.1953567647145995,53.21862310874946,28.70698993673203,24.511633172017433
0.545454545,0.46666666700000003,27.2,9/26/2010,20,24,away,8,MIA,256,352,81,57,31,23,Win,146,84,0,2,1,NYJ,54,402,436,0,-2.703921035109989,52.869455205013814,25.08276708495191,27.786688120061903
0.46666666700000003,0.545454545,32.8,9/26/2010,24,20,home,-8,NYJ,352,256,52,70,23,31,Loss,84,146,2,0,0,MIA,54,436,402,1,2.703921035109989,52.869455205013814,27.786688120061903,25.08276708495191
0.4,0.333333333,35.81666667,9/27/2010,21,18,away,-3,CHI,316,199,152,60,17,20,Loss,63,77,0,3,1,GBP,37,379,276,2,5.776670990843584,48.72287699319966,27.249773992021623,21.47310300117804
0.333333333,0.4,24.18333333,9/27/2010,18,21,home,3,GBP,199,316,38,48,20,17,Win,77,63,3,0,2,CHI,37,276,379,1,-5.776670990843584,48.72287699319966,21.47310300117804,27.249773992021623
0.46666666700000003,0.0,40.48333333,10/3/2010,25,12,away,24,BUF,171,109,30,75,38,14,Win,273,114,0,3,2,NYJ,52,444,223,0,2.6273893377192223,39.53653921793131,21.081964277825268,18.454574940106045
0.0,0.46666666700000003,19.51666667,10/3/2010,12,25,home,-24,NYJ,109,171,32,46,14,38,Loss,114,273,3,0,0,BUF,52,223,444,2,-2.6273893377192223,39.53653921793131,18.454574940106045,21.081964277825268
0.26666666699999997,0.4375,27.16666667,10/3/2010,15,19,away,-17,LAR,193,261,49,65,3,20,Loss,64,88,4,4,1,SEA,23,257,349,2,-9.106903153849693,35.302080465712756,13.097588655931531,22.204491809781224
0.4375,0.26666666699999997,32.83333333,10/3/2010,19,15,home,17,SEA,261,193,41,73,20,3,Win,88,64,4,4,2,LAR,23,349,257,1,9.106903153849693,35.302080465712756,22.204491809781224,13.097588655931531
0.5,0.35714285700000004,30.68333333,10/3/2010,17,23,away,-2,ATL,181,259,41,56,14,16,Loss,81,98,1,3,2,SFO,30,262,357,3,-3.191293137621189,41.24115664231951,19.02493175234916,22.21622488997035
0.35714285700000004,0.5,29.31666667,10/3/2010,23,17,home,2,SFO,259,181,60,75,16,14,Win,98,81,3,1,3,ATL,30,357,262,2,3.191293137621189,41.24115664231951,22.21622488997035,19.02493175234916
0.588235294,0.428571429,37.61666667,10/3/2010,24,16,away,-2,GBP,308,169,102,78,26,28,Loss,123,92,3,2,4,DET,54,431,261,3,5.092573229308245,55.71302500186995,30.402799115589097,25.310225886280854
0.428571429,0.588235294,22.38333333,10/3/2010,16,24,home,2,DET,169,308,31,40,28,26,Win,92,123,2,3,3,GBP,54,261,431,4,-5.092573229308245,55.71302500186995,25.310225886280854,30.402799115589097
0.454545455,0.428571429,29.23333333,10/3/2010,21,21,away,-3,CLE,346,179,79,58,20,23,Loss,67,116,4,1,1,CIN,43,413,295,2,2.807804355159554,45.57496844332592,24.191386399242738,21.383582044083184
0.428571429,0.454545455,30.76666667,10/3/2010,21,21,home,3,CIN,179,346,44,66,23,20,Win,116,67,1,4,2,CLE,43,295,413,1,-2.807804355159554,45.57496844332592,21.383582044083184,24.191386399242738
0.2,0.25,35.3,10/3/2010,22,13,away,6,TEN,308,167,74,76,26,20,Win,19,121,6,2,2,DEN,46,327,288,1,-5.150137242341946,39.43065695011445,17.14025985388625,22.290397096228197
0.25,0.2,24.7,10/3/2010,13,22,home,-6,DEN,167,308,111,52,20,26,Loss,121,19,2,6,1,TEN,46,288,327,2,5.150137242341946,39.43065695011445,22.290397096228197,17.14025985388625
0.333333333,0.571428571,21.63333333,10/3/2010,10,27,away,-2,NOS,133,262,66,47,14,16,Loss,118,121,3,2,2,CAR,30,251,383,1,-5.6390809582300845,43.94942024923199,19.155169645500955,24.794250603731037
0.571428571,0.333333333,38.36666667,10/3/2010,27,10,home,2,CAR,262,133,36,79,16,14,Win,121,118,2,3,1,NOS,30,383,251,2,5.6390809582300845,43.94942024923199,24.794250603731037,19.155169645500955
0.363636364,0.363636364,30.51666667,10/3/2010,22,14,away,3,PIT,250,126,52,65,17,14,Win,70,84,1,2,1,BAL,31,320,210,2,6.863879346560964,36.47345060921118,21.66866497788607,14.804785631325107
0.363636364,0.363636364,29.48333333,10/3/2010,14,22,home,-3,BAL,126,250,88,50,14,17,Loss,84,70,2,1,2,PIT,31,210,320,1,-6.863879346560964,36.47345060921118,14.804785631325107,21.66866497788607
0.7,0.692307692,30.23333333,10/3/2010,28,20,away,-3,JAX,348,163,35,66,28,31,Loss,58,174,1,0,0,IND,59,406,337,2,-1.738939895205526,57.128622281948665,27.69484119337157,29.433781088577096
0.692307692,0.7,29.76666667,10/3/2010,20,28,home,3,IND,163,348,45,57,31,28,Win,174,58,0,1,2,JAX,59,337,406,0,1.738939895205526,57.128622281948665,29.433781088577096,27.69484119337157
0.46153846200000004,0.41666666700000005,29.48333333,10/3/2010,21,24,away,7,OAK,192,245,26,65,31,24,Win,249,118,0,4,3,HOU,55,441,363,0,-6.567490499999195,54.122035028933446,23.777272264467125,30.34476276446632
0.41666666700000005,0.46153846200000004,30.51666667,10/3/2010,24,21,home,-7,HOU,245,192,23,68,24,31,Loss,118,249,4,0,0,OAK,55,363,441,3,6.567490499999195,54.122035028933446,30.34476276446632,23.777272264467125
0.454545455,0.35714285700000004,27.05,10/3/2010,16,21,away,5,PHI,124,243,30,55,17,12,Win,169,110,1,1,2,WAS,29,293,353,1,-4.214808600868041,43.039288988354734,19.412240193743347,23.627048794611387
0.35714285700000004,0.454545455,32.95,10/3/2010,21,16,home,-5,WAS,243,124,80,68,12,17,Loss,110,169,1,1,1,PHI,29,353,293,2,4.214808600868041,43.039288988354734,23.627048794611387,19.412240193743347
0.333333333,0.5,25.03333333,10/3/2010,10,23,away,-31,LAC,87,239,34,51,10,41,Loss,47,180,9,1,1,ARI,51,134,419,3,6.300350426820756,36.556210473210896,21.428280450015826,15.12793002319507
0.5,0.333333333,34.96666667,10/3/2010,23,10,home,31,ARI,239,87,44,60,41,10,Win,180,47,1,9,3,LAC,51,419,134,1,-6.300350426820756,36.556210473210896,15.12793002319507,21.428280450015826
0.0,0.25,26.58333333,10/3/2010,6,18,away,-14,NYG,51,183,40,52,3,17,Loss,59,189,10,2,3,CHI,20,110,372,3,1.0213968837009375,29.513329137990137,15.267363010845537,14.2459661271446
0.25,0.0,33.41666667,10/3/2010,18,6,home,14,CHI,183,51,44,64,17,3,Win,189,59,2,10,3,NYG,20,372,110,3,-1.0213968837009375,29.513329137990137,14.2459661271446,15.267363010845537
0.454545455,0.666666667,27.71666667,10/4/2010,19,23,away,27,MIA,146,308,31,59,41,14,Win,119,92,3,2,4,NEP,55,265,400,0,8.56474218435465,46.456449506451236,27.510595845402943,18.945853661048293
0.666666667,0.454545455,32.28333333,10/4/2010,23,19,home,-27,NEP,308,146,40,67,14,41,Loss,92,119,2,3,0,MIA,55,400,265,4,-8.56474218435465,46.456449506451236,18.945853661048293,27.510595845402943
0.2,0.166666667,30.31666667,10/10/2010,13,8,away,17,CAR,29,62,45,64,23,6,Win,218,85,3,5,3,CHI,29,247,147,4,-12.529921264363704,25.642198764917367,6.55613875027683,19.086060014640537
0.166666667,0.2,29.68333333,10/10/2010,8,13,home,-17,CHI,62,29,53,62,6,23,Loss,85,218,5,3,4,CAR,29,147,247,3,12.529921264363704,25.642198764917367,19.086060014640537,6.556138750276832
0.1,0.470588235,25.58333333,10/10/2010,16,23,away,-10,IND,148,244,38,57,9,19,Loss,113,97,1,1,1,KCC,28,261,341,1,-3.878227796589556,36.03209644603171,16.076934324721076,19.955162121310632
0.470588235,0.1,34.41666667,10/10/2010,23,16,home,10,KCC,244,148,45,76,19,9,Win,97,113,1,1,1,IND,28,341,261,1,3.878227796589556,36.03209644603171,19.955162121310632,16.076934324721076
0.4,0.46666666700000003,30.1,10/10/2010,17,18,away,10,CLE,173,221,60,61,20,10,Win,165,48,2,3,3,ATL,30,338,269,1,-2.627884163621852,37.50205523144211,17.43708553391013,20.06496969753198
0.46666666700000003,0.4,29.9,10/10/2010,18,17,home,-10,ATL,221,173,58,62,10,20,Loss,48,165,3,2,1,CLE,30,269,338,3,2.627884163621852,37.50205523144211,20.06496969753198,17.43708553391013
0.384615385,0.538461538,23.71666667,10/10/2010,16,28,away,-14,BAL,307,182,90,52,17,31,Loss,39,233,1,1,0,DEN,48,346,415,1,3.603750788196992,49.00593944629403,26.30484511724551,22.70109432904852
0.538461538,0.384615385,36.28333333,10/10/2010,28,16,home,14,DEN,182,307,66,73,31,17,Win,233,39,1,1,1,BAL,48,415,346,0,-3.603750788196992,49.00593944629403,22.70109432904852,26.30484511724551
0.35714285700000004,0.181818182,38.85,10/10/2010,26,11,away,24,HOU,297,171,84,74,34,10,Win,117,24,0,3,2,NYG,44,414,195,2,-6.845865183306358,42.73744980903805,17.945792312865844,24.791657496172203
0.181818182,0.35714285700000004,21.15,10/10/2010,11,26,home,-24,NYG,171,297,67,52,10,34,Loss,24,117,3,0,2,HOU,44,195,414,2,6.845865183306358,42.73744980903805,24.791657496172203,17.945792312865844
0.428571429,0.46153846200000004,33.26666667,10/10/2010,23,20,away,-38,DET,213,233,40,74,6,44,Loss,128,89,1,1,0,LAR,50,341,322,3,-9.569687241268527,46.275713908253316,18.353013333492395,27.92270057476092
0.46153846200000004,0.428571429,26.73333333,10/10/2010,20,23,home,38,LAR,233,213,78,61,44,6,Win,89,128,1,1,3,DET,50,322,341,0,9.569687241268527,46.275713908253316,27.92270057476092,18.353013333492395
0.153846154,0.294117647,32.66666667,10/10/2010,17,21,away,-3,WAS,270,322,63,67,0,3,Loss,157,51,4,5,1,GBP,3,427,373,2,-8.292839182921538,39.58412715542083,15.645643986249645,23.938483169171185
0.294117647,0.153846154,34.23333333,10/10/2010,21,17,home,3,GBP,322,270,28,75,3,0,Win,51,157,5,4,2,WAS,3,373,427,1,8.292839182921538,39.58412715542083,23.938483169171185,15.645643986249645
0.454545455,0.307692308,30.41666667,10/10/2010,21,20,away,3,CIN,266,209,25,60,24,21,Win,125,149,3,0,4,TBB,45,391,358,3,2.6297269512834003,50.593161226064815,26.61144408867411,23.981717137390707
0.307692308,0.454545455,29.58333333,10/10/2010,20,21,home,-3,TBB,209,266,60,64,21,24,Loss,149,125,0,3,3,CIN,45,358,391,4,-2.6297269512834003,50.593161226064815,23.981717137390707,26.61144408867411
0.363636364,0.272727273,34.35,10/10/2010,21,17,away,10,BUF,165,196,38,62,36,26,Win,216,110,2,3,0,JAX,62,381,306,3,3.7230445446046376,45.00474466556376,24.3638946050842,20.64085006047956
0.272727273,0.363636364,25.65,10/10/2010,17,21,home,-10,JAX,196,165,35,54,26,36,Loss,110,216,3,2,3,BUF,62,306,381,0,-3.7230445446046376,45.00474466556376,20.64085006047956,24.3638946050842
0.454545455,0.26666666699999997,30.01666667,10/10/2010,19,12,away,-10,ARI,273,153,45,62,20,30,Loss,85,41,1,4,1,NOS,50,358,194,4,4.741546173284823,36.2371241317839,20.489335152534363,15.747788979249538
0.26666666699999997,0.454545455,29.98333333,10/10/2010,12,19,home,10,NOS,153,273,20,57,30,20,Win,41,85,4,1,4,ARI,50,194,358,1,-4.741546173284823,36.2371241317839,15.747788979249538,20.489335152534363
0.41666666700000005,0.4,32.76666667,10/10/2010,29,14,away,-8,OAK,415,168,53,71,27,35,Loss,91,111,3,3,0,LAC,62,506,279,3,-4.937220862981121,53.15385829082812,24.1083187139235,29.04553957690462
0.4,0.41666666700000005,27.23333333,10/10/2010,14,29,home,8,LAC,168,415,85,58,35,27,Win,111,91,3,3,3,OAK,62,279,506,0,4.937220862981121,53.15385829082812,29.04553957690462,24.1083187139235
0.333333333,0.5,23.26666667,10/10/2010,17,25,away,7,DAL,163,370,40,55,34,27,Win,158,141,3,6,3,TEN,61,321,511,0,-8.320187049059454,50.144159003101294,20.91198597702092,29.232173026080375
0.5,0.333333333,36.73333333,10/10/2010,25,17,home,-7,TEN,370,163,133,75,27,34,Loss,141,158,6,3,0,DAL,61,511,321,3,8.320187049059454,50.144159003101294,29.232173026080375,20.91198597702092
0.25,0.615384615,30.8,10/10/2010,17,21,away,3,SFO,227,290,30,62,27,24,Win,125,74,4,2,5,PHI,51,352,364,1,3.7915522251135854,50.23593708937322,27.013744657243404,23.22219243212982
0.615384615,0.25,29.2,10/10/2010,21,17,home,-3,PHI,290,227,65,63,24,27,Loss,74,125,2,4,1,SFO,51,364,352,5,-3.7915522251135854,50.23593708937322,23.22219243212982,27.013744657243404
0.46666666700000003,0.294117647,26.08333333,10/11/2010,16,20,away,-9,NYJ,240,173,51,62,20,29,Loss,96,155,4,2,0,MIN,49,336,328,3,-11.769397774138868,40.062646463754525,14.14662434480783,25.916022118946696
0.294117647,0.46666666700000003,33.91666667,10/11/2010,20,16,home,9,MIN,173,240,55,78,29,20,Win,155,96,2,4,3,NYJ,49,328,336,0,11.769397774138868,40.062646463754525,25.916022118946696,14.14662434480783
0.28571428600000004,0.5,25.95,10/17/2010,20,23,away,-14,PHI,228,320,30,64,17,31,Loss,65,154,3,1,1,ATL,48,293,474,2,0.11443056695961218,48.58180442105831,24.34811749400896,24.233686927049348
0.5,0.28571428600000004,34.05,10/17/2010,23,20,home,14,ATL,320,228,78,68,31,17,Win,154,65,1,3,2,PHI,48,474,293,1,-0.11443056695961218,48.58180442105831,24.233686927049348,24.34811749400896
0.333333333,0.41176470600000004,26.61666667,10/17/2010,22,20,away,-3,LAR,208,183,31,61,17,20,Loss,79,117,7,3,0,LAC,37,287,300,1,-3.814430671954984,37.08256786754187,16.634068597793444,20.448499269748424
0.41176470600000004,0.333333333,33.38333333,10/17/2010,20,22,home,3,LAC,183,208,35,69,20,17,Win,117,79,3,7,1,LAR,37,300,287,0,3.814430671954984,37.08256786754187,20.448499269748424,16.634068597793444
0.75,0.4,31.48333333,10/17/2010,27,21,away,25,TBB,263,235,80,64,31,6,Win,212,42,0,1,1,NOS,37,475,277,1,-5.706355186167428,51.45256738587021,22.87310609985139,28.57946128601882
0.4,0.75,28.51666667,10/17/2010,21,27,home,-25,NOS,235,263,30,66,6,31,Loss,42,212,1,0,1,TBB,37,277,475,1,5.706355186167428,51.45256738587021,28.57946128601882,22.87310609985139
0.45,0.384615385,27.3,10/17/2010,16,24,away,-8,NYG,302,167,91,72,20,28,Loss,64,167,2,2,1,DET,48,366,334,3,-7.088077511824848,47.944862931540236,20.428392709857693,27.516470221682543
0.384615385,0.45,32.7,10/17/2010,24,16,home,8,DET,167,302,15,62,28,20,Win,167,64,2,2,3,NYG,48,334,366,1,7.088077511824848,47.944862931540236,27.516470221682543,20.428392709857693
0.428571429,0.23076923100000002,37.93333333,10/17/2010,26,16,away,3,GBP,231,283,30,78,3,0,Win,150,76,0,5,1,MIA,3,381,359,1,-1.4364845572710951,41.05858510431541,19.81105027352216,21.247534830793253
0.23076923100000002,0.428571429,28.05,10/17/2010,16,26,home,-3,MIA,283,231,45,59,0,3,Loss,76,150,5,0,1,GBP,3,359,381,1,1.4364845572710951,41.05858510431541,21.247534830793253,19.81105027352216
0.38888888899999996,0.0,34.38333333,10/17/2010,20,15,away,3,CHI,242,246,83,71,23,20,Win,111,61,0,6,0,SEA,43,353,307,0,-3.2399527141980977,32.57782349211563,14.668935388958765,17.908888103156862
0.0,0.38888888899999996,25.61666667,10/17/2010,15,20,home,-3,SEA,246,242,18,59,20,23,Loss,61,111,6,0,0,CHI,43,307,353,0,3.2399527141980977,32.57782349211563,17.908888103156862,14.668935388958765
0.3125,0.28571428600000004,40.23333333,10/17/2010,21,23,away,-3,NEP,278,267,67,72,0,3,Loss,99,127,3,3,2,BAL,3,377,394,0,3.0508463465417726,34.975082964948314,19.012964655745044,15.962118309203271
0.28571428600000004,0.3125,32.83333333,10/17/2010,23,21,home,3,BAL,267,278,78,73,3,0,Win,127,99,3,3,0,NEP,3,394,377,2,-3.0508463465417726,34.975082964948314,15.96211830920327,19.012964655745044
0.46153846200000004,0.5,28.06666667,10/17/2010,17,22,away,-18,PIT,258,257,41,60,10,28,Loss,69,121,6,0,1,CLE,38,327,378,3,3.2847049075254056,45.112140800236034,24.19842285388072,20.913717946355312
0.5,0.46153846200000004,31.93333333,10/17/2010,22,17,home,18,CLE,257,258,25,62,28,10,Win,121,69,0,6,3,PIT,38,378,327,1,-3.2847049075254056,45.112140800236034,20.913717946355312,24.19842285388072
0.5625,0.5,33.46666667,10/17/2010,25,23,away,-4,HOU,189,289,35,68,31,35,Loss,228,132,1,2,0,KCC,66,417,421,0,-2.6358832374646273,52.12941209171408,24.746764427124727,27.382647664589353
0.5,0.5625,26.53333333,10/17/2010,23,25,home,4,KCC,289,189,53,57,35,31,Win,132,228,2,1,0,HOU,66,421,417,0,2.6358832374646273,52.12941209171408,27.382647664589353,24.746764427124727
0.384615385,0.38888888899999996,29.61666667,10/17/2010,17,21,away,4,DEN,190,201,74,62,24,20,Win,129,145,2,1,2,NYJ,44,319,346,3,-6.997275626219317,46.11466385168317,19.558694112731924,26.555969738951244
0.38888888899999996,0.384615385,30.38333333,10/17/2010,21,17,home,-4,NYJ,201,190,81,72,20,24,Loss,145,129,1,2,3,DEN,44,346,319,2,6.997275626219317,46.11466385168317,26.555969738951244,19.558694112731924
0.333333333,0.41176470600000004,26.65,10/17/2010,10,17,away,-8,SFO,69,191,60,53,9,17,Loss,110,158,2,2,0,OAK,26,179,349,2,-11.650449745084307,35.451607452576255,11.900578853745973,23.551028598830282
0.41176470600000004,0.333333333,33.35,10/17/2010,17,10,home,8,OAK,191,69,143,66,17,9,Win,158,110,2,2,2,SFO,26,349,179,0,11.650449745084307,35.451607452576255,23.551028598830282,11.900578853745973
0.529411765,0.5,32.16666667,10/17/2010,16,14,away,-3,MIN,220,93,91,60,21,24,Loss,94,95,0,3,1,DAL,45,314,188,2,-2.5176829545560957,36.55668434324185,17.019500694342877,19.53718364889897
0.5,0.529411765,27.83333333,10/17/2010,14,16,home,3,DAL,93,220,45,50,24,21,Win,95,94,3,0,2,MIN,45,188,314,1,2.5176829545560957,36.55668434324185,19.53718364889897,17.019500694342877
0.3,0.307692308,27.5,10/17/2010,22,23,away,3,WAS,299,222,15,68,27,24,Win,170,113,1,3,2,IND,51,469,335,3,-5.946311184928179,48.866197632673156,21.45994322387249,27.406254408800667
0.307692308,0.3,32.5,10/17/2010,23,22,home,-3,IND,222,299,53,72,24,27,Loss,113,170,3,1,3,WAS,51,335,469,2,5.946311184928179,48.866197632673156,27.406254408800667,21.45994322387249
0.571428571,0.23076923100000002,32.75,10/18/2010,20,17,away,27,JAX,171,173,57,60,30,3,Win,153,76,0,2,4,TEN,33,324,249,0,-7.780288054930935,42.21713919581471,17.218425570441887,24.998713625372822
0.23076923100000002,0.571428571,27.25,10/18/2010,17,20,home,-27,TEN,173,171,55,63,3,30,Loss,76,153,2,0,0,JAX,33,249,324,4,7.780288054930935,42.21713919581471,24.998713625372822,17.218425570441887
0.5555555560000001,0.307692308,33.4,10/24/2010,21,15,away,-18,TEN,227,253,100,73,19,37,Loss,99,75,1,3,3,PHI,56,326,328,4,-7.480926605493753,48.9728922861197,20.745982840312976,28.226909445806726
0.307692308,0.5555555560000001,26.6,10/24/2010,15,21,home,18,PHI,253,227,37,60,37,19,Win,75,99,3,1,4,TEN,56,328,326,3,7.480926605493753,48.9728922861197,28.226909445806726,20.745982840312976
0.307692308,0.46666666700000003,23.91666667,10/24/2010,15,22,away,-3,CAR,183,303,81,56,20,23,Loss,99,76,2,1,3,SFO,43,282,379,1,-9.953731731928807,44.17199744076894,17.109132854420068,27.062864586348873
0.46666666700000003,0.307692308,36.08333333,10/24/2010,22,15,home,3,SFO,303,183,35,76,23,20,Win,76,99,1,2,1,CAR,43,379,282,3,9.953731731928807,44.17199744076894,27.062864586348873,17.109132854420068
0.3,0.545454545,26.0,10/24/2010,19,25,away,-22,KCC,216,190,43,58,20,42,Loss,84,236,1,1,0,JAX,62,300,426,3,-0.32943671835571564,49.19905891305502,24.43481109734965,24.764247815705367
0.545454545,0.3,34.0,10/24/2010,25,19,home,22,JAX,190,216,92,61,42,20,Win,236,84,1,1,3,KCC,62,426,300,0,0.32943671835571564,49.19905891305502,24.764247815705367,24.43481109734965
0.4,0.25,30.81666667,10/24/2010,15,15,away,1,MIA,290,249,34,57,23,22,Win,58,64,3,1,2,PIT,45,348,313,2,6.712019955660351,39.73771149723978,23.224865726450066,16.512845770789713
0.25,0.4,29.18333333,10/24/2010,15,15,home,-1,PIT,249,290,24,58,22,23,Loss,64,58,1,3,2,MIA,45,313,348,2,-6.712019955660351,39.73771149723978,16.512845770789713,23.224865726450066
0.583333333,0.538461538,30.36666667,10/24/2010,28,22,away,-7,ATL,385,299,36,74,32,39,Loss,84,153,3,0,2,CIN,71,469,452,1,0.23109624062185524,57.520842294942305,28.87596926778208,28.644873027160227
0.538461538,0.583333333,29.63333333,10/24/2010,22,28,home,7,CIN,299,385,41,63,39,32,Win,153,84,0,3,1,ATL,71,452,469,2,-0.23109624062185524,57.520842294942305,28.644873027160227,28.87596926778208
0.153846154,0.2,29.2,10/24/2010,13,19,away,3,CHI,187,256,48,62,17,14,Win,121,66,2,4,6,WAS,31,308,322,3,-1.5544683349305668,40.97251686255008,19.709024263809756,21.263492598740324
0.2,0.153846154,30.8,10/24/2010,19,13,home,-3,WAS,256,187,51,60,14,17,Loss,66,121,4,2,3,CHI,31,322,308,6,1.5544683349305668,40.97251686255008,21.263492598740324,19.709024263809756
0.181818182,0.333333333,24.43333333,10/24/2010,12,25,away,13,NOS,85,336,30,46,30,17,Win,125,58,1,3,4,CLE,47,210,394,0,2.240129385918845,37.25303405834453,19.746581722131687,17.506452336212845
0.333333333,0.181818182,35.56666667,10/24/2010,25,12,home,-13,CLE,336,85,98,77,17,30,Loss,58,125,3,1,0,NOS,47,394,210,4,-2.240129385918845,37.25303405834453,17.506452336212845,19.746581722131687
0.647058824,0.181818182,38.6,10/24/2010,27,21,away,-3,BAL,382,229,78,79,0,3,Loss,132,135,1,2,2,BUF,3,514,364,4,1.3433086578504465,54.555146710464875,27.949227684157663,26.605919026307213
0.181818182,0.647058824,25.5,10/24/2010,21,27,home,3,BUF,229,382,18,62,3,0,Win,135,132,2,1,4,BAL,3,364,514,2,-1.3433086578504465,54.555146710464875,26.605919026307213,27.949227684157663
0.5,0.333333333,28.68333333,10/24/2010,19,17,away,-1,TBB,124,189,45,59,17,18,Loss,161,124,1,3,0,LAR,35,285,313,1,-11.564538075199223,37.53272123921172,12.984091582006247,24.54862965720547
0.333333333,0.5,31.31666667,10/24/2010,17,19,home,1,LAR,189,124,92,64,18,17,Win,124,161,3,1,1,TBB,35,313,285,0,11.564538075199223,37.53272123921172,24.54862965720547,12.984091582006247
0.166666667,0.333333333,22.71666667,10/24/2010,13,16,away,-12,SEA,114,158,32,55,10,22,Loss,113,144,2,5,1,ARI,32,227,302,5,-6.376240261385417,29.29516225773476,11.45946099817467,17.83570125956009
0.333333333,0.166666667,37.28333333,10/24/2010,16,13,home,12,ARI,158,114,95,79,22,10,Win,144,113,5,2,5,SEA,32,302,227,1,6.376240261385417,29.29516225773476,17.83570125956009,11.45946099817467
0.46153846200000004,0.181818182,38.65,10/24/2010,29,11,away,45,DEN,180,165,94,74,59,14,Win,328,75,2,4,3,OAK,73,508,240,0,-1.5189104140752754,50.21865260425938,24.349871095092055,25.868781509167327
0.181818182,0.46153846200000004,21.35,10/24/2010,11,29,home,-45,OAK,165,180,64,50,14,59,Loss,75,328,4,2,0,DEN,73,240,508,3,1.5189104140752754,50.21865260425938,25.868781509167327,24.349871095092055
0.25,0.46666666700000003,25.58333333,10/24/2010,15,23,away,3,LAC,128,325,51,58,23,20,Win,51,38,4,2,4,NEP,43,179,363,0,4.083223534578055,37.01922437838964,20.551223956483845,16.468000421905792
0.46666666700000003,0.25,34.41666667,10/24/2010,23,15,home,-3,NEP,325,128,69,71,20,23,Loss,38,51,2,4,0,LAC,43,363,179,4,-4.083223534578055,37.01922437838964,16.468000421905792,20.551223956483845
0.428571429,0.545454545,31.06666667,10/24/2010,21,20,away,-4,GBP,206,295,40,66,24,28,Loss,196,84,1,0,2,MIN,52,402,379,3,3.350982908816812,54.505571131197954,28.928277020007382,25.57729411119057
0.545454545,0.428571429,28.93333333,10/24/2010,20,21,home,4,MIN,295,206,20,58,28,24,Win,84,196,0,1,3,GBP,52,379,402,2,-3.350982908816812,54.505571131197954,25.57729411119057,28.928277020007382
0.384615385,0.0,37.51666667,10/25/2010,25,14,away,6,DAL,297,213,46,73,41,35,Win,200,41,1,3,2,NYG,76,497,254,5,0.339915475887409,46.91092628909057,23.62542088248899,23.28550540660158
0.0,0.384615385,22.48333333,10/25/2010,14,25,home,-6,NYG,213,297,42,56,35,41,Loss,41,200,3,1,5,DAL,76,254,497,2,-0.339915475887409,46.91092628909057,23.28550540660158,23.62542088248899
0.5,0.4,23.53333333,10/31/2010,14,15,away,-10,LAR,176,184,30,57,10,20,Loss,25,62,3,2,0,CAR,30,201,246,4,-9.598367266448895,36.62404225452113,13.512837494036116,23.111204760485013
0.4,0.5,36.46666667,10/31/2010,15,14,home,10,CAR,184,176,65,63,20,10,Win,62,25,2,3,4,LAR,30,246,201,0,9.598367266448895,36.62404225452113,23.111204760485013,13.512837494036116
0.47826087,0.26666666699999997,39.36666667,10/31/2010,23,24,away,-3,KCC,191,140,35,84,0,3,Loss,137,274,3,3,0,BUF,3,328,414,1,-16.558653630370543,32.00390998117153,7.722628175400494,24.281281805771037
0.26666666699999997,0.47826087,35.63333333,10/31/2010,24,23,home,3,BUF,140,191,50,74,3,0,Win,274,137,3,3,1,KCC,3,414,328,0,16.558653630370543,32.00390998117153,24.281281805771037,7.722628175400494
0.5,0.46153846200000004,32.58333333,10/31/2010,20,25,away,18,DAL,238,365,36,58,35,17,Win,149,50,3,2,4,JAX,52,387,415,1,-2.3708493212196693,53.746452910729985,25.68780179475516,28.058651115974826
0.46153846200000004,0.5,27.41666667,10/31/2010,25,20,home,-18,JAX,365,238,20,73,17,35,Loss,50,149,2,3,1,DAL,52,415,387,4,2.3708493212196693,53.746452910729985,28.058651115974826,25.68780179475516
0.333333333,0.375,33.48333333,10/31/2010,20,16,away,8,CIN,217,156,42,68,22,14,Win,137,106,0,0,1,MIA,36,354,262,2,-3.212401035235583,36.93750776442099,16.862553364592706,20.074954399828286
0.375,0.333333333,26.51666667,10/31/2010,16,20,home,-8,MIA,156,217,36,64,14,22,Loss,106,137,0,0,2,CIN,36,262,354,1,3.212401035235583,36.93750776442099,20.074954399828286,16.862553364592706
0.14285714300000002,0.41176470600000004,28.61666667,10/31/2010,13,15,away,9,NYJ,156,241,15,62,9,0,Win,81,119,2,2,3,GBP,9,237,360,0,-5.746961163247372,35.35594045360638,14.804489645179505,20.551450808426875
0.41176470600000004,0.14285714300000002,31.38333333,10/31/2010,15,13,home,-9,GBP,241,156,55,69,0,9,Loss,119,81,2,2,0,NYJ,9,360,237,3,5.746961163247372,35.35594045360638,20.551450808426875,14.804489645179505
0.14285714300000002,0.235294118,27.83333333,10/31/2010,13,19,away,-12,DET,195,202,77,63,25,37,Loss,80,102,7,1,2,WAS,62,275,304,2,-11.444209290191576,33.07971409943717,10.817752404622794,22.261961694814374
0.235294118,0.14285714300000002,32.16666667,10/31/2010,19,13,home,12,WAS,202,195,65,71,37,25,Win,102,80,1,7,2,DET,62,304,275,2,11.444209290191576,33.07971409943717,22.261961694814374,10.817752404622796
0.2,0.384615385,26.43333333,10/31/2010,22,16,away,-8,SFO,339,196,60,61,16,24,Loss,59,143,4,0,0,DEN,40,398,339,2,3.6021062507928683,44.54562840696868,24.073867328880773,20.47176107808791
0.384615385,0.2,33.56666667,10/31/2010,16,22,home,8,DEN,196,339,66,61,24,16,Win,143,59,0,4,2,SFO,40,339,398,0,-3.6021062507928683,44.54562840696868,20.47176107808791,24.073867328880773
0.307692308,0.666666667,22.21666667,10/31/2010,15,23,away,-8,LAC,305,300,80,55,25,33,Loss,65,156,0,1,1,TEN,58,370,456,0,-9.906229801857565,49.75867946423499,19.926224831188712,29.832454633046275
0.666666667,0.307692308,37.78333333,10/31/2010,23,15,home,8,TEN,300,305,62,71,33,25,Win,156,65,1,0,0,LAC,58,456,370,1,9.906229801857565,49.75867946423499,29.832454633046275,19.926224831188712
0.333333333,0.538461538,30.48333333,10/31/2010,19,22,away,3,ARI,253,296,80,57,38,35,Win,154,100,2,1,4,TBB,73,407,396,2,1.2668410217335824,52.11099654816661,26.688918784950097,25.422077763216514
0.538461538,0.333333333,29.51666667,10/31/2010,22,19,home,-3,TBB,296,253,12,64,35,38,Loss,100,154,1,2,2,ARI,73,396,407,4,-1.2668410217335824,52.11099654816661,25.422077763216514,26.688918784950097
0.0625,0.294117647,23.93333333,10/31/2010,10,18,away,-30,OAK,117,306,55,59,3,33,Loss,47,239,8,2,0,SEA,36,164,545,1,-6.232412004155908,36.14017750067731,14.953882748260703,21.186294752416607
0.294117647,0.0625,36.06666667,10/31/2010,18,10,home,30,SEA,306,117,102,68,33,3,Win,239,47,2,8,1,OAK,36,545,164,0,6.232412004155908,36.14017750067731,21.186294752416607,14.953882748260702
0.363636364,0.545454545,35.13333333,10/31/2010,23,18,away,-10,NEP,285,240,35,67,18,28,Loss,125,122,1,0,0,MIN,46,410,362,1,9.197895264745743,47.37666961369368,28.28728243921971,19.08938717447397
0.545454545,0.363636364,24.86666667,10/31/2010,18,23,home,10,MIN,240,285,47,54,28,18,Win,122,125,0,1,1,NEP,46,362,410,0,-9.197895264745743,47.37666961369368,19.08938717447397,28.28728243921971
0.3,0.4375,25.9,10/31/2010,13,19,away,-10,NOS,171,288,38,52,10,20,Loss,108,30,3,2,2,PIT,30,279,318,2,4.528335399881167,38.619091465743345,21.573713432812255,17.04537803293109
0.4375,0.3,34.1,10/31/2010,19,13,home,10,PIT,288,171,35,67,20,10,Win,30,108,2,3,2,NOS,30,318,279,2,-4.528335399881167,38.619091465743345,17.04537803293109,21.573713432812255
0.272727273,0.46666666700000003,23.58333333,11/1/2010,19,24,away,-13,IND,183,259,30,59,17,30,Loss,108,107,3,1,0,HOU,47,291,366,2,-6.112638021561789,43.710309950658235,18.798835964548225,24.91147398611001
0.46666666700000003,0.272727273,36.41666667,11/1/2010,24,19,home,13,HOU,259,183,69,74,30,17,Win,107,108,1,3,2,IND,47,366,291,0,6.112638021561789,43.710309950658235,24.91147398611001,18.798835964548225
0.444444444,0.46153846200000004,26.18333333,11/7/2010,18,25,away,6,HOU,290,252,62,50,29,23,Win,77,140,1,2,1,LAC,52,367,392,2,1.256457297176346,51.46647457708603,26.36146593713119,25.105008639954843
0.46153846200000004,0.444444444,33.81666667,11/7/2010,25,18,home,-6,LAC,252,290,31,68,23,29,Loss,140,77,2,1,2,HOU,52,392,367,1,-1.256457297176346,51.46647457708603,25.105008639954843,26.36146593713119
0.5,0.46153846200000004,21.63333333,11/7/2010,17,23,away,-16,BAL,216,256,23,53,10,26,Loss,73,146,2,4,0,MIA,36,289,402,3,6.863592420542309,43.82821595550282,25.345904188022566,18.482311767480255
0.46153846200000004,0.5,38.36666667,11/7/2010,23,17,home,16,MIA,256,216,40,71,26,10,Win,146,73,4,2,3,BAL,36,402,289,0,-6.863592420542309,43.82821595550282,18.482311767480255,25.345904188022566
0.583333333,0.625,31.21666667,11/7/2010,19,22,away,3,BUF,178,294,45,62,22,19,Win,105,46,1,1,3,CHI,41,283,340,1,-8.163449028535556,47.6888253466889,19.762688159076674,27.926137187612227
0.625,0.583333333,28.78333333,11/7/2010,22,19,home,-3,CHI,294,178,33,70,19,22,Loss,46,105,1,1,1,BUF,41,340,283,3,8.163449028535556,47.6888253466889,27.926137187612227,19.762688159076674
0.615384615,0.571428571,25.9,11/7/2010,14,26,away,-6,ATL,182,235,30,50,21,27,Loss,96,130,1,0,0,TBB,48,278,365,2,-4.212186235216073,43.754213048013135,19.77101340639853,23.983199641614604
0.571428571,0.615384615,34.1,11/7/2010,26,14,home,6,TBB,235,182,53,69,27,21,Win,130,96,0,1,2,ATL,48,365,278,0,4.212186235216073,43.754213048013135,23.983199641614604,19.77101340639853
0.272727273,0.538461538,21.86666667,11/7/2010,19,22,away,-20,CLE,215,174,20,59,14,34,Loss,68,230,1,0,1,NEP,48,283,404,3,11.301290977477397,42.8843872161,27.0928390967887,15.791548119311303
0.538461538,0.272727273,38.13333333,11/7/2010,22,19,home,20,NEP,174,215,28,63,34,14,Win,230,68,0,1,3,CLE,48,404,283,1,-11.301290977477397,42.8843872161,15.791548119311301,27.0928390967887
0.5,0.083333333,34.68333333,11/7/2010,27,15,away,31,CAR,243,68,64,76,34,3,Win,165,127,1,4,2,NOS,37,408,195,1,-11.221852635216901,39.42595438569252,14.102050875237808,25.323903510454713
0.083333333,0.5,25.31666667,11/7/2010,15,27,home,-31,NOS,68,243,65,64,3,34,Loss,127,165,4,1,1,CAR,37,195,408,2,11.221852635216901,39.42595438569252,25.323903510454713,14.10205087523781
0.23076923100000002,0.25,27.21666667,11/7/2010,13,28,away,-3,MIN,172,427,39,54,0,3,Loss,53,80,6,3,3,ARI,3,225,507,1,6.961347024727545,41.60157806169801,24.281462543212776,17.32011551848523
0.25,0.23076923100000002,38.08333333,11/7/2010,28,13,home,3,ARI,427,172,65,70,3,0,Win,80,53,3,6,1,MIN,3,507,225,3,-6.961347024727545,41.60157806169801,17.32011551848523,24.281462543212776
0.384615385,0.333333333,29.53333333,11/7/2010,23,21,away,3,DET,327,228,99,70,3,0,Win,110,78,1,2,0,NYJ,3,437,306,2,-9.908126974428718,47.31033208139658,18.70110255348393,28.60922952791265
0.333333333,0.384615385,32.76666667,11/7/2010,21,23,home,-3,NYJ,228,327,102,67,0,3,Loss,78,110,2,1,2,DET,3,306,437,0,9.908126974428718,47.31033208139658,28.60922952791265,18.70110255348393
0.46153846200000004,0.125,42.56666667,11/7/2010,30,8,away,34,SEA,290,113,40,79,41,7,Win,197,49,0,0,3,NYG,48,487,162,1,5.263794500079797,43.564308535273405,24.4140515176766,19.150257017596804
0.125,0.46153846200000004,17.43333333,11/7/2010,8,30,home,-34,NYG,113,290,70,37,7,41,Loss,49,197,0,0,1,SEA,48,162,487,3,-5.263794500079797,43.564308535273405,19.150257017596804,24.4140515176766
0.2,0.25,33.16666667,11/7/2010,21,17,away,-3,OAK,200,209,100,72,0,3,Loss,104,112,3,4,3,KCC,3,304,321,2,-12.368731327023347,40.884535286993646,14.25790197998515,26.626633307008497
0.25,0.2,29.71666667,11/7/2010,17,21,home,3,KCC,209,200,140,64,3,0,Win,112,104,4,3,2,OAK,3,321,304,3,12.368731327023347,40.884535286993646,26.626633307008497,14.25790197998515
0.428571429,0.46666666700000003,28.16666667,11/7/2010,27,19,away,-2,PHI,276,207,59,73,24,26,Loss,62,195,3,3,0,IND,50,338,402,2,-5.1413687537220945,51.01792521128424,22.938278228781073,28.07964698250317
0.46666666700000003,0.428571429,31.83333333,11/7/2010,19,27,home,2,IND,207,276,125,63,26,24,Win,195,62,3,3,2,PHI,50,402,338,0,5.1413687537220945,51.01792521128424,28.07964698250317,22.938278228781073
0.4,0.666666667,22.06666667,11/7/2010,12,26,away,-38,GBP,166,277,40,48,7,45,Loss,39,138,4,1,0,DAL,52,205,415,4,3.0932410729456734,45.736129806295445,24.41468543962056,21.321444366674886
0.666666667,0.4,37.93333333,11/7/2010,26,12,home,38,DAL,277,166,20,71,45,7,Win,138,39,1,4,4,GBP,52,415,205,0,-3.0932410729456734,45.736129806295445,21.321444366674886,24.41468543962056
0.428571429,0.25,32.31666667,11/8/2010,14,18,away,6,CIN,193,218,73,61,27,21,Win,121,54,1,4,2,PIT,48,314,272,2,3.9939360832017505,37.50513447979187,20.74953528149681,16.75559919829506
0.25,0.428571429,27.68333333,11/8/2010,18,14,home,-6,PIT,218,193,30,58,21,27,Loss,54,121,4,1,2,CIN,48,272,314,2,-3.9939360832017505,37.50513447979187,16.75559919829506,20.74953528149681
0.545454545,0.6,24.85,11/11/2010,20,23,away,-5,ATL,204,302,51,57,21,26,Loss,116,60,2,2,0,BAL,47,320,362,2,0.8757886244436675,43.4067455418907,22.141267083167183,21.265478458723518
0.6,0.545454545,35.15,11/11/2010,23,20,home,5,BAL,302,204,5,75,26,21,Win,60,116,2,2,2,ATL,47,362,320,0,-0.8757886244436675,43.4067455418907,21.265478458723518,22.141267083167183
0.263157895,0.333333333,32.4,11/14/2010,19,12,away,-2,BUF,314,139,60,77,12,14,Loss,76,149,1,1,1,DET,26,390,288,1,-9.676452891892344,38.27571109205287,14.299629100080264,23.97608199197261
0.333333333,0.263157895,27.6,11/14/2010,12,19,home,2,DET,139,314,30,58,14,12,Win,149,76,1,1,1,BUF,26,288,390,1,9.676452891892344,38.27571109205287,23.97608199197261,14.299629100080264
0.4,0.363636364,24.61666667,11/14/2010,20,29,away,-7,JAX,314,326,49,53,24,31,Loss,81,165,0,2,0,HOU,55,395,491,1,-0.2018453982363475,57.27293593954488,28.535545270654268,28.737390668890612
0.363636364,0.4,35.38333333,11/14/2010,29,20,home,7,HOU,326,314,62,69,31,24,Win,165,81,2,0,1,JAX,55,491,395,0,0.2018453982363475,57.27293593954488,28.737390668890612,28.535545270654268
0.3125,0.529411765,26.93333333,11/14/2010,15,21,away,-12,MIA,124,316,55,65,17,29,Loss,135,88,2,1,1,TEN,46,259,404,3,-10.377767094314343,42.378535204666875,16.000384055176266,26.37815114949061
0.529411765,0.3125,33.06666667,11/14/2010,21,15,home,12,TEN,316,124,63,68,29,17,Win,88,135,1,2,3,MIA,46,404,259,1,10.377767094314343,42.378535204666875,26.37815114949061,16.000384055176266
0.111111111,0.578947368,25.35,11/14/2010,15,18,away,-14,CHI,170,230,19,54,13,27,Loss,70,130,1,2,2,MIN,40,240,360,4,-7.744135164929343,40.64894331213052,16.45240407360059,24.19653923852993
0.578947368,0.111111111,34.65,11/14/2010,18,15,home,14,MIN,230,170,116,74,27,13,Win,130,70,2,1,4,CHI,40,360,240,2,7.744135164929343,40.64894331213052,24.19653923852993,16.45240407360059
0.523809524,0.333333333,47.13333333,11/14/2010,28,19,away,6,CLE,284,196,70,91,6,0,Win,172,107,2,3,2,NYJ,6,456,303,1,-13.062265943747883,37.887978330817,12.412856193534559,25.47512213728244
0.333333333,0.523809524,27.6,11/14/2010,19,28,home,-6,NYJ,196,284,52,59,0,6,Loss,107,172,3,2,1,CLE,6,303,456,2,13.062265943747883,37.887978330817,25.47512213728244,12.412856193534559
0.384615385,0.35714285700000004,34.18333333,11/14/2010,19,16,away,-6,IND,269,180,38,65,17,23,Loss,72,76,3,2,0,CIN,40,341,256,5,3.2923598969958263,41.50004023506335,22.39620006602959,19.103840169033763
0.35714285700000004,0.384615385,25.81666667,11/14/2010,16,19,home,6,CIN,180,269,45,60,23,17,Win,76,72,2,3,5,IND,40,256,341,0,-3.2923598969958263,41.50004023506335,19.103840169033763,22.39620006602959
0.4,0.5,28.66666667,11/14/2010,18,21,away,-15,TBB,182,235,71,62,16,31,Loss,118,186,2,1,2,CAR,47,300,421,1,-7.439284373241943,49.53386040820158,21.047288017479822,28.48657239072176
0.5,0.4,31.33333333,11/14/2010,21,18,home,15,CAR,235,182,80,55,31,16,Win,186,118,1,2,1,TBB,47,421,300,2,7.439284373241943,49.53386040820158,28.48657239072176,21.047288017479822
0.384615385,0.6,31.85,11/14/2010,30,25,away,-20,DEN,433,299,40,79,29,49,Loss,51,153,4,0,0,KCC,78,484,452,1,-1.7081170653230089,57.999600386918964,28.145741660797977,29.853858726120986
0.6,0.384615385,28.15,11/14/2010,25,30,home,20,KCC,299,433,28,66,49,29,Win,153,51,0,4,1,DEN,78,452,484,0,1.7081170653230089,57.999600386918964,29.853858726120986,28.145741660797977
0.4,0.181818182,35.08333333,11/14/2010,24,19,away,18,ARI,380,286,51,73,36,18,Win,110,41,2,5,2,SEA,54,490,327,1,0.8661939167829971,45.10205285295463,22.984123384868813,22.117929468085816
0.181818182,0.4,24.91666667,11/14/2010,19,24,home,-18,SEA,286,380,50,64,18,36,Loss,41,110,5,2,1,ARI,54,327,490,2,-0.8661939167829971,45.10205285295463,22.117929468085816,22.984123384868813
0.272727273,0.4,22.15,11/14/2010,15,25,away,13,NYG,327,373,60,50,33,20,Win,100,107,0,0,3,DAL,53,427,480,1,-2.6631888031623596,54.87045227078213,26.103631733809884,28.766820536972247
0.4,0.272727273,37.85,11/14/2010,25,15,home,-13,DAL,373,327,69,76,20,33,Loss,107,100,0,0,1,NYG,53,480,427,3,2.6631888031623596,54.87045227078213,28.766820536972247,26.103631733809884
0.14285714300000002,0.0,35.05,11/14/2010,22,19,away,-3,SFO,228,323,135,69,0,3,Loss,104,98,3,5,0,LAR,3,332,421,0,-4.644377273280923,36.61464976847485,15.985136247596962,20.629513520877886
0.0,0.14285714300000002,30.3,11/14/2010,19,22,home,3,LAR,323,228,105,59,3,0,Win,98,104,5,3,0,SFO,3,421,332,0,4.644377273280923,36.61464976847485,20.629513520877886,15.985136247596962
0.3,0.41666666700000005,31.46666667,11/14/2010,26,27,away,13,PIT,350,349,113,67,39,26,Win,103,76,0,5,1,NEP,65,453,425,0,6.586039359360679,52.90696571779443,29.746502538577552,23.160463179216876
0.41666666700000005,0.3,28.53333333,11/14/2010,27,26,home,-13,NEP,349,350,45,70,26,39,Loss,76,103,5,0,0,PIT,65,425,453,1,-6.586039359360679,52.90696571779443,23.160463179216876,29.746502538577552
0.615384615,0.0,38.18333333,11/15/2010,28,15,away,31,WAS,332,270,35,67,59,28,Win,260,105,1,2,3,PHI,87,592,375,0,7.191056436853039,57.10975778270201,32.150407109777525,24.959350672924487
0.0,0.615384615,21.81666667,11/15/2010,15,28,home,-31,PHI,270,332,41,51,28,59,Loss,105,260,2,1,0,WAS,87,375,592,3,-7.191056436853039,57.10975778270201,24.959350672924487,32.150407109777525
0.5555555560000001,0.090909091,37.85,11/18/2010,19,10,away,16,MIA,133,148,45,68,16,0,Win,135,39,3,6,1,CHI,16,268,187,1,-0.3391925186641469,28.14000829070303,13.90040788601944,14.23960040468359
0.090909091,0.5555555560000001,22.15,11/18/2010,10,19,home,-16,CHI,148,133,45,48,0,16,Loss,39,135,6,3,1,MIA,16,187,268,1,0.3391925186641469,28.14000829070303,14.23960040468359,13.90040788601944
0.533333333,0.307692308,33.26666667,11/21/2010,20,15,away,28,MIN,283,207,5,65,31,3,Win,91,93,3,1,2,GBP,34,374,300,0,2.07581764312887,43.76751112194434,22.921664382536605,20.845846739407733
0.307692308,0.533333333,26.73333333,11/21/2010,15,20,home,-28,GBP,207,283,50,57,3,31,Loss,93,91,1,3,0,MIN,34,300,374,2,-2.07581764312887,43.76751112194434,20.845846739407733,22.921664382536605
0.181818182,0.076923077,34.55,11/21/2010,22,9,away,24,CAR,278,150,20,67,37,13,Win,100,120,3,3,2,BAL,50,378,270,2,5.353473329161263,36.837475934455526,21.095474631808393,15.742001302647132
0.076923077,0.181818182,25.45,11/21/2010,9,22,home,-24,BAL,150,278,54,53,13,37,Loss,120,100,3,3,2,CAR,50,270,378,2,-5.353473329161263,36.837475934455526,15.742001302647132,21.095474631808393
0.333333333,0.46666666700000003,25.68333333,11/21/2010,17,22,away,-3,NYJ,246,298,25,60,27,30,Loss,97,103,1,3,2,HOU,57,343,401,1,-6.126425468542466,47.30553163951851,20.589553085488024,26.71597855403049
0.46666666700000003,0.333333333,34.31666667,11/21/2010,22,17,home,3,HOU,298,246,39,72,30,27,Win,103,97,3,1,1,NYJ,57,401,343,2,6.126425468542466,47.30553163951851,26.71597855403049,20.589553085488024
0.5,0.272727273,40.15,11/21/2010,32,15,away,3,TEN,358,222,20,86,3,0,Win,107,151,3,1,2,WAS,3,465,373,1,-9.956826011058231,47.7368827673638,18.890028378152785,28.846854389211018
0.272727273,0.5,26.56666667,11/21/2010,15,32,home,-3,WAS,222,358,81,51,0,3,Loss,151,107,1,3,1,TEN,3,373,465,2,9.956826011058231,47.7368827673638,28.846854389211018,18.890028378152785
0.5,0.5625,27.85,11/21/2010,23,26,away,18,CIN,308,228,58,60,49,31,Win,141,133,1,2,3,BUF,80,449,361,2,3.1545565745762394,58.45002501738597,30.802290795981104,27.647734221404864
0.5625,0.5,32.15,11/21/2010,26,23,home,-18,BUF,228,308,57,69,31,49,Loss,133,141,2,1,2,CIN,80,361,449,3,-3.1545565745762394,58.45002501738597,27.647734221404864,30.802290795981104
0.4375,0.363636364,28.53333333,11/21/2010,15,24,away,-4,JAX,195,226,45,60,20,24,Loss,88,145,6,4,6,CLE,44,283,371,1,0.5943449290209344,44.99567571042057,22.795010319720753,22.200665390699818
0.363636364,0.4375,31.46666667,11/21/2010,24,15,home,4,CLE,226,195,10,67,24,20,Win,145,88,4,6,1,JAX,44,371,283,6,-0.5943449290209344,44.99567571042057,22.200665390699818,22.795010319720753
0.5555555560000001,0.545454545,29.93333333,11/21/2010,17,19,away,-16,DAL,263,131,76,70,19,35,Loss,75,134,3,2,1,DET,54,338,265,2,-7.518578853771927,41.706058128401864,17.093739637314968,24.612318491086896
0.545454545,0.5555555560000001,30.06666667,11/21/2010,19,17,home,16,DET,131,263,39,56,35,19,Win,134,75,2,3,2,DAL,54,265,338,1,7.518578853771927,41.706058128401864,24.612318491086896,17.093739637314968
0.214285714,0.5,27.21666667,11/21/2010,17,18,away,-32,PIT,121,269,55,65,3,35,Loss,61,162,6,2,1,OAK,38,182,431,3,-10.587696571106918,43.21451125434564,16.31340734161936,26.901103912726278
0.5,0.214285714,32.78333333,11/21/2010,18,17,home,32,OAK,269,121,163,64,35,3,Win,162,61,2,6,3,PIT,38,431,182,1,10.587696571106918,43.21451125434564,26.901103912726278,16.31340734161936
0.26666666699999997,0.363636364,32.36666667,11/21/2010,19,17,away,-18,KCC,281,193,96,68,13,31,Loss,101,159,2,0,0,ARI,44,382,352,0,-0.7760372401998428,38.08943726503614,18.65670001241815,19.43273725261799
0.363636364,0.26666666699999997,27.63333333,11/21/2010,17,19,home,18,ARI,193,281,23,53,31,13,Win,159,101,0,2,0,KCC,44,352,382,0,0.7760372401998428,38.08943726503614,19.43273725261799,18.65670001241815
0.529411765,0.1,35.91666667,11/21/2010,24,15,away,17,LAR,253,233,30,70,34,17,Win,138,71,0,0,1,ATL,51,391,304,0,-2.2876497994670846,40.19452962380893,18.953439912170925,21.241089711638008
0.1,0.529411765,24.08333333,11/21/2010,15,24,home,-17,ATL,233,253,54,54,17,34,Loss,71,138,0,0,0,LAR,51,304,391,1,2.2876497994670846,40.19452962380893,21.241089711638008,18.953439912170925
0.5,0.25,36.4,11/21/2010,20,11,away,21,SFO,137,118,35,66,21,0,Win,162,71,2,6,2,TBB,21,299,189,0,-4.43614500263735,29.037784288959816,12.300819643161233,16.736964645798583
0.25,0.5,23.6,11/21/2010,11,20,home,-21,TBB,118,137,18,55,0,21,Loss,71,162,6,2,0,SFO,21,189,299,2,4.43614500263735,29.037784288959816,16.736964645798583,12.300819643161233
0.583333333,0.7333333329999999,26.25,11/21/2010,21,26,away,-15,NOS,366,382,79,61,19,34,Loss,58,112,0,0,2,SEA,53,424,494,2,-0.07304387750017582,61.43696336878948,30.68195974564465,30.755003623144827
0.7333333329999999,0.583333333,33.75,11/21/2010,26,21,home,15,SEA,382,366,24,72,34,19,Win,112,58,0,0,2,NOS,53,494,424,2,0.07304387750017582,61.43696336878948,30.755003623144827,30.68195974564465
0.7857142859999999,0.636363636,29.35,11/21/2010,28,22,away,-3,NEP,396,178,48,72,28,31,Loss,71,168,0,1,0,IND,59,467,346,3,6.163104985355211,58.50534101067479,32.334222998015,26.17111801265979
0.636363636,0.7857142859999999,30.65,11/21/2010,22,28,home,3,IND,178,396,15,60,31,28,Win,168,71,1,0,3,NEP,59,346,467,0,-6.163104985355211,58.50534101067479,26.17111801265979,32.334222998015
0.454545455,0.214285714,25.93333333,11/21/2010,13,17,away,-10,PHI,147,244,54,52,17,27,Loss,61,148,0,3,2,NYG,44,208,392,5,-1.437727879091323,45.812489528304,22.187380824606336,23.625108703697663
0.214285714,0.454545455,34.06666667,11/21/2010,17,13,home,10,NYG,244,147,119,67,27,17,Win,148,61,3,0,5,PHI,44,392,208,2,1.437727879091323,45.812489528304,23.625108703697663,22.187380824606336
0.083333333,0.5,25.68333333,11/22/2010,16,21,away,-21,LAC,172,253,56,58,14,35,Loss,63,147,5,1,1,DEN,49,235,400,1,2.338357937754978,39.188499378775774,20.763428658265376,18.425070720510398
0.5,0.083333333,34.31666667,11/22/2010,21,16,home,21,DEN,253,172,40,65,35,14,Win,147,63,1,5,1,LAC,49,400,235,1,-2.338357937754978,39.188499378775774,18.425070720510398,20.763428658265376
0.5,0.5,28.91666667,11/25/2010,20,25,away,21,DET,338,277,50,53,45,24,Win,109,129,1,2,2,NEP,69,447,406,0,6.664550484035175,54.4254105535021,30.544980518768636,23.88043003473346
0.5,0.5,31.08333333,11/25/2010,25,20,home,-21,NEP,277,338,66,75,24,45,Loss,129,109,2,1,0,DET,69,406,447,2,-6.664550484035175,54.4254105535021,23.88043003473346,30.544980518768636
0.428571429,0.46666666700000003,25.31666667,11/25/2010,21,24,away,3,DAL,333,313,30,62,30,27,Win,81,144,2,1,3,NOS,57,414,457,2,-0.8076728388246884,53.65975131589455,26.426039238534933,27.23371207735962
0.46666666700000003,0.428571429,34.68333333,11/25/2010,24,21,home,-3,NOS,313,333,19,75,27,30,Loss,144,81,1,2,2,DAL,57,457,414,3,0.8076728388246884,53.65975131589455,27.23371207735962,26.426039238534933
0.26666666699999997,0.23076923100000002,26.51666667,11/25/2010,13,18,away,-16,NYJ,117,149,25,62,10,26,Loss,46,170,3,2,1,CIN,36,163,319,3,-2.739439125280665,30.46717821813635,13.863869546427843,16.603308671708508
0.23076923100000002,0.26666666699999997,33.48333333,11/25/2010,18,13,home,16,CIN,149,117,64,67,26,10,Win,170,46,2,3,3,NYJ,36,319,163,1,2.739439125280665,30.46717821813635,16.603308671708508,13.863869546427843
0.4,0.46666666700000003,33.08333333,11/28/2010,17,10,away,4,WAS,162,187,15,63,17,13,Win,137,29,2,4,1,MIN,30,299,216,0,-4.620935176197912,30.85122333686856,13.115144080335323,17.736079256533237
0.46666666700000003,0.4,26.91666667,11/28/2010,10,17,home,-4,MIN,187,162,35,52,13,17,Loss,29,137,4,2,0,WAS,30,216,299,1,4.620935176197912,30.85122333686856,17.736079256533237,13.115144080335325
0.272727273,0.5,20.31666667,11/28/2010,9,24,away,-20,HOU,138,158,79,44,0,20,Loss,24,188,1,2,0,TEN,20,162,346,3,-10.256741655177343,37.06994785431164,13.40660309956715,23.663344754744493
0.5,0.272727273,39.68333333,11/28/2010,24,9,home,20,TEN,158,138,68,76,20,0,Win,188,24,2,1,3,HOU,20,346,162,0,10.256741655177343,37.06994785431164,23.663344754744493,13.40660309956715
0.363636364,0.333333333,28.33333333,11/28/2010,22,19,away,-3,ATL,341,177,66,59,17,20,Loss,77,117,1,2,0,GBP,37,418,294,1,6.824404632879221,45.15933818436731,25.991871408623265,19.167466775744042
0.333333333,0.363636364,31.66666667,11/28/2010,19,22,home,3,GBP,177,341,50,57,20,17,Win,117,77,2,1,1,ATL,37,294,418,0,-6.824404632879221,45.15933818436731,19.167466775744042,25.991871408623265
0.46666666700000003,0.363636364,28.26666667,11/28/2010,16,26,away,-1,CLE,175,227,68,58,23,24,Loss,151,152,3,2,3,CAR,47,326,379,1,-5.929520508000443,46.79549570782172,20.43298759991064,26.362508107911083
0.363636364,0.46666666700000003,31.73333333,11/28/2010,26,16,home,1,CAR,227,175,46,70,24,23,Win,152,151,2,3,1,CLE,47,379,326,3,5.929520508000443,46.79549570782172,26.362508107911083,20.43298759991064
0.6315789470000001,0.307692308,45.38333333,11/28/2010,28,19,away,3,BUF,220,255,107,83,3,0,Win,206,74,5,2,2,PIT,3,426,329,1,-10.27241400652683,41.56063616435586,15.644111078914516,25.916525085441346
0.307692308,0.6315789470000001,27.38333333,11/28/2010,19,28,home,-3,PIT,255,220,20,64,0,3,Loss,74,206,2,5,1,BUF,3,329,426,2,10.27241400652683,41.56063616435586,25.916525085441346,15.644111078914516
0.625,0.3,35.45,11/28/2010,26,17,away,-4,NYG,121,226,20,73,20,24,Loss,207,135,4,0,0,JAX,44,328,361,2,-1.645670748347806,47.67168728340363,23.013008267527912,24.658679015875716
0.3,0.625,24.55,11/28/2010,17,26,home,4,JAX,226,121,25,50,24,20,Win,135,207,0,4,2,NYG,44,361,328,0,1.645670748347806,47.67168728340363,24.658679015875716,23.013008267527912
0.473684211,0.222222222,41.63333333,11/28/2010,24,11,away,16,OAK,285,247,35,82,33,17,Win,186,16,3,1,3,MIA,50,471,263,1,-1.4231430376692042,47.091791345213124,22.83432415377196,24.257467191441165
0.222222222,0.473684211,18.36666667,11/28/2010,11,24,home,-16,MIA,247,285,20,45,17,33,Loss,16,186,1,3,1,OAK,50,263,471,3,1.4231430376692042,47.091791345213124,24.257467191441165,22.83432415377196
0.647058824,0.25,41.05,11/28/2010,28,13,away,18,SEA,233,268,50,80,42,24,Win,270,20,0,2,3,KCC,66,503,288,1,-0.5256876816643086,47.423908833616125,23.449110575975908,23.974798257640217
0.25,0.647058824,18.95,11/28/2010,13,28,home,-18,KCC,268,233,26,51,24,42,Loss,20,270,2,0,1,SEA,66,288,503,3,0.5256876816643086,47.423908833616125,23.974798257640217,23.449110575975908
0.375,0.25,28.96666667,11/28/2010,14,18,away,-7,BAL,162,257,78,60,10,17,Loss,101,92,0,4,1,TBB,27,263,349,0,-3.82504129907202,32.75026613904535,14.462612419986666,18.287653719058685
0.25,0.375,31.03333333,11/28/2010,18,14,home,7,TBB,257,162,30,65,17,10,Win,92,101,4,0,0,BAL,27,349,263,1,3.82504129907202,32.75026613904535,18.287653719058685,14.462612419986666
0.307692308,0.3,31.96666667,11/28/2010,24,18,away,-5,CHI,293,218,19,70,26,31,Loss,105,131,4,4,0,PHI,57,398,349,1,5.551680310474145,45.83780238855903,25.694741349516587,20.14306103904244
0.3,0.307692308,28.03333333,11/28/2010,18,24,home,5,PHI,218,293,56,53,31,26,Win,131,105,4,4,1,CHI,57,349,398,0,-5.551680310474145,45.83780238855903,20.14306103904244,25.694741349516587
0.375,0.111111111,34.28333333,11/28/2010,24,24,away,3,DEN,308,330,30,74,36,33,Win,123,119,2,3,2,LAR,69,431,449,0,0.8720495225923433,52.41680258700353,26.644426054797936,25.772376532205595
0.111111111,0.375,25.71666667,11/28/2010,24,24,home,-3,LAR,330,308,60,62,33,36,Loss,119,123,3,2,0,DEN,69,449,431,2,-0.8720495225923433,52.41680258700353,25.772376532205595,26.644426054797936
0.0,0.25,35.63333333,11/28/2010,18,16,away,22,IND,172,279,40,59,36,14,Win,129,24,2,1,5,LAC,50,301,303,0,6.173019803967229,36.959135710290184,21.566077757128706,15.393057953161478
0.25,0.0,24.36666667,11/28/2010,16,18,home,-22,LAC,279,172,15,62,14,36,Loss,24,129,1,2,0,IND,50,303,301,5,-6.173019803967229,36.959135710290184,15.393057953161478,21.566077757128706
0.538461538,0.181818182,39.01666667,11/29/2010,26,8,away,21,ARI,125,190,40,71,27,6,Win,261,13,1,1,2,SFO,33,386,203,1,0.6065563781863155,35.636236209932875,18.121396294059593,17.51483991587328
0.181818182,0.538461538,20.98333333,11/29/2010,8,26,home,-21,SFO,190,125,61,47,6,27,Loss,13,261,1,1,1,ARI,33,203,386,2,-0.6065563781863155,35.636236209932875,17.51483991587328,18.121396294059593
0.6,0.5,28.18333333,12/2/2010,27,22,away,-10,PHI,323,301,25,64,24,34,Loss,108,115,2,1,1,HOU,58,431,416,2,0.6060770644667082,61.028814813898805,30.817445939182758,30.211368874716047
0.5,0.6,31.81666667,12/2/2010,22,27,home,10,HOU,301,323,85,63,34,24,Win,115,108,1,2,2,PHI,58,416,431,1,-0.6060770644667082,61.028814813898805,30.211368874716047,30.817445939182758
0.4,0.181818182,39.9,12/5/2010,23,11,away,11,TEN,119,163,31,73,17,6,Win,258,57,1,1,2,JAX,23,377,220,0,-4.87641719901676,36.967588485884946,16.045585643434094,20.92200284245085
0.181818182,0.4,20.1,12/5/2010,11,23,home,-11,JAX,163,119,30,47,6,17,Loss,57,258,1,1,0,TEN,23,220,377,2,4.87641719901676,36.967588485884946,20.92200284245085,16.045585643434094
0.5555555560000001,0.428571429,33.31666667,12/5/2010,23,14,away,4,DET,197,168,25,58,24,20,Win,114,134,4,2,0,CHI,44,311,302,1,3.6562264196204066,42.205980909,22.931103664310204,19.274877244689794
0.428571429,0.5555555560000001,26.68333333,12/5/2010,14,23,home,-4,CHI,168,197,42,53,20,24,Loss,134,114,2,4,1,DET,44,302,311,0,-3.6562264196204066,42.205980909,19.274877244689794,22.931103664310204
0.25,0.333333333,26.05,12/5/2010,10,22,away,-24,MIN,155,177,54,49,14,38,Loss,84,210,1,1,4,BUF,52,239,387,5,7.694428376388309,45.99111925518959,26.84277381578895,19.14834543940064
0.333333333,0.25,33.95,12/5/2010,22,10,home,24,BUF,177,155,20,64,38,14,Win,210,84,1,1,5,MIN,52,387,239,4,-7.694428376388309,45.99111925518959,19.14834543940064,26.84277381578895
0.25,0.428571429,22.76666667,12/5/2010,13,21,away,-4,KCC,86,174,35,55,6,10,Loss,161,185,4,2,1,DEN,16,247,359,1,-2.5639511571356532,35.19293697343587,16.314492908150108,18.878444065285763
0.428571429,0.25,37.23333333,12/5/2010,21,13,home,4,DEN,174,86,60,72,10,6,Win,185,161,2,4,1,KCC,16,359,247,1,2.5639511571356532,35.19293697343587,18.878444065285763,16.314492908150108
0.25,0.6,22.81666667,12/5/2010,11,21,away,-18,GBP,172,274,32,51,16,34,Loss,97,136,4,4,0,SFO,50,269,410,1,2.162541248250827,40.50902914924212,21.33578519874647,19.173243950495646
0.6,0.25,37.18333333,12/5/2010,21,11,home,18,SFO,274,172,40,68,34,16,Win,136,97,4,4,1,GBP,50,410,269,0,-2.162541248250827,40.50902914924212,19.173243950495646,21.33578519874647
0.125,0.35714285700000004,27.45,12/5/2010,19,21,away,4,CIN,290,215,100,53,34,30,Win,146,96,2,3,0,NOS,64,436,311,1,10.518153362739167,43.7511428922497,27.134648127494437,16.616494764755267
0.35714285700000004,0.125,32.55,12/5/2010,21,19,home,-4,NOS,215,290,43,62,30,34,Loss,96,146,3,2,1,CIN,64,311,436,0,-10.518153362739167,43.7511428922497,16.616494764755267,27.134648127494437
0.14285714300000002,0.28571428600000004,29.4,12/5/2010,12,17,away,3,MIA,200,167,45,58,13,10,Win,52,114,2,1,3,CLE,23,252,281,0,-1.20313566093887,27.996495593720876,13.396679966391003,14.599815627329873
0.28571428600000004,0.14285714300000002,30.6,12/5/2010,17,12,home,-3,CLE,167,200,37,65,10,13,Loss,114,52,1,2,0,MIA,23,281,252,3,1.20313566093887,27.996495593720876,14.599815627329873,13.396679966391003
0.41666666700000005,0.2,25.53333333,12/5/2010,19,22,away,-24,NYG,264,161,35,64,7,31,Loss,74,197,4,0,1,WAS,38,338,358,6,-0.8387500483562036,48.166785166743814,23.664017559193805,24.50276760755001
0.2,0.41666666700000005,34.46666667,12/5/2010,22,19,home,24,WAS,161,264,35,61,31,7,Win,197,74,0,4,6,NYG,38,358,338,1,0.8387500483562036,48.166785166743814,24.50276760755001,23.664017559193805
0.533333333,0.3,38.65,12/5/2010,22,18,away,15,LAC,117,265,105,69,28,13,Win,251,21,1,4,2,OAK,41,368,286,1,-2.3075612652609383,47.221973199674224,22.457205967206644,24.76476723246758
0.3,0.533333333,21.35,12/5/2010,18,22,home,-15,OAK,265,117,19,51,13,28,Loss,21,251,4,1,1,LAC,41,286,368,2,2.3075612652609383,47.221973199674224,24.76476723246758,22.457205967206644
0.545454545,0.333333333,28.0,12/5/2010,20,19,away,4,TBB,205,174,55,63,28,24,Win,85,151,0,1,1,ATL,52,290,325,2,-13.48447004891825,39.100744498945446,12.808137225013596,26.29260727393185
0.333333333,0.545454545,32.0,12/5/2010,19,20,home,-4,ATL,174,205,102,69,24,28,Loss,151,85,1,0,2,TBB,52,325,290,1,13.48447004891825,39.100744498945446,26.29260727393185,12.808137225013597
0.533333333,0.545454545,40.0,12/5/2010,24,24,away,3,IND,151,365,35,74,3,0,Win,217,40,2,0,4,DAL,3,368,405,0,-5.2005524906428615,48.1778474087018,21.48864745902947,26.689199949672332
0.545454545,0.533333333,27.08333333,12/5/2010,24,24,home,-3,DAL,365,151,28,65,0,3,Loss,40,217,0,2,0,IND,3,405,368,4,5.2005524906428615,48.1778474087018,26.689199949672332,21.48864745902947
0.352941176,0.090909091,33.76666667,12/5/2010,18,14,away,13,ARI,169,119,15,67,19,6,Win,119,105,2,4,2,LAR,25,288,224,1,0.9853481431340168,30.13100880180587,15.558178472469944,14.572830329335925
0.090909091,0.352941176,26.23333333,12/5/2010,14,18,home,-13,LAR,119,169,54,52,6,19,Loss,105,119,4,2,1,ARI,25,224,288,2,-0.9853481431340168,30.13100880180587,14.572830329335925,15.558178472469944
0.333333333,0.5,30.5,12/5/2010,18,25,away,-17,SEA,152,210,53,67,14,31,Loss,131,161,3,3,2,CAR,45,283,371,1,-3.469283653128338,43.85038091442171,20.19054863064669,23.659832283775025
0.5,0.333333333,29.5,12/5/2010,25,18,home,17,CAR,210,152,20,64,31,14,Win,161,131,3,3,1,SEA,45,371,283,2,3.469283653128338,43.85038091442171,23.659832283775025,20.19054863064669
0.28571428600000004,0.307692308,34.13333333,12/5/2010,17,14,away,3,BAL,234,226,61,65,13,10,Win,54,43,3,4,1,PIT,23,288,269,1,3.6753445429915708,31.939566980436453,17.80745576171401,14.132111218722441
0.307692308,0.28571428600000004,25.86666667,12/5/2010,14,17,home,-3,PIT,226,234,53,57,10,13,Loss,43,54,4,3,1,BAL,23,269,288,1,-3.6753445429915708,31.939566980436453,14.132111218722443,17.80745576171401
0.25,0.4,28.98333333,12/6/2010,18,23,away,-42,NEP,149,304,56,65,3,45,Loss,152,101,1,3,0,NYJ,48,301,405,3,11.900006800029942,44.356477390451225,28.128242095240584,16.22823529521064
0.4,0.25,31.01666667,12/6/2010,23,18,home,42,NYJ,304,149,10,58,45,3,Win,101,152,3,1,3,NEP,48,405,301,0,-11.900006800029942,44.356477390451225,16.22823529521064,28.128242095240584
0.533333333,0.454545455,32.51666667,12/9/2010,21,22,away,2,TEN,312,244,60,68,30,28,Win,87,121,1,0,2,IND,58,399,365,0,-6.765043775761926,50.61901385104212,21.926985037640097,28.692028813402022
0.454545455,0.533333333,27.48333333,12/9/2010,22,21,home,-2,IND,244,312,29,64,28,30,Loss,121,87,0,1,0,TEN,58,365,399,2,6.765043775761926,50.61901385104212,28.692028813402022,21.926985037640097
0.41666666700000005,0.375,28.86666667,12/12/2010,15,22,away,1,WAS,262,211,14,52,17,16,Win,103,188,1,2,1,TBB,33,365,399,2,-2.2600564053875765,45.09161852915266,21.41578106188254,23.67583746727012
0.375,0.41666666700000005,31.13333333,12/12/2010,22,15,home,-1,TBB,211,262,25,65,16,17,Loss,188,103,2,1,2,WAS,33,399,365,1,2.2600564053875765,45.09161852915266,23.67583746727012,21.41578106188254
0.529411765,0.23076923100000002,34.83333333,12/12/2010,24,13,away,21,CAR,200,76,10,73,31,10,Win,127,212,3,5,2,ATL,41,327,288,1,-7.395685829026956,37.705156937489114,15.154735554231081,22.550421383258033
0.23076923100000002,0.529411765,25.16666667,12/12/2010,13,24,home,-21,ATL,76,200,50,58,10,31,Loss,212,127,5,3,1,CAR,41,288,327,2,7.395685829026956,37.705156937489114,22.550421383258033,15.15473555423108
0.25,0.46666666700000003,25.48333333,12/12/2010,14,18,away,-16,PIT,156,231,25,49,7,23,Loss,34,123,3,4,0,CIN,30,190,354,3,6.7110728013739465,36.03835550866777,21.374714155020857,14.663641353646913
0.46666666700000003,0.25,34.51666667,12/12/2010,18,14,home,16,CIN,231,156,89,64,23,7,Win,123,34,4,3,3,PIT,30,354,190,0,-6.7110728013739465,36.03835550866777,14.663641353646913,21.374714155020857
0.46153846200000004,0.41666666700000005,30.08333333,12/12/2010,21,19,away,-7,JAX,323,151,25,61,31,38,Loss,153,234,3,2,1,OAK,69,476,385,2,-0.7706719309316945,57.0220370644429,28.1256825667556,28.896354497687298
0.41666666700000005,0.46153846200000004,29.91666667,12/12/2010,19,21,home,7,OAK,151,323,52,58,38,31,Win,234,153,2,3,2,JAX,69,385,476,1,0.7706719309316945,57.0220370644429,28.896354497687298,28.1256825667556
0.166666667,0.2,29.2,12/12/2010,13,15,away,-4,DET,192,96,20,61,3,7,Loss,66,190,4,2,2,GBP,10,258,286,3,0.6810920483457217,33.68481770335306,17.18295487584939,16.501862827503672
0.2,0.166666667,30.8,12/12/2010,15,13,home,4,GBP,96,192,35,65,7,3,Win,190,66,2,4,3,DET,10,286,258,2,-0.6810920483457217,33.68481770335306,16.501862827503672,17.18295487584939
0.2,0.35714285700000004,23.83333333,12/12/2010,9,19,away,-7,BUF,82,131,10,46,6,13,Loss,105,192,1,2,1,CLE,19,187,323,3,3.380235586684332,31.001517152543315,17.190876369613825,13.810640782929491
0.35714285700000004,0.2,36.16666667,12/12/2010,19,9,home,7,CLE,131,82,44,67,13,6,Win,192,105,2,1,3,BUF,19,323,187,1,-3.380235586684332,31.001517152543315,13.81064078292949,17.190876369613825
0.4,0.41176470600000004,29.11666667,12/12/2010,20,10,away,-19,SFO,277,241,75,65,21,40,Loss,84,95,1,2,0,SEA,61,361,336,5,1.3360290573615146,42.07602999757146,21.706029527466487,20.370000470104973
0.41176470600000004,0.4,30.88333333,12/12/2010,10,20,home,19,SEA,241,277,15,56,40,21,Win,95,84,2,1,5,SFO,61,336,361,0,-1.3360290573615146,42.07602999757146,20.370000470104973,21.706029527466487
0.090909091,0.6875,26.98333333,12/12/2010,14,22,away,-18,NOS,191,213,39,59,13,31,Loss,136,132,3,1,3,LAR,44,327,345,3,-3.6883609860668933,44.92260153932333,20.61712027662822,24.30548126269511
0.6875,0.090909091,33.01666667,12/12/2010,22,14,home,18,LAR,213,191,55,70,31,13,Win,132,136,1,3,3,NOS,44,345,327,3,3.6883609860668933,44.92260153932333,24.30548126269511,20.61712027662822
0.6315789470000001,0.375,39.68333333,12/12/2010,27,12,away,29,CHI,351,138,43,78,36,7,Win,124,47,3,2,4,NEP,43,475,185,0,9.000712123657536,45.98719262994509,27.493952376801314,18.493240253143778
0.375,0.6315789470000001,20.31666667,12/12/2010,12,27,home,-29,NEP,138,351,30,42,7,36,Loss,47,124,2,3,0,CHI,43,185,475,4,-9.000712123657536,45.98719262994509,18.493240253143778,27.493952376801314
0.0,0.7333333329999999,19.83333333,12/12/2010,5,25,away,-31,LAC,19,219,15,41,0,31,Loss,48,207,4,2,2,KCC,31,67,426,0,3.5121407156791875,30.166078496075325,16.839109605877255,13.326968890198069
0.7333333329999999,0.0,40.16666667,12/12/2010,25,5,home,31,KCC,219,19,47,69,31,0,Win,207,48,2,4,0,LAC,31,426,67,2,-3.5121407156791875,30.166078496075325,13.32696889019807,16.839109605877255
0.2,0.28571428600000004,26.2,12/12/2010,6,14,away,4,NYJ,30,193,36,56,10,6,Win,101,87,5,6,2,MIA,16,131,280,3,-12.782030864374025,21.60448203626121,4.4112255859435905,17.19325645031762
0.28571428600000004,0.2,33.8,12/12/2010,14,6,home,-4,MIA,193,30,50,81,6,10,Loss,87,101,6,5,3,NYJ,16,280,131,2,12.782030864374025,21.60448203626121,17.19325645031762,4.411225585943592
0.2,0.25,29.65,12/12/2010,20,21,away,-30,ARI,156,146,66,73,13,43,Loss,132,211,1,0,1,DEN,56,288,357,6,-7.831008191219215,40.71679393510729,16.44289287194404,24.27390106316325
0.25,0.2,30.35,12/12/2010,21,20,home,30,DEN,146,156,62,72,43,13,Win,211,132,0,1,6,ARI,56,357,288,1,7.831008191219215,40.71679393510729,24.27390106316325,16.44289287194404
0.363636364,0.272727273,27.85,12/12/2010,18,22,away,3,DAL,258,239,59,55,30,27,Win,171,110,2,1,2,PHI,57,429,349,2,8.897434221068163,50.04806668620218,29.47275045363517,20.575316232567012
0.272727273,0.363636364,32.15,12/12/2010,22,18,home,-3,PHI,239,258,40,60,27,30,Loss,110,171,1,2,2,DAL,57,349,429,2,-8.897434221068163,50.04806668620218,20.575316232567012,29.47275045363517
0.23076923100000002,0.125,32.7,12/13/2010,21,10,away,18,MIN,182,103,55,66,21,3,Win,213,61,1,4,1,NYG,24,395,164,2,-6.365358660389601,32.78872329830347,13.211682318956935,19.57704097934654
0.125,0.23076923100000002,27.3,12/13/2010,10,21,home,-18,NYG,103,182,71,61,3,21,Loss,61,213,4,1,2,MIN,24,164,395,1,6.365358660389601,32.78872329830347,19.57704097934654,13.211682318956935
0.533333333,0.38888888899999996,31.3,12/13/2010,19,28,away,6,HOU,190,378,15,62,6,0,Win,63,111,5,2,2,BAL,6,253,489,0,-7.47081196534128,44.08004768857913,18.304617861618922,25.775429826960206
0.38888888899999996,0.533333333,31.78333333,12/13/2010,28,19,home,-6,BAL,378,190,51,86,0,6,Loss,111,63,2,5,0,HOU,6,489,253,2,7.47081196534128,44.08004768857913,25.775429826960206,18.304617861618922
0.166666667,0.5,22.81666667,12/16/2010,11,24,away,-27,LAC,131,266,60,50,7,34,Loss,61,108,6,1,0,SFO,41,192,374,1,1.8312918319125089,33.92039658205918,17.875844206985846,16.044552375073337
0.5,0.166666667,37.18333333,12/16/2010,24,11,home,27,SFO,266,131,35,67,34,7,Win,108,61,1,6,1,LAC,41,374,192,0,-1.8312918319125089,33.92039658205918,16.044552375073337,17.875844206985846
0.384615385,0.384615385,30.36666667,12/19/2010,20,19,away,-10,IND,289,221,55,61,24,34,Loss,67,155,1,1,0,JAX,58,356,376,2,-4.1715819339513995,47.42391773558883,21.626167900818714,25.797749834770116
0.384615385,0.384615385,29.63333333,12/19/2010,19,20,home,10,JAX,221,289,68,64,34,24,Win,155,67,1,1,2,IND,58,376,356,0,4.1715819339513995,47.42391773558883,25.797749834770116,21.626167900818714
0.294117647,0.352941176,31.73333333,12/19/2010,21,14,away,14,LAR,173,155,40,74,27,13,Win,210,69,3,3,2,KCC,40,383,224,1,-14.307114349476805,34.012685619637736,9.852785635080465,24.15989998455727
0.352941176,0.294117647,28.26666667,12/19/2010,14,21,home,-14,KCC,155,173,60,67,13,27,Loss,69,210,3,3,1,LAR,40,224,383,2,14.307114349476805,34.012685619637736,24.15989998455727,9.852785635080465
0.363636364,0.384615385,24.65,12/19/2010,23,25,away,-3,DAL,286,300,25,63,30,33,Loss,55,134,5,2,0,WAS,63,341,434,3,-4.4792457717532805,47.526766100725325,21.52376016448602,26.003005936239305
0.384615385,0.363636364,35.35,12/19/2010,25,23,home,3,WAS,300,286,70,70,33,30,Win,134,55,2,5,3,DAL,63,434,341,0,4.4792457717532805,47.526766100725325,26.003005936239305,21.52376016448602
0.333333333,0.333333333,28.61666667,12/19/2010,15,22,away,3,MIA,211,261,44,55,17,14,Win,71,65,2,3,2,BUF,31,282,326,1,3.4772132364552304,40.217633835597795,21.84742353602651,18.370210299571283
0.333333333,0.333333333,31.38333333,12/19/2010,22,15,home,-3,BUF,261,211,35,67,14,17,Loss,65,71,3,2,1,MIA,31,326,282,2,-3.4772132364552304,40.217633835597795,18.370210299571283,21.84742353602651
0.25,0.46153846200000004,21.95,12/19/2010,14,22,away,-2,CIN,219,209,25,43,17,19,Loss,59,188,4,0,0,CLE,36,278,397,0,8.526340145554522,37.9559452160532,23.24114268080386,14.71480253524934
0.46153846200000004,0.25,38.05,12/19/2010,22,14,home,2,CLE,209,219,55,68,19,17,Win,188,59,0,4,0,CIN,36,397,278,0,-8.526340145554522,37.9559452160532,14.71480253524934,23.24114268080386
0.5,0.41666666700000005,33.08333333,12/19/2010,26,22,away,3,TBB,252,227,57,66,3,0,Win,181,176,0,3,0,DET,3,433,403,0,-6.566172624115085,48.21789149733578,20.825859436610347,27.39203206072543
0.41666666700000005,0.5,32.06666667,12/19/2010,22,26,home,-3,DET,227,252,65,64,0,3,Loss,176,181,3,0,0,TBB,3,403,433,0,6.566172624115085,48.21789149733578,27.39203206072543,20.825859436610347
0.384615385,0.272727273,32.48333333,12/19/2010,26,19,away,-14,TEN,293,212,66,75,17,31,Loss,30,147,4,3,1,HOU,48,323,359,1,-8.274240048033034,45.397651932718624,18.561705942342794,26.83594599037583
0.272727273,0.384615385,27.51666667,12/19/2010,19,26,home,14,HOU,212,293,76,57,31,17,Win,147,30,3,4,1,TEN,48,359,323,1,8.274240048033034,45.397651932718624,26.83594599037583,18.561705942342794
0.363636364,0.470588235,26.51666667,12/19/2010,19,20,away,7,NYG,221,264,30,59,38,31,Win,197,100,3,2,2,PHI,69,418,364,3,-0.42088316659197167,52.57762384649775,26.07837033995289,26.49925350654486
0.470588235,0.363636364,33.48333333,12/19/2010,20,19,home,-7,PHI,264,221,35,72,31,38,Loss,100,197,2,3,3,NYG,69,364,418,2,0.42088316659197167,52.57762384649775,26.49925350654486,26.07837033995289
0.384615385,0.35714285700000004,28.51666667,12/19/2010,21,17,away,-6,BAL,242,148,68,63,24,30,Loss,27,208,3,3,0,NOS,54,269,356,1,2.933383506137595,37.20492964573855,20.069156575938074,17.13577306980048
0.35714285700000004,0.384615385,31.48333333,12/19/2010,17,21,home,6,NOS,148,242,68,62,30,24,Win,208,27,3,3,1,BAL,54,356,269,0,-2.933383506137595,37.20492964573855,17.13577306980048,20.069156575938074
0.26666666699999997,0.26666666699999997,23.06666667,12/19/2010,11,16,away,-7,CAR,175,126,39,53,12,19,Loss,43,177,3,2,1,ARI,31,218,303,2,-5.16298134568358,31.276146896518554,13.056582775417489,18.219564121101065
0.26666666699999997,0.26666666699999997,36.93333333,12/19/2010,16,11,home,7,ARI,126,175,58,66,19,12,Win,177,43,2,3,2,CAR,31,303,218,1,5.16298134568358,31.276146896518554,18.219564121101065,13.056582775417487
0.473684211,0.333333333,35.41666667,12/19/2010,21,15,away,16,SEA,168,143,35,73,34,18,Win,98,91,1,2,3,ATL,52,266,234,1,-3.7810103030779905,32.96873351421617,14.593861605569089,18.37487190864708
0.333333333,0.473684211,24.58333333,12/19/2010,15,21,home,-16,ATL,143,168,76,56,18,34,Loss,91,98,2,1,1,SEA,52,234,266,3,3.7810103030779905,32.96873351421617,18.37487190864708,14.593861605569089
0.166666667,0.181818182,26.05,12/19/2010,9,20,away,-16,OAK,129,238,93,51,23,39,Loss,106,264,2,0,3,DEN,62,235,502,1,-2.1903189654243924,45.37141808693419,21.5905495607549,23.78086852617929
0.181818182,0.166666667,33.95,12/19/2010,20,9,home,16,DEN,238,129,84,67,39,23,Win,264,106,0,2,1,OAK,62,502,235,3,2.1903189654243924,45.37141808693419,23.78086852617929,21.5905495607549
0.46153846200000004,0.647058824,28.7,12/19/2010,17,25,away,5,PIT,170,232,19,57,22,17,Win,106,146,1,3,0,NYJ,39,276,378,0,-3.891564101383377,42.52421525033065,19.316325574473638,23.20788967585701
0.647058824,0.46153846200000004,31.3,12/19/2010,25,17,home,-5,NYJ,232,170,35,72,17,22,Loss,146,106,3,1,0,PIT,39,378,276,0,3.891564101383377,42.52421525033065,23.20788967585701,19.316325574473638
0.578947368,0.4,40.8,12/19/2010,26,14,away,-4,NEP,226,136,15,80,27,31,Loss,143,113,5,3,0,GBP,58,369,249,2,10.610133988634804,42.63294120607935,26.621537597357076,16.011403608722276
0.4,0.578947368,19.2,12/19/2010,14,26,home,4,GBP,136,226,52,43,31,27,Win,113,143,3,5,2,NEP,58,249,369,0,-10.610133988634804,42.63294120607935,16.011403608722276,26.621537597357076
0.2,0.272727273,31.5,12/20/2010,17,16,away,26,MIN,189,159,72,58,40,14,Win,104,114,1,4,5,CHI,54,293,273,1,0.022729469736976426,38.2915361737061,19.15713282172154,19.13440335198456
0.272727273,0.2,28.5,12/20/2010,16,17,home,-26,CHI,159,189,55,61,14,40,Loss,114,104,4,1,1,MIN,54,273,293,5,-0.022729469736976426,38.2915361737061,19.13440335198456,19.15713282172154
0.23076923100000002,0.333333333,24.6,12/23/2010,7,22,away,-24,PIT,45,293,62,49,3,27,Loss,74,115,4,3,2,CAR,30,119,408,2,-1.9596518069884539,35.23557753087236,16.637962861941954,18.597614668930408
0.333333333,0.23076923100000002,35.4,12/23/2010,22,7,home,24,CAR,293,45,40,68,27,3,Win,115,74,3,4,2,PIT,30,408,119,2,1.9596518069884539,35.23557753087236,18.597614668930408,16.637962861941954
0.444444444,0.181818182,38.08333333,12/25/2010,24,10,away,-1,ARI,199,178,49,76,26,27,Loss,183,93,5,1,0,DAL,53,382,271,3,-1.213120735969368,35.60549272960911,17.19618599681987,18.40930673278924
0.181818182,0.444444444,21.91666667,12/25/2010,10,24,home,1,DAL,178,199,43,47,27,26,Win,93,183,1,5,3,ARI,53,271,382,0,1.213120735969368,35.60549272960911,18.40930673278924,17.19618599681987
0.25,0.28571428600000004,26.86666667,12/26/2010,12,19,away,-8,LAR,246,275,87,59,17,25,Loss,85,60,4,1,1,SFO,42,331,335,2,-5.406377016383103,38.330262076246115,16.461942529931505,21.86831954631461
0.28571428600000004,0.25,33.13333333,12/26/2010,19,12,home,8,SFO,275,246,41,66,25,17,Win,60,85,1,4,2,LAR,42,335,331,1,5.406377016383103,38.330262076246115,21.86831954631461,16.461942529931505
0.470588235,0.3,32.5,12/26/2010,20,16,away,31,BUF,131,244,40,69,34,3,Win,217,125,1,3,7,NEP,37,348,369,0,6.17889936107299,46.83557537169389,26.507237366383443,20.32833800531045
0.3,0.470588235,27.5,12/26/2010,16,20,home,-31,NEP,244,131,40,60,3,34,Loss,125,217,3,1,0,BUF,37,369,348,7,-6.17889936107299,46.83557537169389,20.32833800531045,26.507237366383443
0.538461538,0.636363636,31.76666667,12/26/2010,15,17,away,10,CLE,97,178,5,58,20,10,Win,161,102,1,0,4,BAL,30,258,280,1,6.105781122433369,37.979918436757295,22.042849779595333,15.937068657161962
0.636363636,0.538461538,28.23333333,12/26/2010,17,15,home,-10,BAL,178,97,20,56,10,20,Loss,102,161,0,1,1,CLE,30,280,258,4,-6.105781122433369,37.979918436757295,15.937068657161962,22.042849779595333
0.5,0.333333333,33.85,12/26/2010,24,16,away,-4,CHI,269,202,34,68,34,38,Loss,124,120,0,2,1,NYJ,72,393,322,2,0.015247891899008437,47.14442529896867,23.57983659543384,23.56458870353483
0.333333333,0.5,26.15,12/26/2010,16,24,home,4,NYJ,202,269,31,54,38,34,Win,120,124,2,0,2,CHI,72,322,393,1,-0.015247891899008437,47.14442529896867,23.56458870353483,23.57983659543384
0.26666666699999997,0.41176470600000004,29.88333333,12/26/2010,15,15,away,3,JAX,172,258,40,64,3,0,Win,79,78,1,4,2,WAS,3,251,336,1,-13.848833867040586,33.752296401983685,9.951731267471551,23.800565134512134
0.41176470600000004,0.26666666699999997,32.9,12/26/2010,15,15,home,-3,WAS,258,172,66,65,0,3,Loss,78,79,4,1,1,JAX,3,336,251,2,13.848833867040586,33.752296401983685,23.800565134512134,9.95173126747155
0.25,0.5,20.93333333,12/26/2010,16,23,away,-20,KCC,213,306,74,56,14,34,Loss,57,152,3,1,2,TEN,48,270,458,2,-9.855917916872311,45.67771332615674,17.910897704642217,27.766815621514525
0.5,0.25,39.06666667,12/26/2010,23,16,home,20,TEN,306,213,84,77,34,14,Win,152,57,1,3,2,KCC,48,458,270,2,9.855917916872311,45.67771332615674,27.766815621514525,17.910897704642217
0.333333333,0.470588235,22.75,12/26/2010,14,28,away,7,MIA,208,271,53,49,34,27,Win,67,154,2,2,3,DET,61,275,425,0,-3.3347014680148077,45.466903336553116,21.066100934269155,24.40080240228396
0.470588235,0.333333333,37.25,12/26/2010,28,14,home,-7,DET,271,208,63,83,27,34,Loss,154,67,2,2,0,MIA,61,425,275,3,3.3347014680148077,45.466903336553116,24.40080240228396,21.066100934269155
0.363636364,0.26666666699999997,29.98333333,12/26/2010,27,16,away,5,OAK,179,210,42,69,31,26,Win,191,80,0,3,0,IND,57,370,290,2,-8.565662115452978,45.74332557714534,18.58883173084618,27.15449384629916
0.26666666699999997,0.363636364,30.01666667,12/26/2010,16,27,home,-5,IND,210,179,116,65,26,31,Loss,80,191,3,0,2,OAK,57,290,370,0,8.565662115452978,45.74332557714534,27.15449384629916,18.58883173084618
0.125,0.454545455,28.16666667,12/26/2010,21,25,away,-1,DEN,310,305,24,55,23,24,Loss,91,126,0,1,1,HOU,47,401,431,1,10.084887246767646,53.72509890494167,31.904993075854655,21.820105829087012
0.454545455,0.125,31.83333333,12/26/2010,25,21,home,1,HOU,305,310,27,63,24,23,Win,126,91,1,0,1,DEN,47,431,401,1,-10.084887246767646,53.72509890494167,21.820105829087012,31.904993075854655
0.46153846200000004,0.571428571,29.85,12/26/2010,23,18,away,-14,CIN,249,269,5,63,20,34,Loss,64,102,1,0,1,LAC,54,313,371,2,3.1983490378904946,46.98426683316371,25.0913079355271,21.892958897636607
0.571428571,0.46153846200000004,30.15,12/26/2010,18,23,home,14,LAC,269,249,57,59,34,20,Win,102,64,0,1,2,CIN,54,371,313,1,-3.1983490378904946,46.98426683316371,21.892958897636607,25.0913079355271
0.333333333,0.545454545,28.53333333,12/26/2010,10,22,away,-23,TBB,84,231,10,53,15,38,Loss,90,208,3,2,0,SEA,53,174,439,0,4.083926129495342,34.76860823248144,19.42626718098839,15.34234105149305
0.545454545,0.333333333,31.46666667,12/26/2010,22,10,home,23,SEA,231,84,22,56,38,15,Win,208,90,2,3,0,TBB,53,439,174,0,-4.083926129495342,34.76860823248144,15.342341051493051,19.42626718098839
0.333333333,0.46153846200000004,22.98333333,12/26/2010,16,27,away,-28,GBP,296,396,45,55,17,45,Loss,90,119,1,2,1,NYG,62,386,515,6,3.908925137797908,62.349219387031,33.129072262414454,29.220147124616545
0.46153846200000004,0.333333333,37.01666667,12/26/2010,27,16,home,28,NYG,396,296,31,74,45,17,Win,119,90,2,1,6,GBP,62,515,386,1,-3.908925137797908,62.349219387031,29.220147124616545,33.129072262414454
0.470588235,0.25,36.58333333,12/27/2010,23,14,away,3,ATL,296,140,92,74,17,14,Win,72,75,1,1,2,NOS,31,368,215,2,0.022650526412302696,38.16539415926391,19.09402234283811,19.071371816425803
0.25,0.470588235,23.41666667,12/27/2010,14,23,home,-3,NOS,140,296,10,52,14,17,Loss,75,72,1,1,2,ATL,31,215,368,2,-0.022650526412302696,38.16539415926391,19.071371816425803,19.09402234283811
0.46153846200000004,0.363636364,30.35,12/28/2010,21,24,away,10,PHI,176,224,74,59,24,14,Win,161,107,2,6,3,MIN,38,337,331,1,0.7682263729683481,48.54983851748926,24.659032445228807,23.890806072260457
0.363636364,0.46153846200000004,29.65,12/28/2010,24,21,home,-10,MIN,224,176,62,71,14,24,Loss,107,161,6,2,1,PHI,38,331,337,3,-0.7682263729683481,48.54983851748926,23.890806072260457,24.659032445228807
0.23076923100000002,0.363636364,24.5,1/2/2011,12,24,away,-21,ATL,154,253,97,56,10,31,Loss,137,99,3,1,1,CAR,41,291,352,2,-6.817269533156059,39.52557800171941,16.354154234281676,23.171423767437734
0.363636364,0.23076923100000002,35.5,1/2/2011,24,12,home,21,CAR,253,154,20,71,31,10,Win,99,137,1,3,2,ATL,41,352,291,1,6.817269533156059,39.52557800171941,23.171423767437734,16.354154234281676
0.3,0.5,29.05,1/2/2011,18,20,away,10,NOS,233,199,54,54,23,13,Win,84,106,3,3,3,TBB,36,317,305,2,1.306227369427983,43.45705371333167,22.381640541379824,21.075413171951844
0.5,0.3,30.95,1/2/2011,20,18,home,-10,TBB,199,233,45,66,13,23,Loss,106,84,3,3,2,NOS,36,305,317,3,-1.306227369427983,43.45705371333167,21.075413171951844,22.381640541379824
0.428571429,0.6,29.13333333,1/2/2011,16,22,away,-7,DET,137,250,25,59,13,20,Loss,74,107,3,1,2,MIN,33,211,357,1,-2.427980177918533,41.83547942830651,19.70374962519399,22.131729803112524
0.6,0.428571429,30.86666667,1/2/2011,22,16,home,7,MIN,250,137,33,67,20,13,Win,107,74,1,3,1,DET,33,357,211,2,2.427980177918533,41.83547942830651,22.131729803112524,19.70374962519399
0.333333333,0.5,24.41666667,1/2/2011,6,17,away,-31,NYJ,125,112,15,47,7,38,Loss,37,276,3,1,1,BUF,45,162,388,6,1.420238043141083,39.00614111357461,20.213189578357845,18.792951535216762
0.5,0.333333333,35.58333333,1/2/2011,17,6,home,31,BUF,112,125,25,66,38,7,Win,276,37,1,3,6,NYJ,45,388,162,1,-1.420238043141083,39.00614111357461,18.792951535216762,20.213189578357845
0.307692308,0.647058824,23.68333333,1/2/2011,16,24,away,-31,NEP,206,321,40,58,7,38,Loss,44,181,5,0,1,MIA,45,250,502,2,3.383984606412202,46.09486749736999,24.739426051891094,21.355441445478895
0.647058824,0.307692308,36.31666667,1/2/2011,24,16,home,31,MIA,321,206,72,74,38,7,Win,181,44,0,5,2,NEP,45,502,250,1,-3.383984606412202,46.09486749736999,21.355441445478895,24.739426051891094
0.615384615,0.352941176,33.23333333,1/2/2011,24,17,away,32,CLE,318,182,25,62,41,9,Win,100,43,2,4,3,PIT,50,418,225,0,0.8481267836060624,42.09436065295174,21.471243718278902,20.62311693467284
0.352941176,0.615384615,26.76666667,1/2/2011,17,24,home,-32,PIT,182,318,46,64,9,41,Loss,43,100,4,2,0,CLE,50,225,418,3,-0.8481267836060624,42.09436065295174,20.62311693467284,21.471243718278902
0.46153846200000004,0.38888888899999996,33.46666667,1/2/2011,21,17,away,21,KCC,135,86,77,67,31,10,Win,209,115,4,7,2,OAK,41,344,201,1,-13.273772429957084,37.23800875248727,11.982118161265092,25.255890591222176
0.38888888899999996,0.46153846200000004,26.53333333,1/2/2011,17,21,home,-21,OAK,86,135,39,72,10,31,Loss,115,209,7,4,1,KCC,41,201,344,2,13.273772429957084,37.23800875248727,25.255890591222176,11.982118161265092
0.41176470600000004,0.181818182,34.7,1/2/2011,20,10,away,-6,BAL,305,101,49,76,7,13,Loss,90,98,0,4,2,CIN,20,395,199,5,5.07490300103748,37.57875295814269,21.326827979590085,16.2519249785526
0.181818182,0.41176470600000004,25.3,1/2/2011,10,20,home,6,CIN,101,305,45,50,13,7,Win,98,90,4,0,5,BAL,20,199,395,2,-5.07490300103748,37.57875295814269,16.2519249785526,21.326827979590085
0.3125,0.25,32.33333333,1/2/2011,14,20,away,3,WAS,243,318,24,61,17,14,Win,82,67,0,2,4,NYG,31,325,385,1,-4.615052042455324,43.80560620675212,19.595277082148396,24.21032912460372
0.25,0.3125,27.66666667,1/2/2011,20,14,home,-3,NYG,318,243,25,66,14,17,Loss,67,82,2,0,1,WAS,31,385,325,4,4.615052042455324,43.80560620675212,24.21032912460372,19.595277082148396
0.3125,0.25,29.16666667,1/2/2011,14,14,away,1,PHI,113,123,45,63,14,13,Win,159,121,2,5,4,DAL,27,272,244,1,-6.714109718318138,30.97132876168869,12.128609521685277,18.84271924000341
0.25,0.3125,30.83333333,1/2/2011,14,14,home,-1,DAL,123,113,40,69,13,14,Loss,121,159,5,2,1,PHI,27,244,272,4,6.714109718318138,30.97132876168869,18.84271924000341,12.128609521685275
0.1,0.454545455,30.8,1/2/2011,23,22,away,-17,HOU,124,253,15,62,17,34,Loss,198,244,2,0,0,JAX,51,322,497,2,0.690607213921048,49.854693765836714,25.27265048987888,24.582043275957833
0.454545455,0.1,29.2,1/2/2011,22,23,home,17,JAX,253,124,48,59,34,17,Win,244,198,0,2,2,HOU,51,497,322,0,-0.690607213921048,49.854693765836714,24.582043275957833,25.27265048987888
0.3125,0.181818182,30.66666667,1/2/2011,13,14,away,-7,GBP,117,224,46,65,3,10,Loss,110,60,6,2,2,CHI,13,227,284,2,1.4323587594264797,32.86419479126701,17.148276775346744,15.715918015920266
0.181818182,0.3125,29.33333333,1/2/2011,14,13,home,7,CHI,224,117,30,53,10,3,Win,60,110,2,6,2,GBP,13,284,227,2,-1.4323587594264797,32.86419479126701,15.715918015920266,17.148276775346744
0.4,0.363636364,31.28333333,1/2/2011,17,24,away,-3,IND,290,257,58,64,20,23,Loss,51,101,1,1,1,TEN,43,341,358,1,-4.876206948170538,45.48884961592864,20.30632133387905,25.182528282049592
0.363636364,0.4,28.71666667,1/2/2011,24,17,home,3,TEN,257,290,25,67,23,20,Win,101,51,1,1,1,IND,43,358,341,1,4.876206948170538,45.48884961592864,25.182528282049592,20.30632133387905
0.45,0.181818182,32.8,1/2/2011,19,16,away,-31,SFO,201,262,43,81,7,38,Loss,78,100,6,2,0,ARI,45,279,362,2,-5.9643604835479955,33.25680675343041,13.64622313494121,19.6105836184892
0.181818182,0.45,27.2,1/2/2011,16,19,home,31,ARI,262,201,25,56,38,7,Win,100,78,2,6,2,SFO,45,362,279,0,5.9643604835479955,33.25680675343041,19.6105836184892,13.646223134941208
0.38888888899999996,0.35714285700000004,34.36666667,1/2/2011,20,18,away,5,DEN,283,191,32,73,33,28,Win,164,146,5,3,2,LAC,61,447,337,1,-7.126057324161442,44.34155531227379,18.607748994056173,25.733806318217617
0.35714285700000004,0.38888888899999996,25.63333333,1/2/2011,18,20,home,-5,LAC,191,283,45,68,28,33,Loss,146,164,3,5,1,DEN,61,337,447,2,7.126057324161442,44.34155531227379,25.733806318217617,18.607748994056173
0.14285714300000002,0.26666666699999997,25.25,1/2/2011,10,19,away,-10,SEA,137,192,46,54,6,16,Loss,47,141,3,0,1,LAR,22,184,333,1,-5.438171842043523,28.169613779300306,11.365720968628391,16.803892810671915
0.26666666699999997,0.14285714300000002,34.75,1/2/2011,19,10,home,10,LAR,192,137,70,71,16,6,Win,141,47,0,3,1,SEA,22,333,184,1,5.438171842043523,28.169613779300306,16.803892810671915,11.365720968628391
0.46153846200000004,0.428571429,32.01666667,1/8/2011,32,19,away,-5,SEA,397,265,39,83,36,41,Loss,77,150,1,2,1,NOS,77,474,415,1,-1.2862673144998127,53.05134021630655,25.88253645090337,27.16880376540318
0.428571429,0.46153846200000004,27.98333333,1/8/2011,19,32,home,5,NOS,265,397,39,61,41,36,Win,150,77,2,1,1,SEA,77,415,474,1,1.2862673144998127,53.05134021630655,27.16880376540318,25.88253645090337
0.533333333,0.46153846200000004,33.11666667,1/8/2011,23,16,away,1,IND,184,219,15,70,17,16,Win,169,93,1,1,0,NYJ,33,353,312,1,0.17922803740776727,43.92971815583568,22.054473096621724,21.875245059213956
0.46153846200000004,0.533333333,26.88333333,1/8/2011,16,23,home,-1,NYJ,219,184,10,54,16,17,Loss,93,169,1,1,1,IND,33,312,353,0,-0.17922803740776727,43.92971815583568,21.875245059213956,22.054473096621724
0.529411765,0.125,41.73333333,1/9/2011,26,8,away,23,KCC,248,53,20,78,30,7,Win,142,108,4,3,5,BAL,37,390,161,2,10.421042579598879,37.13122103414857,23.77613180687372,13.355089227274844
0.125,0.529411765,18.26666667,1/9/2011,8,26,home,-23,BAL,53,248,40,40,7,30,Loss,108,142,3,4,2,KCC,37,161,390,5,-10.421042579598879,37.13122103414857,13.355089227274846,23.77613180687372
0.615384615,0.384615385,32.0,1/9/2011,20,18,away,5,PHI,171,271,15,61,21,16,Win,138,81,2,3,1,GBP,37,309,352,2,5.558745921245693,48.82210287438045,27.19042439781307,21.631678476567377
0.384615385,0.615384615,28.0,1/9/2011,18,20,home,-5,GBP,271,171,50,60,16,21,Loss,81,138,3,2,2,PHI,37,352,309,1,-5.558745921245693,48.82210287438045,21.631678476567377,27.19042439781307
0.41666666700000005,0.5,25.53333333,1/15/2011,12,21,away,-7,PIT,91,192,74,53,24,31,Loss,35,71,5,6,2,BAL,55,126,263,3,0.915742600023874,31.97070765553627,16.44322512778007,15.527482527756199
0.5,0.41666666700000005,34.46666667,1/15/2011,21,12,home,7,BAL,192,91,93,69,31,24,Win,71,35,6,5,3,PIT,55,263,126,2,-0.915742600023874,31.97070765553627,15.527482527756199,16.44322512778007
0.666666667,0.3,38.31666667,1/15/2011,28,15,away,27,ATL,346,149,65,69,48,21,Win,96,45,2,5,4,GBP,69,442,194,1,9.02600833805213,49.31092009529275,29.16846421667244,20.14245587862031
0.3,0.666666667,21.68333333,1/15/2011,15,28,home,-27,GBP,149,346,32,48,21,48,Loss,45,96,5,2,1,ATL,69,194,442,4,-9.02600833805213,49.31092009529275,20.14245587862031,29.16846421667244
0.214285714,0.5555555560000001,22.83333333,1/16/2011,18,21,away,-11,CHI,242,261,20,60,24,35,Loss,34,176,2,3,1,SEA,59,276,437,0,-7.755470315768419,39.53964176872613,15.892085726478854,23.647556042247274
0.5555555560000001,0.214285714,37.18333333,1/16/2011,21,18,home,11,SEA,261,242,71,77,35,24,Win,176,34,3,2,0,CHI,59,437,276,1,7.755470315768419,39.53964176872613,23.647556042247274,15.892085726478854
0.46153846200000004,0.35714285700000004,25.06666667,1/16/2011,14,26,away,7,NEP,194,259,35,54,28,21,Win,120,113,0,5,1,NYJ,49,314,372,0,3.1484803592247212,41.16962927209278,22.15905481565875,19.01057445643403
0.35714285700000004,0.46153846200000004,34.93333333,1/16/2011,26,14,home,-7,NYJ,259,194,44,78,21,28,Loss,113,120,5,0,0,NEP,49,372,314,1,-3.1484803592247212,41.16962927209278,19.01057445643403,22.15905481565875
0.181818182,0.076923077,34.06666667,1/23/2011,23,17,away,7,CHI,236,218,40,63,21,14,Win,120,83,1,2,3,GBP,35,356,301,2,1.710849610905795,42.855602099193746,22.28322585504977,20.572376244143975
0.076923077,0.181818182,25.93333333,1/23/2011,17,23,home,-7,GBP,218,236,89,64,14,21,Loss,83,120,2,1,2,CHI,35,301,356,3,-1.710849610905795,42.855602099193746,20.572376244143975,22.28322585504977
0.35714285700000004,0.545454545,25.31666667,1/23/2011,17,23,away,-5,PIT,219,121,50,57,19,24,Loss,70,166,2,2,2,NYJ,43,289,287,1,1.7927472802108042,41.468120494007984,21.630433887109394,19.83768660689859
0.545454545,0.35714285700000004,34.68333333,1/23/2011,23,17,home,5,NYJ,121,219,25,64,24,19,Win,166,70,2,2,1,PIT,43,287,289,2,-1.7927472802108042,41.468120494007984,19.83768660689859,21.630433887109394
0.538461538,0.46153846200000004,33.41666667,2/6/2011,19,15,away,-6,GBP,261,288,55,64,25,31,Loss,126,50,1,3,0,PIT,56,387,338,3,0.8779663056885001,48.50134748042189,24.689656893055197,23.811690587366694
0.46153846200000004,0.538461538,26.58333333,2/6/2011,15,19,home,6,PIT,288,261,67,55,31,25,Win,50,126,3,1,3,GBP,56,338,387,0,-0.8779663056885001,48.50134748042189,23.811690587366694,24.689656893055197
0.642857143,0.666666667,27.1,9/8/2011,27,24,away,-8,GBP,396,296,15,73,34,42,Loss,81,103,3,2,0,NOS,76,477,399,1,0.08018191029828081,59.51327508171898,29.79672849600863,29.71654658571035
0.666666667,0.642857143,32.9,9/8/2011,24,27,home,8,NOS,296,396,48,64,42,34,Win,103,81,2,3,1,GBP,76,399,477,0,-0.08018191029828081,59.51327508171898,29.71654658571035,29.79672849600863
0.363636364,0.5,20.36666667,9/11/2011,13,20,away,-2,JAX,249,160,60,49,14,16,Loss,43,163,2,2,1,TEN,30,292,323,1,-8.961293051270118,40.71878359275916,15.87874527074452,24.84003832201464
0.5,0.363636364,39.63333333,9/11/2011,20,13,home,2,TEN,160,249,39,73,16,14,Win,163,43,2,2,1,JAX,30,323,292,1,8.961293051270118,40.71878359275916,24.84003832201464,15.87874527074452
0.111111111,0.454545455,23.26666667,9/11/2011,15,26,away,-27,HOU,172,217,60,50,7,34,Loss,64,167,3,1,3,IND,41,236,384,2,6.327898025151459,45.53906067943602,25.933479352293737,19.605581327142282
0.454545455,0.111111111,36.73333333,9/11/2011,26,15,home,27,IND,217,172,30,66,34,7,Win,167,64,1,3,2,HOU,41,384,236,3,-6.327898025151459,45.53906067943602,19.605581327142282,25.933479352293737
0.41176470600000004,0.26666666699999997,30.38333333,9/11/2011,17,17,away,10,CLE,155,202,22,64,27,17,Win,139,83,4,2,1,CIN,44,294,285,0,-5.258445799061452,30.606008489769273,12.673781345353909,17.932227144415364
0.26666666699999997,0.41176470600000004,29.61666667,9/11/2011,17,17,home,-10,CIN,202,155,72,68,17,27,Loss,83,139,2,4,0,CLE,44,285,294,1,5.258445799061452,30.606008489769273,17.932227144415364,12.67378134535391
0.5,0.23076923100000002,37.03333333,9/11/2011,23,13,away,34,KCC,201,105,30,66,41,7,Win,163,108,1,2,3,BUF,48,364,213,1,2.4402485514609076,38.217850589642616,20.32904957055176,17.888801019090856
0.23076923100000002,0.5,22.96666667,9/11/2011,13,23,home,-34,BUF,105,201,3,56,7,41,Loss,108,163,2,1,1,KCC,48,213,364,3,-2.4402485514609076,38.217850589642616,17.888801019090856,20.32904957055176
0.333333333,0.4375,27.48333333,9/11/2011,20,17,away,-28,BAL,246,215,53,61,7,35,Loss,66,170,4,1,0,PIT,42,312,385,7,6.693058745648248,46.64006917266266,26.666563959155454,19.97350521350721
0.4375,0.333333333,32.51666667,9/11/2011,17,20,home,28,PIT,215,246,75,61,35,7,Win,170,66,1,4,7,BAL,42,385,312,0,-6.693058745648248,46.64006917266266,19.97350521350721,26.666563959155454
0.307692308,0.375,26.68333333,9/11/2011,20,17,away,-18,CHI,276,289,65,66,12,30,Loss,110,88,5,5,1,ATL,42,386,377,3,-3.601479952393099,43.93292191710244,20.16572098235467,23.76720093474777
0.375,0.307692308,33.31666667,9/11/2011,17,20,home,18,ATL,289,276,56,64,30,12,Win,88,110,5,5,3,CHI,42,377,386,1,3.601479952393099,43.93292191710244,23.76720093474777,20.16572098235467
0.615384615,0.166666667,30.23333333,9/11/2011,27,21,away,18,LAR,167,181,91,67,31,13,Win,236,154,3,5,1,PHI,44,403,335,1,-3.7416634256614874,49.28248352919965,22.770410051769083,26.51207347743057
0.166666667,0.615384615,29.76666667,9/11/2011,21,27,home,-18,PHI,181,167,60,66,13,31,Loss,154,236,5,3,1,LAR,44,335,403,1,3.7416634256614874,49.28248352919965,26.51207347743057,22.770410051769083
0.181818182,0.428571429,36.41666667,9/11/2011,25,17,away,7,TBB,305,259,68,68,27,20,Win,126,56,0,2,2,DET,47,431,315,1,-5.894361209840468,46.257504476351976,20.181571633255754,26.075932843096222
0.428571429,0.181818182,23.58333333,9/11/2011,17,25,home,-7,DET,259,305,39,64,20,27,Loss,56,126,2,0,1,TBB,47,315,431,2,5.894361209840468,46.257504476351976,26.075932843096222,20.181571633255754
0.1,0.333333333,27.4,9/11/2011,15,21,away,-14,WAS,240,258,63,56,14,28,Loss,75,74,4,4,1,NYG,42,315,332,1,-0.5306673698799278,38.566502574836655,19.017917602478363,19.54858497235829
0.333333333,0.1,32.6,9/11/2011,21,15,home,14,NYG,258,240,25,64,28,14,Win,74,75,4,4,1,WAS,42,332,315,1,0.5306673698799278,38.566502574836655,19.54858497235829,19.017917602478363
0.363636364,0.46153846200000004,22.71666667,9/11/2011,10,31,away,-7,LAC,28,330,78,43,17,24,Loss,159,77,2,2,2,MIN,41,187,407,1,0.827334020324419,41.64182027556579,21.234577147945107,20.407243127620685
0.46153846200000004,0.363636364,37.28333333,9/11/2011,31,10,home,7,MIN,330,28,26,77,24,17,Win,77,159,2,2,1,LAC,41,407,187,2,-0.827334020324419,41.64182027556579,20.407243127620685,21.234577147945107
0.272727273,0.41666666700000005,32.78333333,9/11/2011,26,15,away,-7,ARI,403,295,74,68,21,28,Loss,74,99,4,2,1,CAR,49,477,394,1,-0.08276591606214767,52.699088310713236,26.308161197325543,26.390927113387693
0.41666666700000005,0.272727273,27.21666667,9/11/2011,15,26,home,7,CAR,295,403,61,54,28,21,Win,99,74,2,4,1,ARI,49,394,477,1,0.08276591606214767,52.699088310713236,26.390927113387693,26.308161197325543
0.333333333,0.083333333,28.88333333,9/11/2011,18,12,away,-16,SFO,155,124,72,64,17,33,Loss,64,85,5,0,0,SEA,50,219,209,3,1.1362585725351284,26.70069096588454,13.918474769209833,12.782216196674707
0.083333333,0.333333333,31.11666667,9/11/2011,12,18,home,16,SEA,124,155,102,52,33,17,Win,85,64,0,5,3,SFO,50,209,219,0,-1.1362585725351284,26.70069096588454,12.782216196674707,13.918474769209833
0.333333333,0.428571429,33.88333333,9/11/2011,21,19,away,-3,NYJ,326,315,40,66,24,27,Loss,64,45,4,4,2,DAL,51,390,360,3,1.6816816339220289,47.85691285071647,24.769297242319247,23.087615608397222
0.428571429,0.333333333,26.11666667,9/11/2011,19,21,home,3,DAL,315,326,0,64,27,24,Win,45,64,4,4,3,NYJ,51,360,390,2,-1.6816816339220289,47.85691285071647,23.087615608397222,24.769297242319247
0.615384615,0.14285714300000002,28.45,9/12/2011,27,25,away,14,MIA,516,390,50,71,38,24,Win,106,98,1,4,1,NEP,62,622,488,1,6.148380946597214,61.80498481666325,33.97668288163023,27.828301935033018
0.14285714300000002,0.615384615,31.55,9/12/2011,25,27,home,-14,NEP,390,516,60,73,24,38,Loss,98,106,4,1,1,MIA,62,488,622,1,-6.148380946597214,61.80498481666325,27.828301935033018,33.97668288163023
0.35714285700000004,0.46153846200000004,32.58333333,9/12/2011,20,25,away,3,DEN,99,272,131,62,23,20,Win,190,38,1,5,3,OAK,43,289,310,1,-3.9241131296983154,50.566328164898266,23.321107517599977,27.24522064729829
0.46153846200000004,0.35714285700000004,27.41666667,9/12/2011,25,20,home,-3,OAK,272,99,91,64,20,23,Loss,38,190,5,1,1,DEN,43,310,289,3,3.9241131296983154,50.566328164898266,27.24522064729829,23.321107517599977
0.166666667,0.470588235,23.76666667,9/18/2011,18,16,away,-17,NOS,186,264,47,63,13,30,Loss,60,118,6,1,1,CHI,43,246,382,1,-4.434987355894101,36.089644087269434,15.827328365687666,20.262315721581768
0.470588235,0.166666667,36.23333333,9/18/2011,16,18,home,17,CHI,264,186,41,67,30,13,Win,118,60,1,6,1,NOS,43,382,246,1,4.434987355894101,36.089644087269434,20.262315721581768,15.827328365687666
0.666666667,0.363636364,29.21666667,9/18/2011,26,34,away,-3,BUF,323,258,85,63,35,38,Loss,131,223,0,1,1,OAK,73,454,481,2,-0.3280400374323351,68.56030711467842,34.116133538623046,34.44417357605538
0.363636364,0.666666667,30.78333333,9/18/2011,34,26,home,3,OAK,258,323,26,71,38,35,Win,223,131,1,0,2,BUF,73,481,454,1,0.3280400374323351,68.56030711467842,34.44417357605538,34.116133538623046
0.5,0.28571428600000004,34.56666667,9/18/2011,18,19,away,8,IND,197,176,49,67,27,19,Win,106,109,1,2,2,CLE,46,303,285,1,-5.597639569419544,36.45362980726584,15.42799511892315,21.02563468834269
0.28571428600000004,0.5,25.43333333,9/18/2011,19,18,home,-8,CLE,176,197,21,66,19,27,Loss,109,106,2,1,1,IND,46,285,303,2,5.597639569419544,36.45362980726584,21.02563468834269,15.427995118923148
0.583333333,0.454545455,26.5,9/18/2011,19,25,away,4,MIN,230,212,53,52,24,20,Win,105,186,2,2,1,TBB,44,335,398,1,-0.7874392383880715,49.87316345863751,24.542862110124716,25.33030134851279
0.454545455,0.583333333,33.5,9/18/2011,25,19,home,-4,TBB,212,230,65,65,20,24,Loss,186,105,2,2,1,MIN,44,398,335,1,0.7874392383880715,49.87316345863751,25.33030134851279,24.542862110124716
0.41666666700000005,0.46153846200000004,27.43333333,9/18/2011,16,26,away,7,CAR,295,404,57,52,30,23,Win,124,71,1,4,4,GBP,53,419,475,1,2.020736498650127,62.06286223728919,32.04179936796966,30.02106286931953
0.46153846200000004,0.41666666700000005,32.56666667,9/18/2011,26,16,home,-7,GBP,404,295,50,71,23,30,Loss,71,124,4,1,1,CAR,53,475,419,4,-2.020736498650127,62.06286223728919,30.02106286931953,32.04179936796966
0.166666667,0.533333333,21.26666667,9/18/2011,8,23,away,-24,PIT,133,297,66,47,0,24,Loss,31,124,5,2,0,SEA,24,164,421,0,3.4749188876201345,32.57920811615091,18.02706350188552,14.552144614265387
0.533333333,0.166666667,38.73333333,9/18/2011,23,8,home,24,SEA,297,133,48,68,24,0,Win,124,31,2,5,0,PIT,24,421,164,0,-3.4749188876201345,32.57920811615091,14.552144614265387,18.02706350188552
0.25,0.25,26.61666667,9/18/2011,11,15,away,-29,NYJ,91,182,50,54,3,32,Loss,112,101,2,1,2,JAX,35,203,283,4,0.05236140227538222,35.553239018288096,17.802800210281738,17.750438808006358
0.25,0.25,33.38333333,9/18/2011,15,11,home,29,JAX,182,91,60,57,32,3,Win,101,112,1,2,4,NYJ,35,283,203,2,-0.05236140227538222,35.553239018288096,17.750438808006358,17.802800210281738
0.3,0.41176470600000004,24.13333333,9/18/2011,15,21,away,-13,TEN,184,358,44,52,13,26,Loss,45,74,3,0,1,BAL,39,229,432,3,1.6411187278029722,43.08746418215068,22.36429145497683,20.723172727173854
0.41176470600000004,0.3,35.86666667,9/18/2011,21,15,home,13,BAL,358,184,70,71,26,13,Win,74,45,0,3,3,TEN,39,432,229,1,-1.6411187278029722,43.08746418215068,20.723172727173854,22.36429145497683
0.181818182,0.333333333,27.6,9/18/2011,12,23,away,-45,DET,116,322,70,54,3,48,Loss,151,89,2,0,1,KCC,51,267,411,6,1.418882514646917,44.147231533409034,22.783057024027976,21.36417450938106
0.333333333,0.181818182,32.4,9/18/2011,23,12,home,45,KCC,322,116,35,70,48,3,Win,89,151,0,2,6,DET,51,411,267,1,-1.418882514646917,44.147231533409034,21.36417450938106,22.783057024027976
0.333333333,0.352941176,21.5,9/18/2011,16,28,away,-1,WAS,231,283,97,48,21,22,Loss,93,172,3,1,2,ARI,43,324,455,2,-1.988662316484965,47.18339190598367,22.597364794749353,24.586027111234316
0.352941176,0.333333333,38.5,9/18/2011,28,16,home,1,ARI,283,231,15,79,22,21,Win,172,93,1,3,2,WAS,43,455,324,2,1.988662316484965,47.18339190598367,24.586027111234316,22.597364794749353
0.428571429,0.5,32.16666667,9/18/2011,20,14,away,3,SFO,427,132,83,66,3,0,Win,45,74,1,6,1,DAL,3,472,206,2,-0.949880738038047,40.563300306389024,19.80670978417549,20.756590522213536
0.5,0.428571429,30.71666667,9/18/2011,14,20,home,-3,DAL,132,427,25,54,0,3,Loss,74,45,6,1,2,SFO,3,206,472,1,0.949880738038047,40.563300306389024,20.756590522213536,19.80670978417549
0.090909091,0.41666666700000005,29.75,9/18/2011,18,19,away,-2,DEN,310,187,69,63,22,24,Loss,72,131,2,2,2,CIN,46,382,318,0,3.5386119189582845,41.81974070215914,22.67917631055871,19.140564391600428
0.41666666700000005,0.090909091,30.25,9/18/2011,19,18,home,2,CIN,187,310,55,63,24,22,Win,131,72,2,2,0,DEN,46,318,382,2,-3.5386119189582845,41.81974070215914,19.140564391600428,22.67917631055871
0.833333333,0.636363636,30.96666667,9/18/2011,29,28,away,-14,NEP,372,410,44,66,21,35,Loss,98,94,2,2,0,LAC,56,470,504,4,6.984340822768502,68.90774843760323,37.94604463018587,30.961703807417365
0.636363636,0.833333333,29.03333333,9/18/2011,28,29,home,14,LAC,410,372,80,67,35,21,Win,94,98,2,2,4,NEP,56,504,470,0,-6.984340822768502,68.90774843760323,30.961703807417365,37.94604463018587
0.333333333,0.333333333,34.1,9/18/2011,19,18,away,10,MIA,207,153,76,68,23,13,Win,138,153,3,2,2,HOU,36,345,306,0,-5.701416066716011,38.57837937741741,16.4384816553507,22.139897722066713
0.333333333,0.333333333,25.9,9/18/2011,18,19,home,-10,HOU,153,207,20,60,13,23,Loss,153,138,2,3,0,MIA,36,306,345,2,5.701416066716011,38.57837937741741,22.139897722066713,16.4384816553507
0.454545455,0.46153846200000004,30.05,9/18/2011,27,20,away,-4,ATL,314,180,20,67,31,35,Loss,133,138,0,4,2,PHI,66,447,318,3,5.567352851147852,53.39939845170723,29.48337565142754,23.916022800279688
0.46153846200000004,0.454545455,29.95,9/18/2011,20,27,home,4,PHI,180,314,57,61,35,31,Win,138,133,4,0,3,ATL,66,318,447,2,-5.567352851147852,53.39939845170723,23.916022800279688,29.48337565142754
0.294117647,0.333333333,25.8,9/19/2011,14,22,away,-12,NYG,308,204,62,67,16,28,Loss,59,119,2,3,1,LAR,44,367,323,2,-12.816189864711832,42.3287755003077,14.756292817797934,27.572482682509765
0.333333333,0.294117647,34.2,9/19/2011,22,14,home,12,LAR,204,308,55,71,28,16,Win,119,59,3,2,2,NYG,44,323,367,1,12.816189864711832,42.3287755003077,27.572482682509765,14.756292817797934
0.307692308,0.272727273,37.85,9/25/2011,22,19,away,-1,CLE,231,210,93,72,16,17,Loss,138,70,5,0,1,MIA,33,369,280,2,-4.090830323127782,38.77845251163139,17.343811094251805,21.434641417379588
0.272727273,0.307692308,22.15,9/25/2011,19,22,home,1,MIA,210,231,85,58,17,16,Win,70,138,0,5,2,CLE,33,280,369,1,4.090830323127782,38.77845251163139,21.434641417379588,17.343811094251805
0.41666666700000005,0.46666666700000003,23.15,9/25/2011,14,25,away,13,PHI,232,199,21,51,29,16,Win,102,177,3,2,3,NYG,45,334,376,0,2.961902373256968,49.11812908080234,26.040015727029655,23.078113353772686
0.46666666700000003,0.41666666700000005,36.85,9/25/2011,25,14,home,-13,NYG,199,232,36,72,16,29,Loss,177,102,2,3,0,PHI,45,376,334,3,-2.961902373256968,49.11812908080234,23.078113353772686,26.040015727029655
0.428571429,0.615384615,30.1,9/25/2011,21,27,away,-7,NOS,364,354,56,66,33,40,Loss,109,100,2,2,2,HOU,73,473,454,1,-2.037881844601793,59.85422885975736,28.908173507577786,30.946055352179577
0.615384615,0.428571429,29.9,9/25/2011,27,21,home,7,HOU,354,364,26,68,40,33,Win,100,109,2,2,1,NOS,73,454,473,2,2.037881844601793,59.85422885975736,30.946055352179577,28.908173507577786
0.333333333,0.363636364,31.25,9/25/2011,30,24,away,-3,BUF,387,369,93,71,31,34,Loss,108,79,0,0,2,NEP,65,495,448,4,11.655237089671633,64.72301411400423,38.18912560183793,26.5338885121663
0.363636364,0.333333333,28.75,9/25/2011,24,30,home,3,NEP,369,387,77,60,34,31,Win,79,108,0,0,4,BUF,65,448,495,2,-11.655237089671633,64.72301411400423,26.5338885121663,38.18912560183793
0.214285714,0.375,30.43333333,9/25/2011,13,16,away,-6,CAR,129,158,60,57,10,16,Loss,128,107,2,0,0,JAX,26,257,265,1,-11.458067734133246,33.82683941747357,11.184385841670164,22.64245357580341
0.375,0.214285714,29.56666667,9/25/2011,16,13,home,6,JAX,158,129,69,62,16,10,Win,107,128,0,2,1,CAR,26,265,257,0,11.458067734133246,33.82683941747357,22.64245357580341,11.184385841670164
0.333333333,0.1,35.33333333,9/25/2011,16,14,away,5,CIN,176,149,70,64,13,8,Win,50,79,5,1,3,SFO,21,226,228,1,4.960376313332045,29.306500421151274,17.13343836724166,12.173062053909614
0.1,0.333333333,24.66666667,9/25/2011,14,16,home,-5,SFO,149,176,40,53,8,13,Loss,79,50,1,5,1,CIN,21,228,226,3,-4.960376313332045,29.306500421151274,12.173062053909614,17.13343836724166
0.41176470600000004,0.28571428600000004,34.15,9/25/2011,19,16,away,3,MIN,338,189,65,70,3,0,Win,20,132,5,4,0,DET,3,358,321,0,-8.474642070449171,37.631769320575096,14.578563625062962,23.053205695512133
0.28571428600000004,0.41176470600000004,27.83333333,9/25/2011,16,19,home,-3,DET,189,338,79,63,0,3,Loss,132,20,4,5,0,MIN,3,321,358,0,8.474642070449171,37.631769320575096,23.053205695512133,14.578563625062962
0.533333333,0.533333333,29.1,9/25/2011,19,17,away,-3,TEN,172,295,15,63,14,17,Loss,59,38,1,2,2,DEN,31,231,333,2,-3.8642024164066617,44.75526732209905,20.445532452846194,24.309734869252857
0.533333333,0.533333333,30.9,9/25/2011,17,19,home,3,DEN,295,172,80,61,17,14,Win,38,59,2,1,2,TEN,31,333,231,2,3.8642024164066617,44.75526732209905,24.309734869252857,20.445532452846194
0.4,0.28571428600000004,31.18333333,9/25/2011,25,17,away,30,LAR,385,132,32,76,37,7,Win,168,112,2,5,2,BAL,44,553,244,1,-5.784166512912762,46.078478176887195,20.147155831987217,25.93132234489998
0.28571428600000004,0.4,28.81666667,9/25/2011,17,25,home,-30,BAL,132,385,117,63,7,37,Loss,112,168,5,2,1,LAR,44,244,553,2,5.784166512912762,46.078478176887195,25.93132234489998,20.147155831987217
0.428571429,0.0,33.33333333,9/25/2011,25,23,away,-10,OAK,339,149,61,73,24,34,Loss,100,234,4,1,0,NYJ,58,439,383,2,-1.7574997169546291,51.96469818397306,25.103599233509218,26.861098950463845
0.0,0.428571429,26.66666667,9/25/2011,23,25,home,10,NYJ,149,339,55,60,34,24,Win,234,100,1,4,2,OAK,58,383,439,0,1.7574997169546291,51.96469818397306,26.861098950463845,25.103599233509218
0.41666666700000005,0.571428571,25.28333333,9/25/2011,13,22,away,-3,LAC,171,258,65,52,17,20,Loss,81,117,1,2,2,KCC,37,252,375,1,-4.164580978779236,40.670750943215374,18.25308498221807,22.417665960997304
0.571428571,0.41666666700000005,34.71666667,9/25/2011,22,13,home,3,KCC,258,171,40,70,20,17,Win,117,81,2,1,1,LAC,37,375,252,2,4.164580978779236,40.670750943215374,22.417665960997304,18.25308498221807
0.384615385,0.35714285700000004,24.13333333,9/25/2011,21,20,away,-3,TBB,295,180,50,66,13,16,Loss,30,115,4,0,2,ATL,29,325,295,3,-8.033410805967439,40.88168867478973,16.424138934411147,24.45754974037858
0.35714285700000004,0.384615385,35.86666667,9/25/2011,20,21,home,3,ATL,180,295,66,68,16,13,Win,115,30,0,4,3,TBB,29,295,325,2,8.033410805967439,40.88168867478973,24.45754974037858,16.424138934411147
0.384615385,0.25,37.48333333,9/25/2011,24,12,away,10,CHI,292,278,35,69,27,17,Win,100,13,2,3,2,GBP,44,392,291,2,2.5891907907142073,45.86508224102898,24.227136515871592,21.637945725157387
0.25,0.384615385,22.51666667,9/25/2011,12,24,home,-10,GBP,278,292,70,52,17,27,Loss,13,100,3,2,2,CHI,44,291,392,2,-2.5891907907142073,45.86508224102898,21.637945725157387,24.227136515871592
0.214285714,0.375,31.81666667,9/25/2011,20,16,away,-3,SEA,234,139,20,70,10,13,Loss,90,122,3,4,1,ARI,23,324,261,2,-1.8861160117129825,31.62847745534367,14.871180721815342,16.757296733528328
0.375,0.214285714,28.18333333,9/25/2011,16,20,home,3,ARI,139,234,39,65,13,10,Win,122,90,4,3,2,SEA,23,261,324,1,1.8861160117129825,31.62847745534367,16.757296733528328,14.871180721815344
0.533333333,0.4375,33.96666667,9/25/2011,19,14,away,3,IND,341,144,38,68,23,20,Win,67,97,3,1,1,PIT,43,408,241,3,-4.026720035760764,42.289343047094256,19.131311505666744,23.158031541427512
0.4375,0.533333333,26.03333333,9/25/2011,14,19,home,-3,PIT,144,341,21,62,20,23,Loss,97,67,1,3,3,IND,43,241,408,1,4.026720035760764,42.289343047094256,23.158031541427512,19.131311505666744
0.25,0.23076923100000002,28.4,9/26/2011,20,17,away,-2,DAL,233,250,35,62,16,18,Loss,65,125,3,1,2,WAS,34,298,375,2,-3.779359546332529,38.714080763588086,17.46736060862778,21.246720154960308
0.23076923100000002,0.25,31.6,9/26/2011,17,20,home,2,WAS,250,233,55,63,18,16,Win,125,65,1,3,2,DAL,34,375,298,2,3.779359546332529,38.714080763588086,21.246720154960308,17.46736060862778
0.5,0.26666666699999997,37.08333333,10/2/2011,30,15,away,13,JAX,326,170,50,81,23,10,Win,177,104,3,3,1,NOS,33,503,274,2,-7.023696822809031,47.50383089477238,20.240067035981674,27.263763858790703
0.26666666699999997,0.5,22.91666667,10/2/2011,15,30,home,-13,NOS,170,326,15,62,10,23,Loss,104,177,3,3,2,JAX,33,274,503,1,7.023696822809031,47.50383089477238,27.263763858790703,20.240067035981674
0.166666667,0.3,33.48333333,10/2/2011,24,15,away,-5,CHI,374,93,52,72,29,34,Loss,169,224,0,1,1,CAR,63,543,317,1,-2.9067921686507354,49.1735708910094,23.133389361179333,26.040181529830065
0.3,0.166666667,26.51666667,10/2/2011,15,24,home,5,CAR,93,374,45,49,34,29,Win,224,169,1,0,1,CHI,63,317,543,1,2.9067921686507354,49.1735708910094,26.040181529830065,23.133389361179333
0.307692308,0.384615385,23.35,10/2/2011,18,25,away,4,DAL,240,321,75,60,34,30,Win,63,113,0,1,3,DET,64,303,434,1,-5.298669030416237,46.91726367060645,20.80929732009511,26.107966350511344
0.384615385,0.307692308,36.65,10/2/2011,25,18,home,-4,DET,321,240,33,75,30,34,Loss,113,63,1,0,1,DAL,64,434,303,3,5.298669030416237,46.91726367060645,26.107966350511344,20.80929732009511
0.35714285700000004,0.4,32.16666667,10/2/2011,17,15,away,-5,KCC,190,247,45,62,17,22,Loss,151,103,2,3,0,MIN,39,341,350,1,-3.200911003032168,38.087708249689264,17.443398623328548,20.644309626360716
0.4,0.35714285700000004,27.83333333,10/2/2011,15,17,home,5,MIN,247,190,57,60,22,17,Win,103,151,3,2,1,KCC,39,350,341,0,3.200911003032168,38.087708249689264,20.644309626360716,17.443398623328548
0.28571428600000004,0.41666666700000005,28.65,10/2/2011,12,25,away,-3,CIN,190,287,26,56,20,23,Loss,83,171,1,2,2,BUF,43,273,458,0,3.299220011189604,43.31949917256209,23.309359591875847,20.010139580686243
0.41666666700000005,0.28571428600000004,31.35,10/2/2011,25,12,home,3,BUF,287,190,15,70,23,20,Win,171,83,2,1,0,CIN,43,458,273,2,-3.299220011189604,43.31949917256209,20.010139580686243,23.309359591875847
0.333333333,0.4,23.11666667,10/2/2011,13,25,away,18,CLE,220,332,45,50,31,13,Win,112,84,0,4,1,TEN,44,332,416,1,-10.397237203647636,41.53021228271018,15.566487539531273,25.963724743178908
0.4,0.333333333,36.88333333,10/2/2011,25,13,home,-18,TEN,332,220,40,87,13,31,Loss,84,112,4,0,1,CLE,44,416,332,1,10.397237203647636,41.53021228271018,25.963724743178908,15.566487539531273
0.5,0.333333333,35.16666667,10/2/2011,16,14,away,7,LAR,143,127,96,69,17,10,Win,196,45,0,7,1,WAS,27,339,172,2,-22.543654475133465,31.376159697043594,4.416252610955066,26.959907086088528
0.333333333,0.5,24.83333333,10/2/2011,14,16,home,-7,WAS,127,143,65,67,10,17,Loss,45,196,7,0,2,LAR,27,172,339,1,22.543654475133465,31.376159697043594,26.959907086088528,4.416252610955064
0.41666666700000005,0.384615385,28.86666667,10/2/2011,22,23,away,1,PHI,278,405,40,61,24,23,Win,164,108,3,2,3,SFO,47,442,513,1,5.30331549546827,59.426001671406944,32.3646585834376,27.061343087969338
0.384615385,0.41666666700000005,31.13333333,10/2/2011,23,22,home,-1,SFO,405,278,55,68,23,24,Loss,108,164,2,3,1,PHI,47,513,442,3,-5.30331549546827,59.426001671406944,27.061343087969334,32.36465858343761
0.41666666700000005,0.5,28.28333333,10/2/2011,20,17,away,-7,HOU,178,138,45,57,10,17,Loss,118,180,5,0,0,PIT,27,296,318,1,-0.13807923025370883,40.81940915813852,20.340664963942405,20.478744194196114
0.5,0.41666666700000005,31.71666667,10/2/2011,17,20,home,7,PIT,138,178,64,56,17,10,Win,180,118,0,5,1,HOU,27,318,296,0,0.13807923025370883,40.81940915813852,20.478744194196114,20.340664963942405
0.5625,0.545454545,40.16666667,10/2/2011,25,20,away,2,SEA,291,319,35,78,30,28,Win,121,53,0,0,2,ATL,58,412,372,0,-0.743033550709038,49.06348824727018,24.16022734828057,24.903260898989608
0.545454545,0.5625,19.83333333,10/2/2011,20,25,home,-2,ATL,319,291,40,53,28,30,Loss,53,121,0,0,0,SEA,58,372,412,2,0.743033550709038,49.06348824727018,24.903260898989608,24.16022734828057
0.46153846200000004,0.25,28.01666667,10/2/2011,24,22,away,4,ARI,306,212,55,65,31,27,Win,54,156,1,4,2,NYG,58,360,368,2,-5.737104212853605,48.56739818403611,21.41514698559125,27.15225119844486
0.25,0.46153846200000004,31.98333333,10/2/2011,22,24,home,-4,NYG,212,306,118,70,27,31,Loss,156,54,4,1,2,ARI,58,368,360,2,5.737104212853605,48.56739818403611,27.15225119844486,21.41514698559125
0.444444444,0.615384615,26.66666667,10/2/2011,25,24,away,12,OAK,226,344,45,61,31,19,Win,183,160,1,0,2,NEP,50,409,504,0,4.782709878449115,61.4956485158944,33.13917919717176,28.356469318722645
0.615384615,0.444444444,33.33333333,10/2/2011,24,25,home,-12,NEP,344,226,85,66,19,31,Loss,160,183,0,1,0,OAK,50,504,409,2,-4.782709878449115,61.4956485158944,28.356469318722645,33.13917919717176
0.363636364,0.692307692,26.98333333,10/2/2011,18,26,away,-26,GBP,265,396,24,56,23,49,Loss,119,111,1,2,2,DEN,72,384,507,4,8.855543254076936,63.57776504868384,36.21665415138038,27.36111089730345
0.692307692,0.363636364,33.01666667,10/2/2011,26,18,home,26,DEN,396,265,27,69,49,23,Win,111,119,2,1,4,GBP,72,507,384,2,-8.855543254076936,63.57776504868384,27.361110897303448,36.21665415138039
0.3,0.5,26.7,10/2/2011,16,21,away,-10,LAC,176,295,41,55,16,26,Loss,72,116,3,2,0,MIA,42,248,411,2,2.403003397943383,41.569686382343775,21.986344890143577,19.583341492200198
0.5,0.3,33.3,10/2/2011,21,16,home,10,MIA,295,176,80,61,26,16,Win,116,72,2,3,2,LAC,42,411,248,0,-2.403003397943383,41.569686382343775,19.583341492200198,21.986344890143577
0.26666666699999997,0.333333333,22.53333333,10/2/2011,7,16,away,-17,BAL,112,155,69,56,17,34,Loss,38,112,2,2,3,NYJ,51,150,267,4,-5.395995810085731,28.380516347520704,11.492260268717487,16.888256078803217
0.333333333,0.26666666699999997,37.46666667,10/2/2011,16,7,home,17,NYJ,155,112,46,73,34,17,Win,112,38,2,2,4,BAL,51,267,150,3,5.395995810085731,28.380516347520704,16.888256078803217,11.492260268717487
0.307692308,0.41176470600000004,21.0,10/3/2011,13,25,away,-7,TBB,256,274,50,52,17,24,Loss,62,192,4,2,0,IND,41,318,466,1,-8.56675731857091,44.89475991121442,18.164001296321757,26.730758614892665
0.41176470600000004,0.307692308,39.0,10/3/2011,25,13,home,7,IND,274,256,106,77,24,17,Win,192,62,2,4,1,TBB,41,466,318,0,8.56675731857091,44.89475991121442,26.730758614892665,18.164001296321757
0.46666666700000003,0.583333333,27.63333333,10/9/2011,20,26,away,-21,PIT,240,257,70,70,17,38,Loss,66,174,3,1,1,TEN,55,306,431,1,-8.379000927122796,49.231446875980346,20.426222974428775,28.80522390155157
0.583333333,0.46666666700000003,32.36666667,10/9/2011,26,20,home,21,TEN,257,240,51,64,38,17,Win,174,66,1,3,1,PIT,55,431,306,1,8.379000927122796,49.231446875980346,28.80522390155157,20.426222974428775
0.42105263200000004,0.375,32.55,10/9/2011,13,12,away,10,JAX,162,200,33,66,30,20,Win,77,96,2,3,2,CIN,50,239,296,1,-5.192183633286094,32.77811069989385,13.79296353330388,18.98514716658997
0.375,0.42105263200000004,27.45,10/9/2011,12,13,home,-10,CIN,200,162,15,58,20,30,Loss,96,77,3,2,1,JAX,50,296,239,2,5.192183633286094,32.77811069989385,18.98514716658997,13.79296353330388
0.705882353,0.583333333,34.66666667,10/9/2011,27,20,away,3,CAR,343,219,82,75,30,27,Win,101,162,2,1,1,NOS,57,444,381,1,-7.419565392644055,58.65739071875253,25.61891266305424,33.03847805569829
0.583333333,0.705882353,25.33333333,10/9/2011,20,27,home,-3,NOS,219,343,65,54,27,30,Loss,162,101,1,2,1,CAR,57,381,444,1,7.419565392644055,58.65739071875253,33.03847805569829,25.61891266305424
0.2,0.4,25.58333333,10/9/2011,11,21,away,5,HOU,184,403,89,60,25,20,Win,94,70,3,3,2,OAK,45,278,473,1,-16.79571479473617,45.501867247323275,14.353076226293553,31.148791021029723
0.4,0.2,34.41666667,10/9/2011,21,11,home,-5,OAK,403,184,50,79,20,25,Loss,70,94,3,3,1,HOU,45,473,278,2,16.79571479473617,45.501867247323275,31.148791021029723,14.353076226293553
0.222222222,0.428571429,26.36666667,10/9/2011,24,21,away,-7,BUF,315,188,46,60,24,31,Loss,174,143,0,1,1,PHI,55,489,331,5,9.046707650505482,57.41670732641645,33.23170748846097,24.184999837955484
0.428571429,0.222222222,33.63333333,10/9/2011,21,24,home,7,PHI,188,315,40,63,31,24,Win,143,174,1,0,5,BUF,55,331,489,1,-9.046707650505482,57.41670732641645,24.18499983795548,33.23170748846097
0.444444444,0.3,31.01666667,10/9/2011,18,20,away,-24,MIN,214,160,64,76,10,34,Loss,77,172,4,1,1,ARI,44,291,332,4,-5.898325547573645,39.45406347216266,16.777868962294505,22.676194509868154
0.3,0.444444444,28.98333333,10/9/2011,20,18,home,24,ARI,160,214,35,59,34,10,Win,172,77,1,4,4,MIN,44,332,291,1,5.898325547573645,39.45406347216266,22.676194509868154,16.777868962294505
0.26666666699999997,0.083333333,28.76666667,10/9/2011,22,21,away,11,NYG,279,395,70,76,36,25,Win,145,69,6,3,5,SEA,61,424,464,3,-0.6169131778412922,53.39895926917824,26.391023045668476,27.007936223509766
0.083333333,0.26666666699999997,31.23333333,10/9/2011,21,22,home,-11,SEA,395,279,52,67,25,36,Loss,69,145,3,6,3,NYG,61,464,424,5,0.6169131778412922,53.39895926917824,27.007936223509766,26.391023045668476
0.571428571,0.41666666700000005,33.11666667,10/9/2011,26,15,away,4,IND,242,277,39,69,28,24,Win,194,78,2,0,0,KCC,52,436,355,0,0.14745944194813632,47.5265335901498,23.83699651604897,23.689537074100834
0.41666666700000005,0.571428571,26.88333333,10/9/2011,15,26,home,-4,KCC,277,242,40,54,24,28,Loss,78,194,0,2,0,IND,52,355,436,0,-0.14745944194813632,47.5265335901498,23.689537074100834,23.83699651604897
0.4375,0.28571428600000004,28.96666667,10/9/2011,14,28,away,-45,SFO,186,205,96,61,3,48,Loss,86,213,3,0,1,TBB,51,272,418,3,-0.20697966529978729,45.260767257844186,22.526893796272198,22.73387346157199
0.28571428600000004,0.4375,31.03333333,10/9/2011,28,14,home,45,TBB,205,186,30,58,48,3,Win,213,86,0,3,3,SFO,51,418,272,1,0.20697966529978729,45.260767257844186,22.73387346157199,22.526893796272198
0.5,0.222222222,40.13333333,10/9/2011,25,13,away,5,DEN,212,113,0,77,29,24,Win,206,162,5,0,1,LAC,53,418,275,2,3.156761024396858,42.651226822973186,22.90399392368502,19.747232899288164
0.222222222,0.5,19.86666667,10/9/2011,13,25,home,-5,LAC,113,212,53,46,24,29,Loss,162,206,0,5,2,DEN,53,275,418,1,-3.156761024396858,42.651226822973186,19.747232899288164,22.90399392368502
0.272727273,0.5,26.08333333,10/9/2011,14,26,away,-9,NEP,158,294,89,53,21,30,Loss,97,152,2,4,1,NYJ,51,255,446,0,5.320053788621829,42.9771778903833,24.148615839502565,18.828562050880738
0.5,0.272727273,33.91666667,10/9/2011,26,14,home,9,NYJ,294,158,50,72,30,21,Win,152,97,4,2,0,NEP,51,446,255,1,-5.320053788621829,42.9771778903833,18.828562050880738,24.148615839502565
0.6,0.454545455,33.18333333,10/9/2011,19,18,away,11,ATL,369,156,55,63,25,14,Win,57,95,4,1,2,GBP,39,426,251,1,3.2972343577261922,47.05193577477494,25.174585066250565,21.877350708524375
0.454545455,0.6,26.81666667,10/9/2011,18,19,home,-11,GBP,156,369,44,55,14,25,Loss,95,57,1,4,1,ATL,39,251,426,2,-3.2972343577261922,47.05193577477494,21.877350708524375,25.174585066250565
0.307692308,0.454545455,39.05,10/10/2011,23,16,away,-11,DET,237,214,104,66,13,24,Loss,122,181,3,1,1,CHI,37,359,395,0,-0.7611612993869823,47.909528513950015,23.574183607281515,24.3353449066685
0.454545455,0.307692308,20.95,10/10/2011,16,23,home,11,CHI,214,237,94,47,24,13,Win,181,122,1,3,0,DET,37,395,359,1,0.7611612993869823,47.909528513950015,24.3353449066685,23.574183607281515
0.23076923100000002,0.307692308,30.68333333,10/16/2011,22,20,away,-21,GBP,306,309,45,72,3,24,Loss,118,90,3,1,1,LAR,27,424,399,1,-0.39642765663763857,48.89246119209014,24.24801676772625,24.64444442436389
0.307692308,0.23076923100000002,29.31666667,10/16/2011,20,22,home,21,LAR,309,306,16,61,24,3,Win,90,118,1,3,1,GBP,27,399,424,1,0.39642765663763857,48.89246119209014,24.64444442436389,24.24801676772625
0.454545455,0.454545455,29.21666667,10/16/2011,17,24,away,-3,NYG,219,292,75,56,24,27,Loss,155,122,3,0,0,BUF,51,374,414,2,-2.319824163064677,53.08003106900437,25.38010345296985,27.699927616034522
0.454545455,0.454545455,30.78333333,10/16/2011,24,17,home,3,BUF,292,219,79,65,27,24,Win,122,155,0,3,2,NYG,51,414,374,0,2.319824163064677,53.08003106900437,27.699927616034522,25.38010345296985
0.5,0.428571429,26.4,10/16/2011,18,17,away,-10,CIN,179,264,11,58,17,27,Loss,94,94,1,0,0,IND,44,273,358,3,0.2116229925640809,43.51145780401433,21.861540398289204,21.649917405725123
0.428571429,0.5,33.6,10/16/2011,17,18,home,10,IND,264,179,111,63,27,17,Win,94,94,0,1,3,CIN,44,358,273,0,-0.2116229925640809,43.51145780401433,21.649917405725123,21.861540398289204
0.666666667,0.636363636,29.43333333,10/16/2011,24,24,away,-14,ATL,229,159,85,62,17,31,Loss,139,166,1,1,0,CAR,48,368,325,3,-4.111328300590166,54.07090088779615,24.97978629360299,29.091114594193158
0.636363636,0.666666667,30.56666667,10/16/2011,24,24,home,14,CAR,159,229,57,58,31,17,Win,166,139,1,1,3,ATL,48,325,368,0,4.111328300590166,54.07090088779615,29.091114594193158,24.97978629360299
0.14285714300000002,0.133333333,29.65,10/16/2011,14,21,away,6,DET,111,244,120,63,25,19,Win,203,66,2,5,0,SFO,44,314,310,2,-9.103093360023074,32.67012135689184,11.783513998434383,20.886607358457457
0.133333333,0.14285714300000002,30.35,10/16/2011,21,14,home,-6,SFO,244,111,54,73,19,25,Loss,66,203,5,2,2,DET,44,310,314,0,9.103093360023074,32.67012135689184,20.886607358457457,11.783513998434383
0.375,0.1,38.13333333,10/16/2011,22,17,away,7,WAS,230,245,60,72,20,13,Win,192,42,2,2,4,PHI,33,422,287,2,0.1092919068103324,47.023510564299386,23.56640123555486,23.457109328744526
0.1,0.375,21.86666667,10/16/2011,17,22,home,-7,PHI,245,230,75,53,13,20,Loss,42,192,2,2,2,WAS,33,287,422,4,-0.1092919068103324,47.023510564299386,23.457109328744526,23.56640123555486
0.26666666699999997,0.46666666700000003,28.78333333,10/16/2011,16,15,away,-4,PIT,76,185,22,61,13,17,Loss,133,185,5,3,0,JAX,30,209,370,0,-4.112220442742455,32.65209945378564,14.269939505521592,18.382159948264047
0.46666666700000003,0.26666666699999997,31.21666667,10/16/2011,15,16,home,4,JAX,185,76,65,58,17,13,Win,185,133,3,5,0,PIT,30,370,209,0,4.112220442742455,32.65209945378564,18.382159948264047,14.269939505521592
0.5,0.5,25.31666667,10/16/2011,18,18,away,-7,OAK,203,178,34,68,17,24,Loss,65,151,2,2,1,CLE,41,268,329,1,-11.698756602425554,39.809518060989106,14.055380729281776,25.75413733170733
0.5,0.5,34.68333333,10/16/2011,18,18,home,7,CLE,178,203,35,66,24,17,Win,151,65,2,2,1,OAK,41,329,268,1,11.698756602425554,39.809518060989106,25.75413733170733,14.055380729281776
0.375,0.272727273,27.8,10/16/2011,18,24,away,-15,BAL,200,289,15,66,14,29,Loss,93,113,4,2,2,HOU,43,293,402,0,2.8077787182487155,41.41853699230374,22.113157855276228,19.305379137027515
0.272727273,0.375,32.2,10/16/2011,24,18,home,15,HOU,289,200,25,65,29,14,Win,113,93,2,4,0,BAL,43,402,293,2,-2.8077787182487155,41.41853699230374,19.305379137027515,22.113157855276228
0.41666666700000005,0.28571428600000004,28.55,10/16/2011,20,21,away,-6,TBB,383,303,53,65,20,26,Loss,70,117,0,0,0,NOS,46,453,420,4,-4.187775630787627,52.42672327955853,24.11947382438545,28.30724945517308
0.28571428600000004,0.41666666700000005,31.45,10/16/2011,21,20,home,6,NOS,303,383,64,66,26,20,Win,117,70,0,0,4,TBB,46,420,453,0,4.187775630787627,52.42672327955853,28.30724945517308,24.11947382438545
0.333333333,0.615384615,32.81666667,10/16/2011,21,25,away,-4,NEP,300,270,77,67,16,20,Loss,77,101,2,3,4,DAL,36,377,371,2,3.6495385061482306,50.73608662118244,27.192812563665335,23.543274057517102
0.615384615,0.333333333,27.18333333,10/16/2011,25,21,home,4,DAL,270,300,35,69,20,16,Win,101,77,3,2,2,NEP,36,371,377,4,-3.6495385061482306,50.73608662118244,23.543274057517102,27.192812563665335
0.4,0.363636364,29.33333333,10/16/2011,15,22,away,-29,CHI,233,258,40,64,10,39,Loss,53,119,5,1,1,MIN,49,286,377,0,-1.2569206679587488,39.94570661184604,19.34439297194365,20.601313639902394
0.363636364,0.4,30.66666667,10/16/2011,22,15,home,29,MIN,258,233,15,60,39,10,Win,119,53,1,5,0,CHI,49,377,286,1,1.2569206679587488,39.94570661184604,20.601313639902394,19.34439297194365
0.153846154,0.4,29.65,10/17/2011,17,13,away,-18,NYJ,190,192,10,63,6,24,Loss,118,104,4,2,1,MIA,30,308,296,3,3.275763900376683,36.34151896617576,19.80864143327622,16.53287753289954
0.4,0.153846154,30.35,10/17/2011,13,17,home,18,MIA,192,190,49,56,24,6,Win,104,118,2,4,3,NYJ,30,296,308,1,-3.275763900376683,36.34151896617576,16.53287753289954,19.80864143327622
0.538461538,0.2,37.96666667,10/23/2011,29,11,away,34,TEN,296,95,68,70,41,7,Win,222,53,0,2,2,HOU,48,518,148,0,-5.208196995015868,45.19612794800484,19.993965476494488,25.202162471510356
0.2,0.538461538,22.03333333,10/23/2011,11,29,home,-34,HOU,95,296,76,48,7,41,Loss,53,222,2,0,0,TEN,48,148,518,2,5.208196995015868,45.19612794800484,25.202162471510356,19.993965476494488
0.307692308,0.28571428600000004,33.2,10/23/2011,19,16,away,6,TBB,218,250,54,67,24,18,Win,177,30,2,1,4,CHI,42,395,280,2,-10.392912277724005,42.29105948687579,15.949073604575894,26.341985882299895
0.28571428600000004,0.307692308,26.8,10/23/2011,16,19,home,-6,CHI,250,218,69,64,18,24,Loss,30,177,1,2,2,TBB,42,280,395,4,10.392912277724005,42.29105948687579,26.341985882299895,15.949073604575892
0.166666667,0.5,17.06666667,10/23/2011,9,20,away,-3,CLE,69,159,68,50,3,6,Loss,68,139,4,4,1,SEA,9,137,298,2,-9.702975171437494,23.275323481983236,6.786174155272871,16.489149326710365
0.5,0.166666667,42.93333333,10/23/2011,20,9,home,3,SEA,159,69,48,84,6,3,Win,139,68,4,4,2,CLE,9,298,137,1,9.702975171437494,23.275323481983236,16.489149326710365,6.786174155272871
0.5,0.615384615,27.23333333,10/23/2011,16,25,away,-6,NYJ,172,156,95,58,21,27,Loss,96,162,1,2,2,LAC,48,268,318,2,-6.470377074567711,45.551101397440256,19.54036216143627,26.010739236003985
0.615384615,0.5,32.76666667,10/23/2011,25,16,home,6,LAC,156,172,60,66,27,21,Win,162,96,2,1,2,NYJ,48,318,268,2,6.470377074567711,45.551101397440256,26.010739236003985,19.54036216143627
0.41666666700000005,0.41666666700000005,24.5,10/23/2011,22,20,away,-13,CAR,261,232,26,63,20,33,Loss,92,175,3,4,0,WAS,53,353,407,3,-9.388750833249489,49.6188005868333,20.115024876791907,29.503775710041396
0.41666666700000005,0.41666666700000005,35.5,10/23/2011,20,22,home,13,WAS,232,261,105,64,33,20,Win,175,92,4,3,3,CAR,53,407,353,0,9.388750833249489,49.6188005868333,29.503775710041396,20.115024876791907
0.41176470600000004,0.083333333,34.95,10/23/2011,22,13,away,7,DET,199,159,80,69,23,16,Win,129,104,3,3,1,ATL,39,328,263,2,-2.6347451907122243,35.61170266297886,16.488478736133317,19.12322392684554
0.083333333,0.41176470600000004,25.05,10/23/2011,13,22,home,-7,ATL,159,199,84,55,16,23,Loss,104,129,3,3,2,DET,39,263,328,1,2.6347451907122243,35.61170266297886,19.12322392684554,16.488478736133317
0.25,0.214285714,34.28333333,10/23/2011,18,15,away,3,MIA,131,173,30,73,3,0,Win,177,94,6,4,1,DEN,3,308,267,1,-5.2103610143017285,25.414355425110188,10.10199720540423,15.312358219705958
0.214285714,0.25,33.31666667,10/23/2011,15,18,home,-3,DEN,173,131,20,68,0,3,Loss,94,177,4,6,1,MIA,3,267,308,1,5.2103610143017285,25.414355425110188,15.312358219705958,10.10199720540423
0.5,0.375,35.78333333,10/23/2011,26,23,away,12,ARI,354,257,69,69,32,20,Win,91,73,2,2,1,PIT,52,445,330,0,3.5085778327809924,49.638409118147095,26.573493475464044,23.06491564268305
0.375,0.5,24.21666667,10/23/2011,23,26,home,-12,PIT,257,354,74,55,20,32,Loss,73,91,2,2,0,ARI,52,330,445,1,-3.5085778327809924,49.638409118147095,23.06491564268305,26.573493475464044
0.46666666700000003,0.307692308,33.61666667,10/23/2011,22,18,away,28,OAK,161,167,98,69,28,0,Win,139,155,0,1,6,KCC,28,300,322,2,-11.406395112007656,49.57777706324842,19.08569097562038,30.49208608762804
0.307692308,0.46666666700000003,26.38333333,10/23/2011,18,22,home,-28,KCC,167,161,120,63,0,28,Loss,155,139,1,0,2,OAK,28,322,300,6,11.406395112007656,49.57777706324842,30.49208608762804,19.08569097562038
0.25,0.5625,32.1,10/23/2011,25,22,away,6,MIN,307,217,44,60,33,27,Win,114,218,4,2,2,GBP,60,421,435,1,4.030786352109304,56.38915247378297,30.209969412946137,26.179183060836834
0.5625,0.25,27.9,10/23/2011,22,25,home,-6,GBP,217,307,91,65,27,33,Loss,218,114,2,4,1,MIN,60,435,421,2,-4.030786352109304,56.38915247378297,26.179183060836834,30.209969412946137
0.384615385,0.375,26.06666667,10/23/2011,13,24,away,-27,DAL,195,151,16,55,7,34,Loss,70,294,1,2,1,LAR,41,265,445,2,2.144222170878596,43.07324710817666,22.608734639527626,20.464512468649033
0.375,0.384615385,33.93333333,10/23/2011,24,13,home,27,LAR,151,195,30,60,34,7,Win,294,70,2,1,2,DAL,41,445,265,1,-2.144222170878596,43.07324710817666,20.464512468649033,22.608734639527626
0.363636364,0.75,21.68333333,10/23/2011,11,36,away,-55,NOS,97,321,49,46,7,62,Loss,155,236,1,2,0,IND,69,252,557,3,7.144872475136118,55.31598988948037,31.230431182308244,24.085558707172126
0.75,0.363636364,38.31666667,10/23/2011,36,11,home,55,IND,321,97,10,75,62,7,Win,236,155,2,1,3,NOS,69,557,252,0,-7.144872475136118,55.31598988948037,24.085558707172126,31.230431182308244
0.166666667,0.125,23.75,10/24/2011,11,13,away,-5,JAX,112,73,85,53,7,12,Loss,34,132,3,4,1,BAL,19,146,205,2,-3.464914980820355,21.007054538887495,8.77106977903357,12.235984759853924
0.125,0.166666667,36.25,10/24/2011,13,11,home,5,BAL,73,112,90,66,12,7,Win,132,34,4,3,2,JAX,19,205,146,1,3.464914980820355,21.007054538887495,12.235984759853924,8.77106977903357
0.181818182,0.363636364,30.3,10/30/2011,17,30,away,-3,BAL,98,298,92,57,27,30,Loss,109,107,6,3,2,ARI,57,207,405,1,-0.38668983898111264,37.9267962090008,18.770053185009843,19.156743023990956
0.363636364,0.181818182,29.7,10/30/2011,30,17,home,3,ARI,298,98,99,80,30,27,Win,107,109,3,6,1,BAL,57,405,207,2,0.38668983898111264,37.9267962090008,19.156743023990956,18.770053185009843
0.470588235,0.3125,28.61666667,10/30/2011,19,21,away,-10,LAR,227,140,32,70,21,31,Loss,56,183,6,4,1,NOS,52,283,323,2,-10.066230059414105,38.19518274355933,14.064476342072613,24.130706401486716
0.3125,0.470588235,31.38333333,10/30/2011,21,19,home,10,NOS,140,227,64,72,31,21,Win,183,56,4,6,2,LAR,52,323,283,1,10.066230059414105,38.19518274355933,24.130706401486716,14.064476342072613
0.5,0.5,32.08333333,10/30/2011,22,21,away,3,CAR,229,265,43,65,24,21,Win,132,140,4,3,2,MIN,45,361,405,1,-6.594128284461899,52.18666454555628,22.79626813054719,29.390396415009093
0.5,0.5,27.91666667,10/30/2011,21,22,home,-3,MIN,265,229,60,65,21,24,Loss,140,132,3,4,1,CAR,45,405,361,2,6.594128284461899,52.18666454555628,29.390396415009093,22.79626813054719
0.352941176,0.41176470600000004,28.53333333,10/30/2011,22,17,away,-17,TEN,241,215,66,77,10,27,Loss,158,96,2,1,0,IND,37,399,311,2,-14.16370327072403,42.612320158628656,14.224308443952314,28.38801171467634
0.41176470600000004,0.352941176,31.46666667,10/30/2011,17,22,home,17,IND,215,241,40,65,27,10,Win,96,158,1,2,2,TEN,37,311,399,0,14.16370327072403,42.612320158628656,28.38801171467634,14.224308443952314
0.384615385,0.5,27.56666667,10/30/2011,18,21,away,-3,NYG,101,344,30,53,17,20,Loss,145,58,5,1,0,MIA,37,246,402,1,0.2845816761458977,42.30176124226011,21.293171459203005,21.008589783057108
0.5,0.384615385,32.43333333,10/30/2011,21,18,home,3,MIA,344,101,46,69,20,17,Win,58,145,1,5,1,NYG,37,402,246,0,-0.2845816761458977,42.30176124226011,21.008589783057108,21.293171459203005
0.35714285700000004,0.588235294,24.68333333,10/30/2011,13,20,away,-10,HOU,90,202,39,58,14,24,Loss,84,156,1,2,2,JAX,38,174,358,2,-14.242294567588717,39.01190202864566,12.384803730528471,26.627098298117186
0.588235294,0.35714285700000004,35.31666667,10/30/2011,20,13,home,10,JAX,202,90,60,71,24,14,Win,156,84,2,1,2,HOU,38,358,174,2,14.242294567588717,39.01190202864566,26.627098298117186,12.384803730528471
0.333333333,0.14285714300000002,29.56666667,10/30/2011,21,19,away,35,DEN,263,117,45,62,45,10,Win,113,195,2,7,3,DET,55,376,312,0,-2.5926482139720157,41.10327037207138,19.255311079049683,21.847959293021695
0.14285714300000002,0.333333333,30.43333333,10/30/2011,19,21,home,-35,DET,117,263,55,76,10,45,Loss,195,113,7,2,0,DEN,55,312,376,3,2.5926482139720157,41.10327037207138,21.847959293021695,19.255311079049683
0.28571428600000004,0.5,25.15,10/30/2011,10,17,away,-23,BUF,152,252,59,54,0,23,Loss,26,138,10,2,2,WAS,23,178,390,2,-2.5132448134786216,36.49841890887987,16.992587047700624,19.505831861179246
0.5,0.28571428600000004,34.85,10/30/2011,17,10,home,23,WAS,252,152,35,62,23,0,Win,138,26,2,10,2,BUF,23,390,178,2,2.5132448134786216,36.49841890887987,19.505831861179246,16.992587047700624
0.428571429,0.333333333,31.45,10/30/2011,18,20,away,22,SEA,160,350,65,57,34,12,Win,92,61,1,4,2,CIN,46,252,411,2,1.2580602786263586,42.64492232218036,21.95149130040336,20.693431021777002
0.333333333,0.428571429,28.55,10/30/2011,20,18,home,-22,CIN,350,160,80,71,12,34,Loss,61,92,4,1,2,SEA,46,411,252,2,-1.2580602786263586,42.64492232218036,20.693431021777002,21.95149130040336
0.428571429,0.4,27.13333333,10/30/2011,18,19,away,-10,SFO,224,174,39,61,10,20,Loss,66,174,4,1,0,CLE,30,290,348,2,-1.881786558276751,37.086678846695634,17.60244614420944,19.484232702486192
0.4,0.428571429,32.86666667,10/30/2011,19,18,home,10,CLE,174,224,40,64,20,10,Win,174,66,1,4,2,SFO,30,348,290,0,1.881786558276751,37.086678846695634,19.484232702486192,17.60244614420944
0.3,0.625,20.63333333,10/30/2011,19,29,away,-8,PIT,170,329,37,50,17,25,Loss,43,98,3,5,1,NEP,42,213,427,0,10.50491999015877,43.24367420653268,26.874297098345725,16.369377108186956
0.625,0.3,39.36666667,10/30/2011,29,19,home,8,NEP,329,170,50,78,25,17,Win,98,43,5,3,0,PIT,42,427,213,1,-10.50491999015877,43.24367420653268,16.369377108186956,26.874297098345725
0.3,0.583333333,17.85,10/30/2011,12,31,away,-27,PHI,182,256,20,49,7,34,Loss,85,239,4,4,0,DAL,41,267,495,1,7.4220050997008755,47.583869242546236,27.502937171123556,20.08093207142268
0.583333333,0.3,42.15,10/30/2011,31,12,home,27,DAL,256,182,33,70,34,7,Win,239,85,4,4,1,PHI,41,495,267,0,-7.4220050997008755,47.583869242546236,20.08093207142268,27.502937171123556
0.35714285700000004,0.5,37.48333333,10/31/2011,22,19,away,-3,KCC,345,247,105,71,0,3,Loss,102,94,3,3,4,LAC,3,447,341,4,-7.066698224767039,46.956085501209344,19.944693638221153,27.01139186298819
0.5,0.35714285700000004,32.25,10/31/2011,19,22,home,3,LAC,247,345,53,67,3,0,Win,94,102,3,3,4,KCC,3,341,447,4,7.066698224767039,46.956085501209344,27.01139186298819,19.944693638221153
0.2,0.428571429,30.55,11/6/2011,18,18,away,-10,DAL,219,279,88,61,13,23,Loss,162,163,1,0,1,SEA,36,381,442,3,-0.8112019017707848,46.39688191526757,22.792840006748392,23.60404190851918
0.428571429,0.2,29.45,11/6/2011,18,18,home,10,SEA,279,219,82,60,23,13,Win,163,162,0,1,3,DAL,36,442,381,1,0.8112019017707848,46.39688191526757,23.60404190851918,22.792840006748392
0.428571429,0.28571428600000004,37.76666667,11/6/2011,21,10,away,24,IND,269,103,10,66,31,7,Win,163,83,1,2,2,ATL,38,432,186,1,0.5940106136651693,36.013195703293725,18.303603158479447,17.709592544814278
0.28571428600000004,0.428571429,22.23333333,11/6/2011,10,21,home,-24,ATL,103,269,32,56,7,31,Loss,83,163,2,1,1,IND,38,186,432,2,-0.5940106136651693,36.013195703293725,17.709592544814278,18.303603158479447
0.545454545,0.272727273,37.86666667,11/6/2011,24,14,away,16,BUF,222,191,60,68,27,11,Win,126,96,1,0,3,NYJ,38,348,287,2,-1.3333148705926927,47.56887556687193,23.11778034813962,24.451095218732313
0.272727273,0.545454545,22.13333333,11/6/2011,14,24,home,-16,NYJ,191,222,84,53,11,27,Loss,96,126,0,1,2,BUF,38,287,348,3,1.3333148705926927,47.56887556687193,24.451095218732313,23.11778034813962
0.333333333,0.642857143,24.75,11/6/2011,10,21,away,-18,HOU,128,119,35,47,12,30,Loss,44,261,4,0,1,CLE,42,172,380,2,0.365064475525827,36.77180170291384,18.568433089219834,18.203368613694007
0.642857143,0.333333333,35.25,11/6/2011,21,10,home,18,CLE,119,128,15,63,30,12,Win,261,44,0,4,2,HOU,42,380,172,1,-0.365064475525827,36.77180170291384,18.203368613694007,18.568433089219834
0.25,0.41666666700000005,32.31666667,11/6/2011,15,17,away,8,WAS,188,251,55,58,19,11,Win,138,52,2,2,3,SFO,30,326,303,1,-4.033918661666679,37.67924504976942,16.822663194051373,20.856581855718048
0.41666666700000005,0.25,27.68333333,11/6/2011,17,15,home,-8,SFO,251,188,35,63,11,19,Loss,52,138,2,2,1,WAS,30,303,326,3,4.033918661666679,37.67924504976942,20.856581855718048,16.822663194051373
0.166666667,0.5,29.93333333,11/6/2011,18,25,away,-11,NOS,281,258,80,58,16,27,Loss,84,195,1,0,1,TBB,43,365,453,0,-1.1301934937313511,48.17333085929276,23.521568682780703,24.651762176512058
0.5,0.166666667,30.06666667,11/6/2011,25,18,home,11,TBB,258,281,63,64,27,16,Win,195,84,0,1,0,NOS,43,453,365,1,1.1301934937313511,48.17333085929276,24.651762176512058,23.521568682780703
0.3,0.4,25.35,11/6/2011,17,20,away,28,KCC,244,227,49,47,31,3,Win,107,116,0,5,0,MIA,34,351,343,0,-2.224190914669636,37.6926430217527,17.734226053541533,19.958416968211168
0.4,0.3,34.65,11/6/2011,20,17,home,-28,MIA,227,244,70,78,3,31,Loss,116,107,5,0,0,KCC,34,343,351,0,2.224190914669636,37.6926430217527,19.958416968211168,17.734226053541533
0.5,0.35714285700000004,32.91666667,11/6/2011,20,19,away,7,TEN,210,250,87,70,24,17,Win,109,78,1,2,1,CIN,41,319,328,0,-11.815738512344192,41.45936865041507,14.821815069035441,26.63755358137963
0.35714285700000004,0.5,27.08333333,11/6/2011,19,20,home,-7,CIN,250,210,100,63,17,24,Loss,78,109,2,1,0,TEN,41,328,319,1,11.815738512344192,41.45936865041507,26.63755358137963,14.821815069035441
0.25,0.333333333,31.85,11/6/2011,20,21,away,14,OAK,113,316,93,62,38,24,Win,299,100,1,2,3,DEN,62,412,416,0,-4.339863024096349,54.37571244476845,25.017924710336054,29.3577877344324
0.333333333,0.25,28.15,11/6/2011,21,20,home,-14,DEN,316,113,130,63,24,38,Loss,100,299,2,1,0,OAK,62,416,412,3,4.339863024096349,54.37571244476845,29.3577877344324,25.017924710336054
0.28571428600000004,0.333333333,30.28333333,11/6/2011,23,23,away,4,NEP,250,332,50,68,24,20,Win,111,106,0,2,4,NYG,44,361,438,2,0.30675470687736883,52.15442585490433,26.23059028089085,25.92383557401348
0.333333333,0.28571428600000004,29.71666667,11/6/2011,23,23,home,-4,NYG,332,250,81,75,20,24,Loss,106,111,2,0,2,NEP,44,438,361,4,-0.30675470687736883,52.15442585490433,25.92383557401348,26.23059028089085
0.214285714,0.2,36.96666667,11/6/2011,23,16,away,-6,ARI,233,192,71,75,0,6,Loss,150,70,4,3,0,LAR,6,383,262,1,-3.8369999320591113,33.9570611209478,15.060030594444342,18.897030526503457
0.2,0.214285714,24.98333333,11/6/2011,16,23,home,6,LAR,192,233,45,55,6,0,Win,70,150,3,4,1,ARI,6,262,383,0,3.8369999320591113,33.9570611209478,18.897030526503457,15.060030594444344
0.6,0.454545455,29.75,11/6/2011,21,28,away,7,LAC,232,375,33,56,45,38,Win,136,85,4,2,3,GBP,83,368,460,0,4.6471251542573135,57.84150875217549,31.244316953216405,26.597191798959088
0.454545455,0.6,30.25,11/6/2011,28,21,home,-7,GBP,375,232,64,69,38,45,Loss,85,136,2,4,0,LAC,83,460,368,3,-4.6471251542573135,57.84150875217549,26.597191798959088,31.244316953216405
0.666666667,0.583333333,33.98333333,11/6/2011,23,20,away,3,PIT,289,322,20,77,23,20,Win,67,70,3,1,2,BAL,43,356,392,1,-1.5344878235978823,49.668452435396546,24.06698230589933,25.601470129497216
0.583333333,0.666666667,26.01666667,11/6/2011,20,23,home,-3,BAL,322,289,69,58,20,23,Loss,70,67,1,3,1,PIT,43,392,356,2,1.5344878235978823,49.668452435396546,25.601470129497216,24.06698230589933
0.5,0.571428571,33.45,11/7/2011,22,20,away,6,PHI,208,211,53,66,30,24,Win,164,119,0,1,2,CHI,54,372,330,2,-3.9851573760395658,50.83036487768163,23.422603750821033,27.4077611268606
0.571428571,0.5,26.55,11/7/2011,20,22,home,-6,CHI,211,208,44,63,24,30,Loss,119,164,1,0,2,PHI,54,330,372,2,3.9851573760395658,50.83036487768163,27.4077611268606,23.422603750821033
0.4,0.3125,32.61666667,11/10/2011,20,20,away,7,LAC,298,239,45,63,24,17,Win,191,75,1,6,2,OAK,41,489,314,2,-3.4956377677807957,51.1525585791176,23.8284604056684,27.3240981734492
0.3125,0.4,27.38333333,11/10/2011,20,20,home,-7,OAK,239,298,31,68,17,24,Loss,75,191,6,1,2,LAC,41,314,489,2,3.4956377677807957,51.1525585791176,27.3240981734492,23.8284604056684
0.307692308,0.3125,30.05,11/13/2011,18,30,away,3,ATL,322,343,79,59,3,0,Win,41,138,0,1,1,NOS,3,363,481,0,-7.366430135539062,43.83382032461156,18.233695094536248,25.60012523007531
0.3125,0.307692308,36.53333333,11/13/2011,30,18,home,-3,NOS,343,322,85,85,0,3,Loss,138,41,1,0,0,ATL,3,481,363,1,7.366430135539062,43.83382032461156,25.60012523007531,18.233695094536248
0.3,0.23076923100000002,35.1,11/13/2011,21,12,away,28,TBB,235,141,54,60,37,9,Win,185,90,1,4,4,HOU,46,420,231,0,-3.5742193731126335,40.01389935005592,18.219839988471644,21.794059361584278
0.23076923100000002,0.3,24.9,11/13/2011,12,21,home,-28,HOU,141,235,49,57,9,37,Loss,90,185,4,1,0,TBB,46,231,420,4,3.5742193731126335,40.01389935005592,21.794059361584278,18.219839988471644
0.333333333,0.35714285700000004,27.55,11/13/2011,17,16,away,1,CLE,148,209,55,58,13,12,Win,133,126,1,2,1,LAR,25,281,335,2,-2.475042889402074,37.55432239655748,17.539639753577703,20.01468264297978
0.35714285700000004,0.333333333,32.45,11/13/2011,16,17,home,-1,LAR,209,148,60,59,12,13,Loss,126,133,2,1,2,CLE,25,335,281,1,2.475042889402074,37.55432239655748,20.01468264297978,17.539639753577703
0.41666666700000005,0.363636364,33.88333333,11/13/2011,24,14,away,7,CIN,223,170,31,68,24,17,Win,105,109,5,0,2,PIT,41,328,279,1,4.082417955074645,39.18823914174811,21.63532854841138,17.552910593336733
0.363636364,0.41666666700000005,26.11666667,11/13/2011,14,24,home,-7,PIT,170,223,35,56,17,24,Loss,109,105,0,5,1,CIN,41,279,328,2,-4.082417955074645,39.18823914174811,17.552910593336733,21.63532854841138
0.384615385,0.571428571,26.45,11/13/2011,16,20,away,-11,MIA,185,200,51,51,9,20,Loss,61,103,3,2,2,WAS,29,246,303,2,-0.9282965337367877,39.92780741857463,19.499755442418923,20.428051976155707
0.571428571,0.384615385,33.55,11/13/2011,20,16,home,11,WAS,200,185,55,64,20,9,Win,103,61,2,3,2,MIA,29,303,246,2,0.9282965337367877,39.92780741857463,20.428051976155707,19.499755442418923
0.23076923100000002,0.214285714,32.6,11/13/2011,22,16,away,27,CAR,211,166,92,63,30,3,Win,172,113,1,5,2,TEN,33,383,279,1,-10.925644817180878,42.604040903363696,15.839198043091407,26.76484286027229
0.214285714,0.23076923100000002,27.4,11/13/2011,16,22,home,-27,TEN,166,211,99,64,3,30,Loss,113,172,5,1,1,CAR,33,279,383,2,10.925644817180878,42.604040903363696,26.76484286027229,15.83919804309141
0.375,0.2,31.7,11/13/2011,23,15,away,4,PHI,282,123,66,73,21,17,Win,88,166,4,2,2,ARI,38,370,289,2,-3.5908798660300163,41.22087796715806,18.814999050564023,22.405878916594038
0.2,0.375,28.3,11/13/2011,15,23,home,-4,ARI,123,282,97,60,17,21,Loss,166,88,2,4,2,PHI,38,289,370,2,3.5908798660300163,41.22087796715806,22.405878916594038,18.814999050564023
0.35714285700000004,0.181818182,33.63333333,11/13/2011,16,17,away,7,KCC,69,124,65,63,17,10,Win,244,134,0,4,0,DEN,27,313,258,0,-3.383619866064942,30.160202660871526,13.388291397403293,16.771911263468233
0.181818182,0.35714285700000004,26.36666667,11/13/2011,17,16,home,-7,DEN,124,69,40,62,10,17,Loss,134,244,4,0,0,KCC,27,258,313,0,3.383619866064942,30.160202660871526,16.771911263468233,13.388291397403293
0.4,0.26666666699999997,35.35,11/13/2011,18,13,away,14,IND,110,128,55,64,17,3,Win,141,84,2,5,3,JAX,20,251,212,1,-3.2916050064570275,33.71239033436855,15.210392663955762,18.501997670412788
0.26666666699999997,0.4,24.65,11/13/2011,13,18,home,-14,JAX,128,110,40,57,3,17,Loss,84,141,5,2,1,IND,20,212,251,3,3.2916050064570275,33.71239033436855,18.501997670412788,15.210392663955762
0.28571428600000004,0.666666667,25.46666667,11/13/2011,20,24,away,-37,DAL,136,270,12,49,7,44,Loss,135,163,1,0,0,BUF,51,271,433,4,8.353723353572796,51.161010176233084,29.75736676490294,21.403643411330144
0.666666667,0.28571428600000004,34.53333333,11/13/2011,24,20,home,37,BUF,270,136,74,61,44,7,Win,163,135,0,1,4,DAL,51,433,271,0,-8.353723353572796,51.161010176233084,21.403643411330144,29.75736676490294
0.41666666700000005,0.3125,24.98333333,11/13/2011,25,16,away,-5,SEA,248,208,34,66,17,22,Loss,75,119,1,1,0,BAL,39,323,327,3,-1.3186949692809389,39.3550307347617,19.01816788274038,20.33686285202132
0.3125,0.41666666700000005,35.01666667,11/13/2011,16,25,home,5,BAL,208,248,100,70,22,17,Win,119,75,1,1,3,SEA,39,327,323,0,1.3186949692809389,39.3550307347617,20.33686285202132,19.01816788274038
0.235294118,0.23076923100000002,30.9,11/13/2011,22,12,away,-24,CHI,313,107,53,84,13,37,Loss,80,109,2,2,1,DET,50,393,216,6,-10.164764966147763,38.782457459236625,14.30884624654443,24.473611212692195
0.23076923100000002,0.235294118,29.1,11/13/2011,12,22,home,24,DET,107,313,37,57,37,13,Win,109,80,2,2,6,CHI,50,216,393,1,10.164764966147763,38.782457459236625,24.473611212692195,14.30884624654443
0.5,0.272727273,34.6,11/13/2011,21,16,away,-7,SFO,302,228,45,70,20,27,Loss,93,77,1,2,1,NYG,47,395,305,2,0.2733093329091876,45.376591885890576,22.82495060939988,22.551641276490695
0.272727273,0.5,25.4,11/13/2011,16,21,home,7,NYG,228,302,35,52,27,20,Win,77,93,2,1,2,SFO,47,305,395,1,-0.2733093329091876,45.376591885890576,22.551641276490695,22.82495060939988
0.307692308,0.384615385,30.11666667,11/13/2011,21,22,away,21,NYJ,329,268,80,67,37,16,Win,60,110,0,5,3,NEP,53,389,378,0,2.778236194163183,47.495879257198155,25.13705772568067,22.358821531517485
0.384615385,0.307692308,29.88333333,11/13/2011,22,21,home,-21,NEP,268,329,56,69,16,37,Loss,110,60,5,0,0,NYJ,53,378,389,3,-2.778236194163183,47.495879257198155,22.358821531517485,25.13705772568067
0.35714285700000004,0.538461538,26.7,11/14/2011,14,23,away,-38,GBP,162,266,80,59,7,45,Loss,104,90,3,3,1,MIN,52,266,356,1,-0.55910584209483,42.470642326556344,20.955768242230757,21.514874084325587
0.538461538,0.35714285700000004,33.3,11/14/2011,23,14,home,38,MIN,266,162,5,66,45,7,Win,90,104,3,3,1,GBP,52,356,266,1,0.55910584209483,42.470642326556344,21.514874084325587,20.955768242230757
0.214285714,0.23076923100000002,32.2,11/17/2011,22,11,away,-4,DEN,235,104,15,71,13,17,Loss,83,125,3,1,1,NYJ,30,318,229,2,0.3546795921964403,34.46091958747252,17.40779958983448,17.05311999763804
0.23076923100000002,0.214285714,27.8,11/17/2011,11,22,home,4,NYJ,104,235,51,56,17,13,Win,125,83,1,3,2,DEN,30,229,318,1,-0.3546795921964403,34.46091958747252,17.05311999763804,17.40779958983448
0.0,0.41666666700000005,28.9,11/20/2011,14,16,away,-27,MIA,204,147,27,65,8,35,Loss,41,95,2,1,0,BUF,43,245,242,2,0.612414959548282,29.068186468776716,14.840300714162499,14.227885754614217
0.41666666700000005,0.0,31.1,11/20/2011,16,14,home,27,BUF,147,204,50,56,35,8,Win,95,41,1,2,2,MIA,43,242,245,0,-0.612414959548282,29.068186468776716,14.227885754614217,14.840300714162499
0.333333333,0.35714285700000004,32.88333333,11/20/2011,23,13,away,-7,BAL,364,268,43,78,24,31,Loss,119,105,2,1,1,CIN,55,483,373,3,1.4916895637875793,47.54828923686339,24.519989400325485,23.028299836537904
0.35714285700000004,0.333333333,27.11666667,11/20/2011,13,23,home,7,CIN,268,364,69,56,31,24,Win,105,119,1,2,3,BAL,55,373,483,1,-1.4916895637875793,47.54828923686339,23.028299836537904,24.519989400325485
0.46666666700000003,0.4,30.88333333,11/20/2011,23,20,away,-4,CLE,195,186,81,71,10,14,Loss,108,148,1,2,1,JAX,24,303,334,0,-6.732295584259475,41.768046912755736,17.51787566424813,24.250171248507606
0.4,0.46666666700000003,29.11666667,11/20/2011,20,23,home,4,JAX,186,195,70,54,14,10,Win,148,108,2,1,0,CLE,24,334,303,1,6.732295584259475,41.768046912755736,24.250171248507606,17.51787566424813
0.470588235,0.4,36.01666667,11/20/2011,20,18,away,3,WAS,264,279,48,73,3,0,Win,89,60,4,3,2,DAL,3,353,339,0,-14.360703113831693,34.44209808930972,10.04069748773901,24.401400601570707
0.4,0.470588235,33.33333333,11/20/2011,18,20,home,-3,DAL,279,264,59,65,0,3,Loss,60,89,3,4,0,WAS,3,339,353,2,14.360703113831693,34.44209808930972,24.401400601570707,10.040697487739012
0.454545455,0.583333333,31.35,11/20/2011,22,24,away,-9,GBP,334,287,55,60,26,35,Loss,121,91,2,2,1,TBB,61,455,378,2,4.002647912529623,57.866451068268006,30.934549490398815,26.93190157786919
0.583333333,0.454545455,28.65,11/20/2011,24,22,home,9,TBB,287,334,37,59,35,26,Win,91,121,2,2,2,GBP,61,378,455,1,-4.002647912529623,57.866451068268006,26.93190157786919,30.934549490398815
0.3,0.545454545,26.88333333,11/20/2011,24,29,away,-14,DET,272,326,70,65,35,49,Loss,137,169,1,2,3,CAR,84,409,495,4,-0.6543429894199218,66.13051180946111,32.7380844100206,33.392427399440514
0.545454545,0.3,33.11666667,11/20/2011,29,24,home,14,CAR,326,272,56,67,49,35,Win,169,137,2,1,4,DET,84,495,409,3,0.6543429894199218,66.13051180946111,33.392427399440514,32.7380844100206
0.35714285700000004,0.4,35.73333333,11/20/2011,22,20,away,6,MIN,139,187,117,68,27,21,Win,162,124,4,5,5,OAK,48,301,311,1,-5.699525360540774,48.187896182867604,21.244185411163414,26.94371077170419
0.4,0.35714285700000004,24.26666667,11/20/2011,20,22,home,-6,OAK,187,139,50,62,21,27,Loss,124,162,5,4,1,MIN,48,311,301,5,5.699525360540774,48.187896182867604,26.94371077170419,21.244185411163414
0.111111111,0.380952381,15.73333333,11/20/2011,11,25,away,-16,SFO,149,267,75,48,7,23,Loss,80,164,2,0,1,ARI,30,229,431,5,-7.45819589392449,38.94214523353972,15.741974669807615,23.200170563732105
0.380952381,0.111111111,44.26666667,11/20/2011,25,11,home,16,ARI,267,149,87,87,23,7,Win,164,80,0,2,5,SFO,30,431,229,1,7.45819589392449,38.94214523353972,23.200170563732105,15.741974669807615
0.41176470600000004,0.333333333,35.0,11/20/2011,16,13,away,17,LAR,163,143,100,68,24,7,Win,126,42,4,5,3,SEA,31,289,185,2,-9.612675393600178,31.85610857849629,11.121716592448056,20.734391986048234
0.333333333,0.41176470600000004,25.0,11/20/2011,13,16,home,-17,SEA,143,163,50,62,7,24,Loss,42,126,5,4,2,LAR,31,185,289,3,9.612675393600178,31.85610857849629,20.734391986048234,11.121716592448056
0.571428571,0.333333333,23.01666667,11/20/2011,17,25,away,-6,ATL,257,316,86,59,17,23,Loss,41,116,1,0,1,TEN,40,298,432,1,-6.422414910240493,47.09683541090481,20.33721025033216,26.75962516057265
0.333333333,0.571428571,36.98333333,11/20/2011,25,17,home,6,TEN,316,257,55,68,23,17,Win,116,41,0,1,1,ATL,40,432,298,1,6.422414910240493,47.09683541090481,26.75962516057265,20.33721025033216
0.454545455,0.571428571,26.83333333,11/20/2011,15,23,away,-11,CHI,280,286,20,48,20,31,Loss,52,92,0,0,1,LAC,51,332,378,3,2.963861036702486,50.10380231020425,26.53383167345337,23.56997063675088
0.571428571,0.454545455,33.16666667,11/20/2011,23,15,home,11,LAC,286,280,61,64,31,20,Win,92,52,0,0,3,CHI,51,378,332,1,-2.963861036702486,50.10380231020425,23.56997063675088,26.53383167345337
0.529411765,0.35714285700000004,36.3,11/20/2011,17,12,away,7,NYG,255,249,30,70,17,10,Win,136,29,1,3,2,PHI,27,391,278,3,-2.363580137497002,46.25478464667638,21.945602254589687,24.30918239208669
0.35714285700000004,0.529411765,23.7,11/20/2011,12,17,home,-7,PHI,249,255,39,55,10,17,Loss,29,136,3,1,3,NYG,27,278,391,2,2.363580137497002,46.25478464667638,24.30918239208669,21.945602254589687
0.428571429,0.307692308,31.5,11/21/2011,16,20,away,-31,NEP,209,223,34,67,3,34,Loss,125,157,3,3,1,KCC,37,334,380,3,5.1093433193658875,40.284201995435396,22.696772657400643,17.587429338034752
0.307692308,0.428571429,28.5,11/21/2011,20,16,home,31,KCC,223,209,20,65,34,3,Win,157,125,3,3,3,NEP,37,380,334,1,-5.1093433193658875,40.284201995435396,17.587429338034752,22.696772657400643
0.2,0.5,29.2,11/24/2011,18,23,away,12,DET,296,273,54,53,27,15,Win,53,136,2,1,3,GBP,42,349,409,0,4.765479937966688,51.83505134081241,28.30026563938955,23.534785701422862
0.5,0.2,30.8,11/24/2011,23,18,home,-12,GBP,273,296,82,67,15,27,Loss,136,53,1,2,0,DET,42,409,349,3,-4.765479937966688,51.83505134081241,23.534785701422862,28.30026563938955
0.25,0.222222222,31.46666667,11/24/2011,18,19,away,-1,DAL,263,218,55,61,19,20,Loss,89,85,4,1,2,MIA,39,352,303,1,3.268052500435303,38.41410972831758,20.84108111437644,17.573028613941137
0.222222222,0.25,28.53333333,11/24/2011,19,18,home,1,MIA,218,263,69,58,20,19,Win,85,89,1,4,1,DAL,39,303,352,2,-3.268052500435303,38.41410972831758,17.573028613941137,20.84108111437644
0.166666667,0.46666666700000003,28.86666667,11/24/2011,12,16,away,-10,BAL,96,161,97,54,6,16,Loss,74,92,9,0,0,SFO,22,170,253,1,5.798088630291218,24.850920321516192,15.324504475903705,9.526415845612487
0.46666666700000003,0.166666667,31.13333333,11/24/2011,16,12,home,10,SFO,161,96,20,58,16,6,Win,92,74,0,9,1,BAL,22,253,170,0,-5.798088630291218,24.850920321516192,9.526415845612487,15.324504475903705
0.5,0.111111111,36.28333333,11/27/2011,22,17,away,8,IND,176,218,92,65,27,19,Win,201,105,3,2,2,CAR,46,377,323,1,0.7222648111906036,46.606597074990866,23.664430943090736,22.94216613190013
0.111111111,0.5,23.71666667,11/27/2011,17,22,home,-8,CAR,218,176,15,54,19,27,Loss,105,201,2,3,1,IND,46,323,377,2,-0.7222648111906036,46.606597074990866,22.94216613190013,23.664430943090736
0.2,0.41176470600000004,26.61666667,11/27/2011,15,18,away,-6,TEN,186,150,30,60,17,23,Loss,122,202,2,2,4,TBB,40,308,352,5,-9.569342818781065,43.481171743604804,16.95591446241187,26.525257281192935
0.41176470600000004,0.2,33.38333333,11/27/2011,18,15,home,6,TBB,150,186,50,71,23,17,Win,202,122,2,2,5,TEN,40,352,308,4,9.569342818781065,43.481171743604804,26.525257281192935,16.95591446241187
0.133333333,0.263157895,28.35,11/27/2011,9,14,away,7,JAX,127,150,80,59,20,13,Win,88,105,0,7,1,HOU,33,215,255,1,-15.985264274065965,25.047765932586138,4.531250829260088,20.51651510332605
0.263157895,0.133333333,31.65,11/27/2011,14,9,home,-7,HOU,150,127,30,71,13,20,Loss,105,88,7,0,1,JAX,33,255,215,1,15.985264274065965,25.047765932586138,20.51651510332605,4.531250829260086
0.333333333,0.23076923100000002,33.98333333,11/27/2011,16,12,away,3,LAR,106,186,30,64,23,20,Win,268,86,3,2,2,ARI,43,374,272,3,-2.1650786992931286,36.32581161875605,17.08036645973146,19.245445159024587
0.23076923100000002,0.333333333,26.01666667,11/27/2011,12,16,home,-3,ARI,186,106,49,56,20,23,Loss,86,268,2,3,3,LAR,43,272,374,2,2.1650786992931286,36.32581161875605,19.245445159024587,17.08036645973146
0.4,0.454545455,36.18333333,11/27/2011,21,20,away,-4,NYJ,250,180,85,70,24,28,Loss,86,138,3,0,2,BUF,52,336,318,0,-4.472281883276894,45.14428550705885,20.336001811890977,24.80828369516787
0.454545455,0.4,23.81666667,11/27/2011,20,21,home,4,BUF,180,250,40,58,28,24,Win,138,86,0,3,0,NYJ,52,318,336,2,4.472281883276894,45.14428550705885,24.80828369516787,20.336001811890977
0.4,0.428571429,28.43333333,11/27/2011,17,18,away,-3,CIN,140,257,15,66,20,23,Loss,134,132,2,2,1,CLE,43,274,389,1,-2.995801446345758,36.515452793296916,16.75982567347558,19.755627119821337
0.428571429,0.4,31.56666667,11/27/2011,18,17,home,3,CLE,257,140,35,65,23,20,Win,132,134,2,2,1,CIN,43,389,274,1,2.995801446345758,36.515452793296916,19.755627119821337,16.75982567347558
0.307692308,0.5,25.35,11/27/2011,12,22,away,-10,ATL,162,246,49,53,14,24,Loss,64,89,4,2,1,MIN,38,226,335,0,1.1270958453605893,34.40219318336963,17.76464451436511,16.637548669004524
0.5,0.307692308,34.65,11/27/2011,22,12,home,10,MIN,246,162,30,65,24,14,Win,89,64,2,4,0,ATL,38,335,226,1,-1.1270958453605893,34.40219318336963,16.637548669004524,17.76464451436511
0.3,0.375,33.33333333,11/27/2011,22,15,away,6,SEA,306,126,115,65,23,17,Win,110,124,1,2,1,WAS,40,416,250,2,-9.492826310510303,39.9820879317162,15.244630810602949,24.737457121113252
0.375,0.3,26.66666667,11/27/2011,15,22,home,-6,WAS,126,306,91,62,17,23,Loss,124,110,2,1,2,SEA,40,250,416,1,9.492826310510303,39.9820879317162,24.737457121113252,15.244630810602949
0.428571429,0.2,29.96666667,11/27/2011,18,17,away,-5,OAK,229,268,61,67,20,25,Loss,172,73,4,4,1,CHI,45,401,341,3,-10.166322512020887,46.0596680299503,17.94667275896471,28.112995270985593
0.2,0.428571429,30.03333333,11/27/2011,17,18,home,5,CHI,268,229,44,68,25,20,Win,73,172,4,4,3,OAK,45,341,401,1,10.166322512020887,46.0596680299503,28.112995270985593,17.94667275896471
0.545454545,0.307692308,32.71666667,11/27/2011,29,23,away,18,PHI,353,393,20,71,38,20,Win,104,73,1,2,1,NEP,58,457,466,0,9.756578655000132,57.5686299993953,33.66260432719771,23.906025672197583
0.307692308,0.545454545,27.28333333,11/27/2011,23,29,home,-18,NEP,393,353,60,67,20,38,Loss,73,104,2,1,0,PHI,58,466,457,1,-9.756578655000132,57.5686299993953,23.906025672197586,33.66260432719771
0.3125,0.352941176,37.13333333,11/27/2011,18,20,away,3,LAC,141,159,63,70,3,0,Win,208,185,1,3,0,DEN,3,349,344,0,-13.095361265593741,27.856513197656795,7.380575966031529,20.475937231625267
0.352941176,0.3125,37.38333333,11/27/2011,20,18,home,-3,DEN,159,141,30,75,0,3,Loss,185,208,3,1,0,LAC,3,344,349,0,13.095361265593741,27.856513197656795,20.475937231625267,7.380575966031527
0.272727273,0.4,33.5,11/27/2011,18,15,away,4,KCC,182,162,50,60,13,9,Win,108,90,1,1,4,PIT,22,290,252,2,0.6302920451473062,36.26663886493162,18.448465455039464,17.818173409892157
0.4,0.272727273,26.5,11/27/2011,15,18,home,-4,PIT,162,182,20,63,9,13,Loss,90,108,1,1,2,KCC,22,252,290,4,-0.6302920451473062,36.26663886493162,17.818173409892157,18.448465455039464
0.454545455,0.5555555560000001,31.46666667,11/28/2011,29,31,away,-25,NOS,392,372,32,70,24,49,Loss,73,205,1,0,0,NYG,73,465,577,2,-0.8235110032899087,68.59912375061072,33.8878063736604,34.71131737695031
0.5555555560000001,0.454545455,28.53333333,11/28/2011,31,29,home,25,NYG,372,392,104,69,49,24,Win,205,73,0,1,2,NOS,73,577,465,0,0.8235110032899087,68.59912375061072,34.71131737695031,33.8878063736604
0.25,0.41666666700000005,29.66666667,12/1/2011,20,15,away,-17,SEA,198,173,28,56,14,31,Loss,132,174,2,3,0,PHI,45,330,347,4,15.612479032016566,44.43308975225927,30.02278439213792,14.410305360121352
0.41666666700000005,0.25,30.33333333,12/1/2011,15,20,home,17,PHI,173,198,30,52,31,14,Win,174,132,3,2,4,SEA,45,347,330,0,-15.612479032016566,44.43308975225927,14.410305360121352,30.02278439213792
0.307692308,0.3125,32.2,12/4/2011,16,17,away,15,WAS,165,204,40,62,34,19,Win,101,100,0,2,3,NYJ,53,266,304,1,-12.222663128090401,35.12307809567761,11.450207483793605,23.672870611884008
0.3125,0.307692308,27.8,12/4/2011,17,16,home,-15,NYJ,204,165,50,71,19,34,Loss,100,101,2,0,1,WAS,53,304,266,3,12.222663128090401,35.12307809567761,23.672870611884008,11.450207483793605
0.428571429,0.5,24.93333333,12/4/2011,18,20,away,-7,HOU,267,175,43,65,10,17,Loss,70,162,0,3,1,ATL,27,337,337,2,-11.918690549905088,41.42437135057504,14.752840400334978,26.671530950240065
0.5,0.428571429,35.06666667,12/4/2011,20,18,home,7,ATL,175,267,35,72,17,10,Win,162,70,3,0,2,HOU,27,337,337,1,11.918690549905088,41.42437135057504,26.671530950240065,14.752840400334978
0.35,0.0,32.7,12/4/2011,13,11,away,7,CHI,139,88,60,70,10,3,Win,113,93,2,7,3,KCC,13,252,181,1,-6.359138689591784,22.534822761137328,8.087842035772772,14.446980725364556
0.0,0.35,27.3,12/4/2011,11,13,home,-7,KCC,88,139,35,55,3,10,Loss,93,113,7,2,1,CHI,13,181,252,3,6.359138689591784,22.534822761137328,14.446980725364556,8.087842035772772
0.181818182,0.4375,28.23333333,12/4/2011,18,18,away,6,BUF,130,282,20,57,23,17,Win,187,104,1,1,2,TEN,40,317,386,0,-3.2918472720341465,41.43234994565861,19.07025133681223,22.362098608846377
0.4375,0.181818182,31.76666667,12/4/2011,18,18,home,-6,TEN,282,130,15,70,17,23,Loss,104,187,1,1,0,BUF,40,386,317,2,3.2918472720341465,41.43234994565861,22.362098608846377,19.07025133681223
0.181818182,0.2,27.26666667,12/4/2011,13,22,away,-28,PIT,128,159,109,55,7,35,Loss,104,136,3,3,0,CIN,42,232,295,2,7.446358332675983,31.949665653392508,19.698011993034246,12.251653660358262
0.2,0.181818182,32.73333333,12/4/2011,22,13,home,28,CIN,159,128,29,59,35,7,Win,136,104,3,3,2,PIT,42,295,232,0,-7.446358332675983,31.949665653392508,12.251653660358262,19.698011993034246
0.545454545,0.384615385,32.68333333,12/4/2011,26,15,away,19,TBB,222,207,20,63,38,19,Win,163,78,2,2,1,CAR,57,385,285,0,-5.933567219439222,45.77223111137342,19.9193319459671,25.85289916540632
0.384615385,0.545454545,27.31666667,12/4/2011,15,26,home,-19,CAR,207,222,73,56,19,38,Loss,78,163,2,2,0,TBB,57,285,385,1,5.933567219439222,45.77223111137342,25.85289916540632,19.9193319459671
0.181818182,0.571428571,21.66666667,12/4/2011,18,23,away,-20,MIA,258,153,91,57,14,34,Loss,46,209,2,1,0,OAK,48,304,362,1,-7.168706266984557,44.85678675016064,18.84404024158804,26.012746508572597
0.571428571,0.181818182,38.33333333,12/4/2011,23,18,home,20,OAK,153,258,79,70,34,14,Win,209,46,1,2,1,MIA,48,362,304,0,7.168706266984557,44.85678675016064,26.012746508572597,18.84404024158804
0.272727273,0.4,22.15,12/4/2011,13,27,away,3,MIN,186,360,73,49,35,32,Win,150,129,2,3,3,DEN,67,336,489,2,0.5898969464114359,52.266206383833925,26.42805166512268,25.838154718711245
0.4,0.272727273,37.85,12/4/2011,27,13,home,-3,DEN,360,186,54,81,32,35,Loss,129,150,3,2,2,MIN,67,489,336,3,-0.5898969464114359,52.266206383833925,25.838154718711245,26.42805166512268
0.666666667,0.545454545,35.65,12/4/2011,26,24,away,-7,NEP,338,289,29,70,24,31,Loss,99,73,2,1,0,IND,55,437,362,2,8.326035736131548,55.024438180189165,31.675236958160355,23.34920122202881
0.545454545,0.666666667,24.35,12/4/2011,24,26,home,7,IND,289,338,20,63,31,24,Win,73,99,1,2,2,NEP,55,362,437,0,-8.326035736131548,55.024438180189165,23.34920122202881,31.675236958160355
0.473684211,0.214285714,37.56666667,12/4/2011,24,13,away,14,CLE,158,174,18,79,24,10,Win,290,59,1,3,1,BAL,34,448,233,1,-2.181483569928929,34.45609799700868,16.137307213539877,18.318790783468806
0.214285714,0.473684211,22.43333333,12/4/2011,13,24,home,-14,BAL,174,158,37,56,10,24,Loss,59,290,3,1,1,CLE,34,233,448,1,2.181483569928929,34.45609799700868,18.318790783468806,16.137307213539877
0.583333333,0.454545455,33.05,12/4/2011,29,24,away,3,NYG,360,347,30,77,38,35,Win,89,100,2,1,2,GBP,73,449,447,1,-1.0928569280184681,62.97056568138012,30.93885437668083,32.03171130469929
0.454545455,0.583333333,26.95,12/4/2011,24,29,home,-3,GBP,347,360,55,61,35,38,Loss,100,89,1,2,1,NYG,73,447,449,2,1.0928569280184681,62.97056568138012,32.0317113046993,30.938854376680826
0.333333333,0.307692308,33.7,12/4/2011,20,16,away,-6,ARI,261,224,49,67,0,6,Loss,75,103,5,5,0,DAL,6,336,327,0,0.9679988541607769,32.62147193159345,16.79473539287711,15.826736538716336
0.307692308,0.333333333,29.58333333,12/4/2011,16,20,home,6,DAL,224,261,41,55,6,0,Win,103,75,5,5,0,ARI,6,327,336,0,-0.9679988541607769,32.62147193159345,15.826736538716336,16.79473539287711
0.23076923100000002,0.28571428600000004,23.91666667,12/4/2011,10,18,away,-26,SFO,126,245,35,49,0,26,Loss,31,144,4,4,0,LAR,26,157,389,2,1.325385478190391,32.0241761388713,16.674780808530844,15.349395330340453
0.28571428600000004,0.23076923100000002,36.08333333,12/4/2011,18,10,home,26,LAR,245,126,72,63,26,0,Win,144,31,4,4,2,SFO,26,389,157,0,-1.325385478190391,32.0241761388713,15.349395330340453,16.674780808530844
0.181818182,0.5,35.1,12/4/2011,25,21,away,-14,NOS,379,338,107,69,17,31,Loss,87,100,3,2,0,DET,48,466,438,1,2.1168258601152825,54.03772719162174,28.077276525868513,25.96045066575323
0.5,0.181818182,24.9,12/4/2011,21,25,home,14,DET,338,379,30,61,31,17,Win,100,87,2,3,1,NOS,48,438,466,0,-2.1168258601152825,54.03772719162174,25.96045066575323,28.077276525868513
0.4,0.5625,28.28333333,12/5/2011,19,17,away,24,JAX,294,177,55,54,38,14,Win,139,129,0,2,1,LAC,52,433,306,0,-4.911940742598281,45.404261485744705,20.24616037157321,25.158101114171494
0.5625,0.4,31.71666667,12/5/2011,17,19,home,-24,LAC,177,294,26,66,14,38,Loss,129,139,2,0,0,JAX,52,306,433,1,4.911940742598281,45.404261485744705,25.158101114171494,20.24616037157321
0.4375,0.25,32.3,12/8/2011,19,20,away,-11,PIT,206,269,54,69,3,14,Loss,98,147,3,2,3,CLE,17,304,416,2,1.4300086483640477,44.94711160753258,23.188560127948314,21.758551479584263
0.25,0.4375,27.7,12/8/2011,20,19,home,11,CLE,269,206,97,53,14,3,Win,147,98,2,3,2,PIT,17,416,304,3,-1.4300086483640477,44.94711160753258,21.758551479584263,23.188560127948314
0.470588235,0.384615385,30.71666667,12/11/2011,18,19,away,8,CAR,308,259,50,69,31,23,Win,86,157,3,2,2,ATL,54,394,416,0,-10.200867451346827,47.003368704798255,18.401250626725712,28.602118078072543
0.384615385,0.470588235,29.28333333,12/11/2011,19,18,home,-8,ATL,259,308,50,64,23,31,Loss,157,86,2,3,0,CAR,54,416,394,2,10.200867451346827,47.003368704798255,28.602118078072543,18.401250626725712
0.272727273,0.333333333,27.18333333,12/11/2011,15,21,away,-27,JAX,170,209,97,59,14,41,Loss,110,116,3,1,2,TBB,55,280,325,7,-8.938701437778747,45.62053222540446,18.340915393812857,27.279616831591603
0.333333333,0.272727273,32.81666667,12/11/2011,21,15,home,27,TBB,209,170,80,67,41,14,Win,116,110,1,3,7,JAX,55,325,280,2,8.938701437778747,45.62053222540446,27.279616831591603,18.340915393812857
0.5625,0.384615385,31.73333333,12/11/2011,25,16,away,1,CIN,268,184,50,77,20,19,Win,144,101,5,1,2,HOU,39,412,285,4,-4.338980257530366,48.66705450072192,22.164037121595776,26.503017379126142
0.384615385,0.5625,28.26666667,12/11/2011,16,25,home,-1,HOU,184,268,27,58,19,20,Loss,101,144,1,5,4,CIN,39,285,412,2,4.338980257530366,48.66705450072192,26.503017379126142,22.164037121595776
0.571428571,0.5,28.76666667,12/11/2011,29,13,away,-6,DET,156,208,37,83,28,34,Loss,269,72,4,5,0,MIN,62,425,280,6,-7.879408890249286,49.88060224165915,21.00059667570493,28.880005565954217
0.5,0.571428571,31.23333333,12/11/2011,13,29,home,6,MIN,208,156,76,55,34,28,Win,72,269,5,4,6,DET,62,280,425,0,7.879408890249286,49.88060224165915,28.880005565954217,21.00059667570493
0.454545455,0.5,23.85,12/11/2011,22,25,away,7,WAS,352,293,47,58,34,27,Win,79,170,1,2,2,NEP,61,431,463,1,4.807467892385226,55.743799322360964,30.275633607373095,25.46816571498787
0.5,0.454545455,36.15,12/11/2011,25,22,home,-7,NEP,293,352,73,69,27,34,Loss,170,79,2,1,1,WAS,61,463,431,2,-4.807467892385226,55.743799322360964,25.46816571498787,30.275633607373095
0.166666667,0.333333333,22.3,12/11/2011,13,24,away,-27,NYJ,156,155,128,58,10,37,Loss,65,159,5,3,1,KCC,47,221,314,1,-2.026266989010285,33.292285735766896,15.633009373378307,17.65927636238859
0.333333333,0.166666667,37.7,12/11/2011,24,13,home,27,KCC,155,156,22,66,37,10,Win,159,65,3,5,1,NYJ,47,314,221,1,2.026266989010285,33.292285735766896,17.65927636238859,15.633009373378306
0.578947368,0.1,37.55,12/11/2011,24,17,away,5,TEN,323,314,95,75,22,17,Win,114,59,2,2,0,NOS,39,437,373,0,-5.378500809819025,46.79376042471668,20.70762980744883,26.08613061726785
0.1,0.578947368,22.45,12/11/2011,17,24,home,-5,NOS,314,323,54,55,17,22,Loss,59,114,2,2,0,TEN,39,373,437,0,5.378500809819025,46.79376042471668,26.08613061726785,20.70762980744883
0.14285714300000002,0.538461538,23.86666667,12/11/2011,12,24,away,-14,BAL,117,212,15,57,10,24,Loss,50,146,4,2,2,IND,34,167,358,1,4.495434493494091,33.877401576656126,19.186418035075107,14.690983541581017
0.538461538,0.14285714300000002,36.13333333,12/11/2011,24,12,home,14,IND,212,117,40,70,24,10,Win,146,50,2,4,1,BAL,34,358,167,2,-4.495434493494091,33.877401576656126,14.69098354158102,19.186418035075107
0.26666666699999997,0.2,31.35,12/11/2011,18,11,away,16,MIA,188,95,69,66,26,10,Win,51,109,4,9,3,PHI,36,239,204,2,-2.93843739936953,29.728260629060955,13.39491161484571,16.333349014215244
0.2,0.26666666699999997,28.65,12/11/2011,11,18,home,-16,PHI,95,188,81,64,10,26,Loss,109,51,9,4,2,MIA,36,204,239,3,2.93843739936953,29.728260629060955,16.333349014215244,13.394911614845713
0.133333333,0.294117647,31.78333333,12/11/2011,12,20,away,-3,DEN,86,221,69,61,0,3,Loss,159,124,4,5,2,CHI,3,245,345,1,-9.649797261478874,28.382391858403516,9.366297298462321,19.016094559941195
0.294117647,0.133333333,34.65,12/11/2011,20,12,home,3,CHI,221,86,28,79,3,0,Win,124,159,5,4,1,DEN,3,345,245,2,9.649797261478874,28.382391858403516,19.016094559941195,9.366297298462321
0.176470588,0.214285714,30.93333333,12/11/2011,12,12,away,-2,ARI,143,270,35,63,19,21,Loss,90,55,5,2,3,SFO,40,233,325,0,2.138842883655879,27.754177527463057,14.946510205559468,12.807667321903589
0.214285714,0.176470588,29.06666667,12/11/2011,12,12,home,2,SFO,270,143,45,54,21,19,Win,55,90,2,5,0,ARI,40,325,233,3,-2.138842883655879,27.754177527463057,12.807667321903589,14.946510205559468
0.384615385,0.272727273,31.33333333,12/11/2011,23,22,away,-30,GBP,240,255,89,73,16,46,Loss,117,136,1,4,1,OAK,62,357,391,5,-1.2182469393911823,55.740666852969085,27.261209956788953,28.47945689618013
0.272727273,0.384615385,28.66666667,12/11/2011,22,23,home,30,OAK,255,240,35,60,46,16,Win,136,117,4,1,5,GBP,62,391,357,1,1.2182469393911823,55.740666852969085,28.47945689618013,27.261209956788953
0.363636364,0.571428571,24.45,12/11/2011,17,23,away,-27,LAC,185,216,5,58,10,37,Loss,96,150,1,2,1,BUF,47,281,366,3,-0.38713784256890627,45.195844335527354,22.404353246479225,22.79149108904813
0.571428571,0.363636364,35.55,12/11/2011,23,17,home,27,BUF,216,185,50,67,37,10,Win,150,96,2,1,3,LAC,47,366,281,1,0.38713784256890627,45.195844335527354,22.79149108904813,22.404353246479225
0.428571429,0.5,34.31666667,12/11/2011,28,23,away,3,DAL,400,305,55,78,37,34,Win,110,139,0,3,1,NYG,71,510,444,1,-4.55525303938668,59.120857120707555,27.28280204066044,31.838055080047116
0.5,0.428571429,25.68333333,12/11/2011,23,28,home,-3,NYG,305,400,51,58,34,37,Loss,139,110,3,0,1,DAL,71,444,510,1,4.55525303938668,59.120857120707555,31.838055080047116,27.28280204066044
0.214285714,0.5,28.51666667,12/12/2011,19,21,away,-17,SEA,167,214,30,63,13,30,Loss,114,145,3,2,1,LAR,43,281,359,1,-3.979104301136439,38.75552388036272,17.388209789613143,21.36731409074958
0.5,0.214285714,31.48333333,12/12/2011,21,19,home,17,LAR,214,167,61,68,30,13,Win,145,114,2,3,1,SEA,43,359,281,1,3.979104301136439,38.75552388036272,21.36731409074958,17.388209789613143
0.3,0.4,21.48333333,12/15/2011,12,20,away,-27,ATL,91,276,40,46,14,41,Loss,116,97,5,1,0,JAX,55,207,373,4,2.521026318430625,37.74536940410508,20.133197861267853,17.612171542837224
0.4,0.3,38.51666667,12/15/2011,20,12,home,27,JAX,276,91,31,68,41,14,Win,97,116,1,5,4,ATL,55,373,207,0,-2.521026318430625,37.74536940410508,17.612171542837224,20.133197861267853
0.538461538,0.41666666700000005,37.98333333,12/17/2011,28,7,away,16,TBB,239,132,15,69,31,15,Win,160,58,2,3,1,DAL,46,399,190,1,-0.38312658495497054,38.17696262028846,18.896918017666742,19.280044602621714
0.41666666700000005,0.538461538,22.01666667,12/17/2011,7,28,home,-16,DAL,132,239,46,43,15,31,Loss,58,160,3,2,1,TBB,46,190,399,1,0.38312658495497054,38.17696262028846,19.280044602621714,18.896918017666742
0.375,0.3,31.61666667,12/18/2011,18,13,away,24,CHI,226,89,36,65,38,14,Win,60,132,1,4,5,SEA,52,286,221,1,-1.9710335117490985,34.00275712863658,16.01586180844374,17.98689532019284
0.3,0.375,28.38333333,12/18/2011,13,18,home,-24,SEA,89,226,45,60,14,38,Loss,132,60,4,1,1,CHI,52,221,286,5,1.9710335117490985,34.00275712863658,17.98689532019284,16.01586180844374
0.727272727,0.28571428600000004,38.81666667,12/18/2011,36,12,away,22,MIN,412,102,65,79,42,20,Win,161,105,0,4,1,NOS,62,573,207,2,-3.07906391522193,52.95627097604674,24.938603530412404,28.017667445634334
0.28571428600000004,0.727272727,21.18333333,12/18/2011,12,36,home,-22,NOS,102,412,84,54,20,42,Loss,105,161,4,0,2,MIN,62,207,573,1,3.07906391522193,52.95627097604674,28.017667445634334,24.938603530412404
0.533333333,0.333333333,35.0,12/18/2011,19,22,away,13,NYG,177,233,48,65,23,10,Win,123,91,1,3,3,WAS,33,300,324,2,-7.08851152070551,46.06858129362528,19.490034886459885,26.578546407165394
0.333333333,0.533333333,25.0,12/18/2011,22,19,home,-13,WAS,233,177,75,61,10,23,Loss,91,123,3,1,2,NYG,33,324,300,3,7.08851152070551,46.06858129362528,26.578546407165394,19.490034886459885
0.23076923100000002,0.0,28.81666667,12/18/2011,17,21,away,7,BUF,194,291,62,60,30,23,Win,254,113,2,3,3,MIA,53,448,404,3,1.3681159691800238,48.115609067824174,24.7418625185021,23.373746549322075
0.0,0.23076923100000002,31.18333333,12/18/2011,21,17,home,-7,MIA,291,194,92,69,23,30,Loss,113,254,3,2,3,BUF,53,404,448,3,-1.3681159691800238,48.115609067824174,23.373746549322075,24.7418625185021
0.428571429,0.333333333,23.81666667,12/18/2011,16,23,away,-5,KCC,213,299,37,57,14,19,Loss,102,139,4,0,0,GBP,33,315,438,0,-0.809667301005728,43.623409107145676,21.406870903069972,22.216538204075704
0.333333333,0.428571429,36.18333333,12/18/2011,23,16,home,5,GBP,299,213,55,70,19,14,Win,139,102,0,4,0,KCC,33,438,315,0,0.809667301005728,43.623409107145676,22.216538204075704,21.406870903069972
0.375,0.25,31.95,12/18/2011,21,10,away,-14,IND,322,82,70,76,13,27,Loss,66,205,1,0,1,TEN,40,388,287,3,-7.165928185582739,41.013003154160934,16.9235374842891,24.089465669871835
0.25,0.375,28.05,12/18/2011,10,21,home,14,TEN,82,322,25,51,27,13,Win,205,66,0,1,3,IND,40,287,388,1,7.165928185582739,41.013003154160934,24.089465669871835,16.9235374842891
0.642857143,0.222222222,32.56666667,12/18/2011,20,18,away,15,HOU,150,208,40,60,28,13,Win,166,150,2,2,3,CAR,41,316,358,0,-4.730293129452244,47.6457006317733,21.45770375116053,26.187996880612772
0.222222222,0.642857143,27.43333333,12/18/2011,18,20,home,-15,CAR,208,150,60,57,13,28,Loss,150,166,2,2,0,HOU,41,358,316,3,4.730293129452244,47.6457006317733,26.187996880612772,21.45770375116053
0.272727273,0.153846154,30.05,12/18/2011,19,18,away,7,LAR,173,210,101,61,20,13,Win,110,95,1,3,0,CIN,33,283,305,1,-4.7928895186019655,35.65361329272134,15.430361887059686,20.223251405661653
0.153846154,0.272727273,29.95,12/18/2011,18,19,home,-7,CIN,210,173,109,63,13,20,Loss,95,110,3,1,1,LAR,33,305,283,0,4.7928895186019655,35.65361329272134,20.223251405661653,15.430361887059686
0.470588235,0.111111111,28.45,12/18/2011,25,26,away,1,OAK,375,345,72,73,28,27,Win,57,132,2,3,1,DET,55,432,477,1,-4.166619154880575,59.34585134521451,27.589616095166967,31.756235250047546
0.111111111,0.470588235,31.55,12/18/2011,26,25,home,-1,DET,345,375,86,65,27,28,Loss,132,57,3,2,1,OAK,55,477,432,1,4.166619154880575,59.34585134521451,31.756235250047546,27.589616095166967
0.35714285700000004,0.5,31.36666667,12/18/2011,16,24,away,-3,ARI,213,289,74,62,0,3,Loss,120,74,2,4,1,CLE,3,333,363,1,-6.004484019552554,36.77495705762061,15.385236519034027,21.389720538586584
0.5,0.35714285700000004,32.7,12/18/2011,24,16,home,3,CLE,289,213,13,74,3,0,Win,74,120,4,2,1,ARI,3,363,333,1,6.004484019552554,36.77495705762061,21.38972053858658,15.385236519034029
0.23076923100000002,0.5,29.95,12/18/2011,13,20,away,-26,PHI,147,260,93,60,19,45,Loss,94,160,4,3,4,NYJ,64,241,420,4,3.8797794656135594,49.82511731279339,26.852448389203474,22.972668923589914
0.5,0.23076923100000002,30.05,12/18/2011,20,13,home,26,NYJ,260,147,62,58,45,19,Win,160,94,3,4,4,PHI,64,420,241,4,-3.8797794656135594,49.82511731279339,22.972668923589914,26.852448389203474
0.41666666700000005,0.4,33.68333333,12/18/2011,26,23,away,18,DEN,310,141,30,72,41,23,Win,141,252,2,4,3,NEP,64,451,393,0,13.246242287089904,53.15756608761578,33.20190418735284,19.955661900262935
0.4,0.41666666700000005,26.31666667,12/18/2011,23,26,home,-18,NEP,141,310,39,58,23,41,Loss,252,141,4,2,0,DEN,64,393,451,3,-13.246242287089904,53.15756608761578,19.95566190026294,33.20190418735284
0.583333333,0.6,25.8,12/18/2011,19,23,away,-20,LAC,201,270,25,56,14,34,Loss,89,145,7,0,0,BAL,48,290,415,2,9.038437882191637,47.297084978690705,28.16776143044117,19.129323548249534
0.6,0.583333333,34.2,12/18/2011,23,19,home,20,BAL,270,201,35,60,34,14,Win,145,89,0,7,2,LAC,48,415,290,0,-9.038437882191637,47.297084978690705,19.129323548249534,28.16776143044117
0.571428571,0.307692308,31.43333333,12/19/2011,20,17,away,-17,SFO,305,187,72,66,3,20,Loss,84,100,3,0,0,PIT,23,389,287,4,-3.3008105739917646,43.60794502263268,20.153567224320454,23.454377798312223
0.307692308,0.571428571,28.56666667,12/19/2011,17,20,home,17,PIT,187,305,49,61,20,3,Win,100,84,0,3,4,SFO,23,287,389,0,3.3008105739917646,43.60794502263268,23.454377798312223,20.153567224320454
0.1,0.41176470600000004,27.08333333,12/22/2011,14,24,away,-3,IND,112,225,84,51,16,19,Loss,171,95,4,3,1,HOU,35,283,320,1,-4.008984334157168,37.74125982156393,16.86613774370338,20.87512207786055
0.41176470600000004,0.1,32.91666667,12/22/2011,24,14,home,3,HOU,225,112,35,76,19,16,Win,95,171,3,4,1,IND,35,320,283,1,4.008984334157168,37.74125982156393,20.87512207786055,16.86613774370338
0.363636364,0.3,29.56666667,12/24/2011,20,23,away,7,WAS,148,256,40,58,33,26,Win,241,141,2,3,2,MIN,59,389,397,0,-3.7251499655857394,45.47490649011641,20.874878262265334,24.600028227851077
0.3,0.363636364,30.43333333,12/24/2011,23,20,home,-7,MIN,256,148,64,68,26,33,Loss,141,241,3,2,0,WAS,59,397,389,2,3.7251499655857394,45.47490649011641,24.600028227851077,20.874878262265334
0.28571428600000004,0.35714285700000004,28.35,12/24/2011,17,21,away,-7,CIN,257,136,87,67,16,23,Loss,59,165,5,2,2,ARI,39,316,301,3,-2.5500777518582005,38.446498269852185,17.948210258996994,20.49828801085519
0.35714285700000004,0.28571428600000004,31.65,12/24/2011,21,17,home,7,ARI,136,257,47,67,23,16,Win,165,59,2,5,3,CIN,39,301,316,2,2.5500777518582005,38.446498269852185,20.49828801085519,17.948210258996994
0.454545455,0.0,32.95,12/24/2011,23,20,away,-32,CAR,258,163,64,60,16,48,Loss,59,270,3,1,0,TBB,64,317,433,4,4.281945118086316,50.450965338784194,27.366455228435257,23.084510110348937
0.0,0.454545455,27.05,12/24/2011,20,23,home,32,TBB,163,258,77,49,48,16,Win,270,59,1,3,4,CAR,64,433,317,0,-4.281945118086316,50.450965338784194,23.084510110348937,27.366455228435257
0.26666666699999997,0.19047619,23.9,12/24/2011,11,22,away,15,NYJ,217,226,45,55,29,14,Win,115,105,2,5,3,NYG,43,332,331,1,-15.058791349585846,38.51397290488891,11.727590777651532,26.786382127237378
0.19047619,0.26666666699999997,36.1,12/24/2011,22,11,home,-15,NYG,226,217,95,89,14,29,Loss,105,115,5,2,1,NYJ,43,331,332,3,15.058791349585846,38.51397290488891,26.786382127237378,11.727590777651532
0.153846154,0.166666667,30.51666667,12/24/2011,18,14,away,-26,BUF,152,191,58,68,14,40,Loss,133,160,4,1,0,DEN,54,285,351,4,1.2549992751153276,38.40718308126965,19.831091178192487,18.576091903077163
0.166666667,0.153846154,29.48333333,12/24/2011,14,18,home,26,DEN,191,152,69,56,40,14,Win,160,133,1,4,4,BUF,54,351,285,0,-1.2549992751153276,38.40718308126965,18.576091903077163,19.831091178192487
0.27777777800000003,0.25,29.01666667,12/24/2011,18,20,away,-6,TEN,187,342,28,71,17,23,Loss,113,65,1,1,3,JAX,40,300,407,1,-8.307744152446066,43.135980787893494,17.414118317723712,25.721862470169782
0.25,0.27777777800000003,30.98333333,12/24/2011,20,18,home,6,JAX,342,187,0,66,23,17,Win,65,113,1,1,1,TEN,40,407,300,3,8.307744152446066,43.135980787893494,25.721862470169782,17.414118317723712
0.375,0.14285714300000002,30.75,12/24/2011,15,17,away,-27,PIT,68,208,21,63,0,27,Loss,164,169,3,0,1,LAR,27,232,377,0,2.040823362963235,34.046384404647064,18.04360388380515,16.002780520841913
0.14285714300000002,0.375,29.25,12/24/2011,17,15,home,27,LAR,208,68,50,50,27,0,Win,169,164,0,3,0,PIT,27,377,232,1,-2.040823362963235,34.046384404647064,16.002780520841913,18.04360388380515
0.384615385,0.470588235,29.06666667,12/24/2011,20,26,away,-3,NEP,253,281,39,65,24,27,Loss,121,119,5,4,0,MIA,51,374,400,2,0.22321802542914426,44.57579147052026,22.399504747974703,22.176286722545555
0.470588235,0.384615385,30.93333333,12/24/2011,26,20,home,3,MIA,281,253,50,81,27,24,Win,119,121,4,5,2,NEP,51,400,374,0,-0.22321802542914426,44.57579147052026,22.176286722545555,22.399504747974703
0.384615385,0.41176470600000004,27.7,12/24/2011,18,15,away,-6,BAL,139,122,95,60,14,20,Loss,117,162,2,1,1,CLE,34,256,284,1,-2.099148299792468,31.543840015030817,14.722345857619175,16.821494157411642
0.41176470600000004,0.384615385,32.3,12/24/2011,15,18,home,6,CLE,122,139,51,62,20,14,Win,162,117,1,2,1,BAL,34,284,256,1,2.099148299792468,31.543840015030817,16.821494157411642,14.722345857619175
0.272727273,0.25,29.56666667,12/24/2011,13,26,away,3,KCC,237,300,92,51,3,0,Win,71,135,0,0,2,OAK,3,308,435,2,0.5192179870890552,49.36219715175716,24.940707569423108,24.42148958233405
0.25,0.272727273,32.65,12/24/2011,26,13,home,-3,OAK,300,237,88,66,0,3,Loss,135,71,0,0,2,KCC,3,435,308,2,-0.5192179870890552,49.36219715175716,24.42148958233405,24.940707569423108
0.4,0.692307692,27.65,12/24/2011,20,24,away,-28,DET,299,353,10,70,10,38,Loss,68,87,0,3,0,LAC,48,367,440,2,-1.333835220892766,52.02500950821096,25.345587143659095,26.67942236455186
0.692307692,0.4,32.35,12/24/2011,24,20,home,28,LAC,353,299,8,62,38,10,Win,87,68,3,0,2,DET,48,440,367,0,1.333835220892766,52.02500950821096,26.67942236455186,25.345587143659095
0.384615385,0.352941176,27.61666667,12/24/2011,20,16,away,13,DAL,281,157,47,60,20,7,Win,105,81,2,3,0,PHI,27,386,238,1,-1.9396027779993164,38.216424434327195,18.138410828163938,20.078013606163257
0.352941176,0.384615385,32.38333333,12/24/2011,16,20,home,-13,PHI,157,281,47,66,7,20,Loss,81,105,3,2,1,DAL,27,238,386,0,1.9396027779993164,38.216424434327195,20.078013606163257,18.138410828163938
0.214285714,0.384615385,32.9,12/24/2011,21,14,away,2,SEA,171,141,77,68,19,17,Win,178,124,2,4,1,SFO,36,349,265,0,-2.367952215633794,32.62878054685415,15.13041416561018,17.498366381243972
0.384615385,0.214285714,27.1,12/24/2011,14,21,home,-2,SFO,141,171,51,58,17,19,Loss,124,178,4,2,0,SEA,36,265,349,1,2.367952215633794,32.62878054685415,17.498366381243972,15.13041416561018
0.5,0.5555555560000001,35.8,12/25/2011,24,19,away,-14,GBP,242,282,28,70,21,35,Loss,199,81,0,1,0,CHI,56,441,363,2,3.6810315150254276,53.592695120601185,28.636863317813308,24.955831802787877
0.5555555560000001,0.5,24.2,12/25/2011,19,24,home,14,CHI,282,242,0,51,35,21,Win,81,199,1,0,2,GBP,56,363,441,0,-3.6810315150254276,53.592695120601185,24.955831802787877,28.636863317813308
0.470588235,0.7692307690000001,33.31666667,12/26/2011,23,26,away,-29,NOS,434,299,57,75,16,45,Loss,35,164,0,1,2,ATL,61,469,463,1,-3.9658552848677076,59.385776951517485,27.70996083332489,31.675816118192596
0.7692307690000001,0.470588235,26.68333333,12/26/2011,26,23,home,29,ATL,299,434,46,63,45,16,Win,164,35,1,0,1,NOS,61,463,469,2,3.9658552848677076,59.385776951517485,31.675816118192596,27.70996083332489
0.363636364,0.533333333,28.88333333,1/1/2012,20,14,away,-2,MIA,245,128,40,62,17,19,Loss,129,82,2,1,2,NYJ,36,374,210,3,0.15100543177428594,41.562377509796306,20.856691470785297,20.70568603901101
0.533333333,0.363636364,31.11666667,1/1/2012,14,20,home,2,NYJ,128,245,35,59,19,17,Win,82,129,1,2,3,MIA,36,210,374,2,-0.15100543177428594,41.562377509796306,20.70568603901101,20.856691470785297
0.363636364,0.5,28.33333333,1/1/2012,32,27,away,-4,GBP,502,469,101,76,41,45,Loss,73,81,2,3,2,DET,86,575,550,4,-0.7927294995142979,76.09988831877821,37.65357940963196,38.44630890914625
0.5,0.363636364,31.66666667,1/1/2012,27,32,home,4,DET,469,502,78,71,45,41,Win,81,73,3,2,4,GBP,86,550,575,2,0.7927294995142979,76.09988831877821,38.44630890914625,37.65357940963196
0.0,0.666666667,25.43333333,1/1/2012,21,33,away,-28,NOS,137,409,5,51,17,45,Loss,164,208,2,0,1,CAR,62,301,617,2,7.928870292515732,60.13504408748202,34.03195718999888,26.103086897483145
0.666666667,0.0,34.56666667,1/1/2012,33,21,home,28,CAR,409,137,60,73,45,17,Win,208,164,0,2,2,NOS,62,617,301,1,-7.928870292515732,60.13504408748202,26.103086897483145,34.03195718999888
0.428571429,0.35714285700000004,25.36666667,1/1/2012,17,22,away,1,HOU,275,235,47,60,23,22,Win,86,152,3,3,1,TEN,45,361,387,1,-6.296498825384035,47.06816737913805,20.38583427687701,26.682333102261044
0.35714285700000004,0.428571429,34.63333333,1/1/2012,22,17,home,-1,TEN,235,275,55,65,22,23,Loss,152,86,3,3,1,HOU,45,387,361,1,6.296498825384035,47.06816737913805,26.682333102261044,20.38583427687701
0.384615385,0.2,28.76666667,1/1/2012,10,16,away,4,MIN,117,222,20,57,17,13,Win,92,79,7,2,3,CHI,30,209,301,3,-5.565164137900881,31.776632698395336,13.105734280247226,18.67089841814811
0.2,0.384615385,31.23333333,1/1/2012,16,10,home,-4,CHI,222,117,38,71,13,17,Loss,79,92,2,7,3,MIN,30,301,209,3,5.565164137900881,31.776632698395336,18.67089841814811,13.105734280247226
0.375,0.454545455,30.68333333,1/1/2012,21,24,away,-24,PHI,247,315,71,71,10,34,Loss,130,75,1,2,2,WAS,44,377,390,1,-5.125159047556572,51.41227650437729,23.14355872841036,28.26871777596693
0.454545455,0.375,29.31666667,1/1/2012,24,21,home,24,WAS,315,247,75,60,34,10,Win,75,130,2,1,1,PHI,44,390,377,2,5.125159047556572,51.41227650437729,28.26871777596693,23.14355872841036
0.375,0.333333333,35.13333333,1/1/2012,21,18,away,7,LAR,205,200,80,71,34,27,Win,116,111,3,3,2,SFO,61,321,311,0,-9.082129682544142,38.63261335285418,14.775241835155018,23.85737151769916
0.333333333,0.375,24.86666667,1/1/2012,18,21,home,-7,SFO,200,205,50,62,27,34,Loss,111,116,3,3,0,LAR,61,311,321,2,9.082129682544142,38.63261335285418,23.85737151769916,14.775241835155018
0.14285714300000002,0.5,30.36666667,1/1/2012,26,28,away,-28,NEP,296,342,45,68,21,49,Loss,106,138,2,4,1,BUF,70,402,480,4,10.814962351816746,58.00912873197857,34.412045541897655,23.597083190080912
0.5,0.14285714300000002,29.63333333,1/1/2012,28,26,home,28,BUF,342,296,77,69,49,21,Win,138,106,4,2,4,NEP,70,480,402,1,-10.814962351816746,58.00912873197857,23.597083190080916,34.412045541897655
0.428571429,0.384615385,29.2,1/1/2012,19,15,away,-6,JAX,242,71,40,65,13,19,Loss,56,190,3,3,1,IND,32,298,261,3,-1.1656877706954791,39.62958161349936,19.231946921401942,20.39763469209742
0.384615385,0.428571429,30.8,1/1/2012,15,19,home,6,IND,71,242,10,57,19,13,Win,190,56,3,3,3,JAX,32,261,298,1,1.1656877706954791,39.62958161349936,20.39763469209742,19.231946921401942
0.5,0.545454545,29.86666667,1/1/2012,18,22,away,-21,ATL,259,177,20,61,24,45,Loss,35,251,2,0,2,TBB,69,294,428,4,0.8761447872289203,48.99287582722946,24.93451030722919,24.058365520000272
0.545454545,0.5,30.13333333,1/1/2012,22,18,home,21,TBB,177,259,20,59,45,24,Win,251,35,0,2,4,ATL,69,428,294,2,-0.8761447872289203,48.99287582722946,24.058365520000272,24.93451030722919
0.384615385,0.470588235,29.43333333,1/1/2012,15,19,away,8,CIN,126,231,59,52,24,16,Win,221,105,1,1,1,BAL,40,347,336,0,3.8680459852655424,38.607091302077826,21.237568643671686,17.36952265840614
0.470588235,0.384615385,30.56666667,1/1/2012,19,15,home,-8,BAL,231,126,35,69,16,24,Loss,105,221,1,1,0,CIN,40,336,347,1,-3.8680459852655424,38.607091302077826,17.36952265840614,21.237568643671686
0.5,0.28571428600000004,39.18333333,1/1/2012,22,14,away,4,CLE,199,168,37,78,13,9,Win,161,72,2,2,1,PIT,22,360,240,2,-8.266037180052198,34.33576585546459,13.034864337706196,21.30090151775839
0.28571428600000004,0.5,20.81666667,1/1/2012,14,22,home,-4,PIT,168,199,40,58,9,13,Loss,72,161,2,2,2,CLE,22,240,360,1,8.266037180052198,34.33576585546459,21.30090151775839,13.034864337706194
0.333333333,0.27777777800000003,27.03333333,1/1/2012,14,16,away,4,DEN,175,50,36,60,7,3,Win,106,216,1,2,2,KCC,10,281,266,1,-6.607713711829323,31.184400815331266,12.28834355175097,18.896057263580296
0.27777777800000003,0.333333333,32.96666667,1/1/2012,16,14,home,-4,KCC,50,175,49,71,3,7,Loss,216,106,2,1,1,DEN,10,266,281,2,6.607713711829323,31.184400815331266,18.896057263580296,12.288343551750971
0.1875,0.41176470600000004,33.7,1/1/2012,19,20,away,-3,ARI,191,257,55,73,0,3,Loss,178,131,4,2,2,SEA,3,369,388,1,-9.7565962086506,33.77620785279798,12.009805822073691,21.76640203072429
0.41176470600000004,0.1875,35.31666667,1/1/2012,20,19,home,3,SEA,257,191,76,73,3,0,Win,131,178,2,4,1,ARI,3,388,369,2,9.7565962086506,33.77620785279798,21.76640203072429,12.009805822073691
0.7,0.615384615,30.45,1/1/2012,25,28,away,12,OAK,310,417,68,57,38,26,Win,153,103,0,0,1,LAC,64,463,520,1,-1.6647544908936325,69.99788629631837,34.16656590271237,35.831320393606
0.615384615,0.7,29.55,1/1/2012,28,25,home,-12,LAC,417,310,64,67,26,38,Loss,103,153,0,0,1,OAK,64,520,463,1,1.6647544908936325,69.99788629631837,35.831320393606,34.16656590271237
0.333333333,0.46666666700000003,25.45,1/1/2012,19,20,away,-17,NYG,251,331,43,59,14,31,Loss,49,106,6,2,0,DAL,45,300,437,2,-0.6290621470409974,45.41662124578139,22.393779549370198,23.022841696411195
0.46666666700000003,0.333333333,34.55,1/1/2012,20,19,home,17,DAL,331,251,28,66,31,14,Win,106,49,2,6,2,NYG,45,437,300,0,0.6290621470409974,45.41662124578139,23.022841696411195,22.393779549370198
0.46153846200000004,0.5,30.28333333,1/7/2012,21,19,away,-21,HOU,224,152,25,65,10,31,Loss,76,188,4,2,0,CIN,41,300,340,3,-0.8011073712729768,44.984119395810026,22.091506012268525,22.8926133835415
0.5,0.46153846200000004,29.71666667,1/7/2012,19,21,home,21,CIN,152,224,87,57,31,10,Win,188,76,2,4,3,HOU,41,340,300,0,0.8011073712729768,44.984119395810026,22.8926133835415,22.091506012268525
0.7,0.636363636,22.4,1/7/2012,22,34,away,-17,NOS,380,459,64,53,28,45,Loss,32,167,0,2,2,DET,73,412,626,2,3.699944344768972,72.03550425963164,37.8677243022003,34.167779957431335
0.636363636,0.7,37.6,1/7/2012,34,22,home,17,DET,459,380,18,81,45,28,Win,167,32,2,0,2,NOS,73,626,412,2,-3.699944344768972,72.03550425963164,34.167779957431335,37.8677243022003
0.28571428600000004,0.533333333,25.43333333,1/8/2012,14,19,away,-22,NYG,183,270,15,64,2,24,Loss,64,172,2,1,0,ATL,26,247,442,0,-8.280834813293096,37.92797058826154,14.82356788748422,23.104402700777317
0.533333333,0.28571428600000004,34.56666667,1/8/2012,19,14,home,22,ATL,270,183,73,64,24,2,Win,172,64,1,2,0,NYG,26,442,247,0,8.280834813293096,37.92797058826154,23.104402700777317,14.82356788748422
0.4375,0.3,31.1,1/8/2012,21,18,away,-6,DEN,244,316,61,68,0,6,Loss,156,131,5,0,1,PIT,6,400,447,1,4.865780378245446,49.792084844924915,27.32893261158518,22.463152233339734
0.3,0.4375,29.08333333,1/8/2012,18,21,home,6,PIT,316,244,30,55,6,0,Win,131,156,0,5,1,DEN,6,447,400,1,-4.865780378245446,49.792084844924915,22.463152233339734,27.32893261158518
0.35714285700000004,0.26666666699999997,31.33333333,1/14/2012,26,17,away,-4,SFO,435,264,0,80,32,36,Loss,37,143,3,4,1,NOS,68,472,407,5,-1.9899356036905687,50.546246340951456,24.278155368630443,26.268090972321012
0.26666666699999997,0.35714285700000004,28.66666667,1/14/2012,17,26,home,4,NOS,264,435,33,68,36,32,Win,143,37,4,3,5,SFO,68,407,472,1,1.9899356036905687,50.546246340951456,26.268090972321012,24.278155368630443
0.38888888899999996,0.5,33.38333333,1/14/2012,15,31,away,-35,NEP,108,363,55,71,10,45,Loss,144,146,5,0,2,DEN,55,252,509,1,7.719205434773372,49.23745584544137,28.47833064010737,20.759125205333998
0.5,0.38888888899999996,26.61666667,1/14/2012,31,15,home,35,DEN,363,108,20,64,45,10,Win,146,144,0,5,1,NEP,55,509,252,2,-7.719205434773372,49.23745584544137,20.759125205333998,28.47833064010737
0.333333333,0.25,28.66666667,1/15/2012,16,11,away,-7,BAL,184,140,20,63,13,20,Loss,131,87,0,5,0,HOU,33,315,227,4,-0.6144871356479076,30.729931175793418,15.057722020072756,15.672209155720662
0.25,0.333333333,31.33333333,1/15/2012,11,16,home,7,HOU,140,184,0,63,20,13,Win,87,131,5,0,4,BAL,33,227,315,0,0.6144871356479076,30.729931175793418,15.672209155720662,15.057722020072756
0.5,0.5,29.58333333,1/15/2012,19,25,away,17,GBP,325,241,30,61,37,20,Win,95,147,1,4,4,NYG,57,420,388,1,-0.6434851443804188,56.88335139843105,28.119933127025316,28.763418271405737
0.5,0.5,30.41666667,1/15/2012,25,19,home,-17,NYG,241,325,20,73,20,37,Loss,147,95,4,1,1,GBP,57,388,420,4,0.6434851443804188,56.88335139843105,28.763418271405737,28.119933127025316
0.529411765,0.454545455,33.55,1/22/2012,19,25,away,-3,NEP,282,234,33,70,20,23,Loss,116,96,3,1,3,BAL,43,398,330,1,8.810848351095586,45.993278823988035,27.40206358754181,18.591215236446224
0.454545455,0.529411765,26.45,1/22/2012,25,19,home,3,BAL,234,282,5,68,23,20,Win,96,116,1,3,1,NEP,43,330,398,3,-8.810848351095586,45.993278823988035,18.591215236446224,27.40206358754181
0.333333333,0.076923077,39.6,1/22/2012,20,15,away,3,SFO,267,178,60,90,3,0,Win,85,150,6,3,2,NYG,3,352,328,0,-13.712835731013389,30.308185128402794,8.297674698694703,22.01051042970809
0.076923077,0.333333333,28.3,1/22/2012,15,20,home,-3,NYG,178,267,50,57,0,3,Loss,150,85,3,6,0,SFO,3,328,352,2,13.712835731013389,30.308185128402794,22.01051042970809,8.297674698694703
0.454545455,0.5,37.08333333,2/5/2012,26,21,away,4,NEP,282,266,24,71,21,17,Win,114,83,3,2,1,NYG,38,396,349,0,5.859883937004632,48.45120080129075,27.155542369147692,21.29565843214306
0.5,0.454545455,22.91666667,2/5/2012,21,26,home,-4,NYG,266,282,28,62,17,21,Loss,83,114,2,3,0,NEP,38,349,396,1,-5.859883937004632,48.45120080129075,21.29565843214306,27.155542369147692
0.4,0.333333333,34.11666667,9/5/2012,18,15,away,7,NYG,290,187,86,57,24,17,Win,143,82,2,3,1,DAL,41,433,269,1,1.6266544715779672,43.242203845907646,22.434429158742805,20.80777468716484
0.333333333,0.4,25.88333333,9/5/2012,15,18,home,-7,DAL,187,290,33,54,17,24,Loss,82,143,3,2,1,NYG,41,269,433,1,-1.6266544715779672,43.242203845907646,20.80777468716484,22.434429158742805
0.26666666699999997,0.181818182,39.16666667,9/9/2012,22,24,away,8,NOS,306,326,127,71,40,32,Win,153,32,2,2,3,WAS,72,459,358,0,-7.955744825524434,48.72531347607679,20.38478432527618,28.340529150800613
0.181818182,0.26666666699999997,20.83333333,9/9/2012,24,22,home,-8,WAS,326,306,107,64,32,40,Loss,32,153,2,2,0,NOS,72,358,459,3,7.955744825524434,48.72531347607679,28.340529150800613,20.38478432527618
0.333333333,0.444444444,30.1,9/9/2012,14,28,away,-4,DET,173,346,65,55,23,27,Loss,77,83,4,1,3,LAR,50,250,429,0,1.4990424945533949,47.58864437638858,24.543843435470986,23.044800940917593
0.444444444,0.333333333,29.9,9/9/2012,28,14,home,4,LAR,346,173,27,67,27,23,Win,83,77,1,4,0,DET,50,429,250,3,-1.4990424945533949,47.58864437638858,23.044800940917593,24.543843435470986
0.5,0.35714285700000004,31.01666667,9/9/2012,25,16,away,21,TEN,228,264,20,67,34,13,Win,162,20,1,2,2,NEP,47,390,284,0,4.834731737310996,43.230863085686615,24.032797411498805,19.19806567418781
0.35714285700000004,0.5,28.98333333,9/9/2012,16,25,home,-21,NEP,264,228,30,61,13,34,Loss,20,162,2,1,0,TEN,47,284,390,2,-4.834731737310996,43.230863085686615,19.19806567418781,24.032797411498805
0.2,0.41176470600000004,25.26666667,9/9/2012,15,19,away,-20,HOU,199,254,78,58,10,30,Loss,76,83,2,2,0,MIA,40,275,337,4,-4.746767110979153,39.10425140718239,17.17874214810162,21.92550925908077
0.41176470600000004,0.2,34.73333333,9/9/2012,19,15,home,20,MIA,254,199,35,68,30,10,Win,83,76,2,2,4,HOU,40,337,275,0,4.746767110979153,39.10425140718239,21.92550925908077,17.17874214810162
0.666666667,0.7142857140000001,28.7,9/9/2012,20,21,away,-20,NYJ,195,266,34,58,28,48,Loss,195,118,0,0,1,BUF,76,390,384,4,-0.657909136247488,58.25429836559745,28.79819461467498,29.45610375092247
0.7142857140000001,0.666666667,31.3,9/9/2012,21,20,home,20,BUF,266,195,34,63,48,28,Win,118,195,0,0,4,NYJ,76,384,390,1,0.657909136247488,58.25429836559745,29.45610375092247,28.79819461467498
0.5,0.6875,28.08333333,9/9/2012,21,22,away,16,KCC,292,241,12,55,40,24,Win,84,152,1,3,3,ATL,64,376,393,0,2.5461387421001866,49.28111467007108,25.91362670608563,23.367487963985447
0.6875,0.5,31.91666667,9/9/2012,22,21,home,-16,ATL,241,292,25,69,24,40,Loss,152,84,3,1,0,KCC,64,393,376,3,-2.5461387421001866,49.28111467007108,23.367487963985447,25.91362670608563
0.5,0.2,37.81666667,9/9/2012,22,20,away,-3,MIN,242,266,25,75,0,3,Loss,113,123,2,2,1,JAX,3,355,389,1,-4.91445937401278,43.101960893879415,19.093750759933318,24.008210133946097
0.2,0.5,27.08333333,9/9/2012,20,22,home,3,JAX,266,242,47,58,3,0,Win,123,113,2,2,1,MIN,3,389,355,1,4.91445937401278,43.101960893879415,24.008210133946097,19.093750759933318
0.42105263200000004,0.153846154,35.96666667,9/9/2012,25,12,away,1,CLE,306,111,110,88,17,16,Win,150,99,2,2,4,PHI,33,456,210,5,-10.485716302559856,43.88521410414529,16.699748900792716,27.185465203352575
0.153846154,0.42105263200000004,24.03333333,9/9/2012,12,25,home,-1,PHI,111,306,35,59,16,17,Loss,99,150,2,2,5,CLE,33,210,456,4,10.485716302559856,43.88521410414529,27.185465203352575,16.699748900792716
0.2,0.333333333,24.53333333,9/9/2012,22,26,away,-20,CHI,293,314,19,63,21,41,Loss,63,114,3,2,1,IND,62,356,428,5,4.232260499703429,52.60874624732334,28.420503373513384,24.188242873809955
0.333333333,0.2,35.46666667,9/9/2012,26,22,home,20,IND,314,293,48,70,41,21,Win,114,63,2,3,5,CHI,62,428,356,1,-4.232260499703429,52.60874624732334,24.188242873809955,28.420503373513384
0.2,0.35714285700000004,22.55,9/9/2012,16,18,away,-6,TBB,291,128,65,49,10,16,Loss,10,130,3,2,0,CAR,26,301,258,2,-1.0895129215150057,38.00393782640054,18.457212452442768,19.54672537395777
0.35714285700000004,0.2,37.45,9/9/2012,18,16,home,6,CAR,128,291,35,62,16,10,Win,130,10,2,3,2,TBB,26,258,301,0,1.0895129215150057,38.00393782640054,19.54672537395777,18.457212452442768
0.3125,0.3,33.56666667,9/9/2012,18,18,away,-4,ARI,139,210,90,70,16,20,Loss,115,43,3,1,2,SEA,36,254,253,2,-3.840147739726471,33.12085635990631,14.640354310089922,18.48050204981639
0.3,0.3125,26.43333333,9/9/2012,18,18,home,4,SEA,210,139,102,57,20,16,Win,43,115,1,3,2,ARI,36,253,254,2,3.840147739726471,33.12085635990631,18.480502049816394,14.64035431008992
0.222222222,0.46153846200000004,33.0,9/9/2012,22,21,away,8,GBP,191,279,66,62,30,22,Win,186,45,4,3,1,SFO,52,377,324,0,3.0187201586780747,44.85952812591525,23.93912414229666,20.920403983618588
0.46153846200000004,0.222222222,27.0,9/9/2012,21,22,home,-8,SFO,279,191,77,61,22,30,Loss,45,186,3,4,0,GBP,52,324,377,1,-3.0187201586780747,44.85952812591525,20.920403983618588,23.93912414229666
0.578947368,0.5555555560000001,35.08333333,9/9/2012,19,20,away,-12,DEN,209,240,52,71,19,31,Loss,75,94,5,2,1,PIT,50,284,334,1,-0.9617159129903108,44.159810479073954,21.59904728304182,22.560763196032134
0.5555555560000001,0.578947368,24.91666667,9/9/2012,20,19,home,12,PIT,240,209,49,55,31,19,Win,94,75,2,5,1,DEN,50,334,284,1,0.9617159129903108,44.159810479073954,22.560763196032134,21.59904728304182
0.26666666699999997,0.333333333,32.43333333,9/10/2012,20,26,away,-31,BAL,193,308,41,69,13,44,Loss,129,122,4,3,0,CIN,57,322,430,2,11.362922718953943,44.65553624542564,28.009229482189788,16.64630676323585
0.333333333,0.26666666699999997,27.56666667,9/10/2012,26,20,home,31,CIN,308,193,50,58,44,13,Win,122,129,3,4,2,BAL,57,430,322,0,-11.362922718953943,44.65553624542564,16.64630676323585,28.009229482189788
0.384615385,0.333333333,30.56666667,9/10/2012,15,21,away,8,OAK,226,276,78,54,22,14,Win,32,45,1,3,1,LAC,36,258,321,0,-5.0691562599223445,40.285634365942144,17.6082390530099,22.677395312932244
0.333333333,0.384615385,29.43333333,9/10/2012,21,15,home,-8,LAC,276,226,35,69,14,22,Loss,45,32,3,1,0,OAK,36,321,258,1,5.0691562599223445,40.285634365942144,22.677395312932244,17.6082390530099
0.333333333,0.28571428600000004,27.81666667,9/13/2012,11,19,away,-13,GBP,74,215,65,57,10,23,Loss,94,106,7,5,2,CHI,33,168,321,4,-1.3710018373143953,35.565442756805396,17.0972204597455,18.468222297059896
0.28571428600000004,0.333333333,32.18333333,9/13/2012,19,11,home,13,CHI,215,74,54,66,23,10,Win,106,94,5,7,4,GBP,33,321,168,2,1.3710018373143953,35.565442756805396,18.468222297059896,17.0972204597455
0.46666666700000003,0.333333333,27.11666667,9/16/2012,21,21,away,-7,CIN,309,295,103,62,27,34,Loss,130,80,2,6,1,CLE,61,439,375,1,2.8769986309843496,48.13952990724711,25.508264269115728,22.63126563813138
0.333333333,0.46666666700000003,32.88333333,9/16/2012,21,21,home,7,CLE,295,309,54,62,34,27,Win,80,130,6,2,1,CIN,61,375,439,1,-2.8769986309843496,48.13952990724711,22.63126563813138,25.508264269115728
0.35714285700000004,0.41666666700000005,30.65,9/16/2012,25,15,away,-18,BUF,272,178,33,71,17,35,Loss,150,201,5,0,0,KCC,52,422,379,3,0.531824045586518,47.79241778683293,24.162120916209723,23.630296870623205
0.41666666700000005,0.35714285700000004,29.35,9/16/2012,15,25,home,18,KCC,178,272,50,55,35,17,Win,201,150,0,5,3,BUF,52,379,422,0,-0.531824045586518,47.79241778683293,23.630296870623205,24.162120916209723
0.28571428600000004,0.46666666700000003,25.65,9/16/2012,17,26,away,-1,PHI,214,357,45,65,23,24,Loss,111,129,2,2,4,BAL,47,325,486,2,1.868952598251831,52.41487580875989,27.14191420350586,25.27296160525403
0.46666666700000003,0.28571428600000004,34.35,9/16/2012,26,17,home,1,BAL,357,214,58,75,24,23,Win,129,111,2,2,2,PHI,47,486,325,4,-1.868952598251831,52.41487580875989,25.27296160525403,27.14191420350586
0.46666666700000003,0.4375,30.36666667,9/16/2012,19,17,away,-3,IND,232,194,105,65,20,23,Loss,95,84,4,2,0,MIN,43,327,278,1,-7.598899896253381,39.740636958223945,16.070868530985283,23.66976842723866
0.4375,0.46666666700000003,29.63333333,9/16/2012,17,19,home,3,MIN,194,232,51,63,23,20,Win,84,95,2,4,1,IND,43,278,327,0,7.598899896253381,39.740636958223945,23.66976842723866,16.070868530985283
0.28571428600000004,0.333333333,28.31666667,9/16/2012,16,25,away,2,NEP,140,297,39,61,20,18,Win,102,90,2,4,1,ARI,38,242,387,2,2.098141314849558,36.33409480999566,19.21611806242261,17.117976747573053
0.333333333,0.28571428600000004,31.68333333,9/16/2012,25,16,home,-2,ARI,297,140,60,78,18,20,Loss,90,102,4,2,2,NEP,38,387,242,1,-2.098141314849558,36.33409480999566,17.117976747573053,19.21611806242261
0.538461538,0.5,30.4,9/16/2012,27,23,away,-8,CAR,323,244,23,77,27,35,Loss,163,219,1,1,1,NOS,62,486,463,2,-5.650359208522837,60.4849213217956,27.417281056636384,33.06764026515922
0.5,0.538461538,29.6,9/16/2012,23,27,home,8,NOS,244,323,34,62,35,27,Win,219,163,1,1,2,CAR,62,463,486,1,5.650359208522837,60.4849213217956,33.06764026515922,27.417281056636384
0.470588235,0.0,43.28333333,9/16/2012,28,9,away,20,JAX,195,52,64,83,27,7,Win,216,65,0,3,1,HOU,34,411,117,0,-7.257650951715867,34.329203033679,13.535776040981567,20.793426992697434
0.0,0.470588235,16.71666667,9/16/2012,9,28,home,-20,HOU,52,195,71,38,7,27,Loss,65,216,3,0,0,JAX,34,117,411,1,7.257650951715867,34.329203033679,20.793426992697434,13.535776040981567
0.2,0.384615385,26.51666667,9/16/2012,14,31,away,-7,NYG,228,510,33,52,34,41,Loss,79,94,2,0,3,TBB,75,307,604,2,0.23925306718794914,57.658084751046566,28.94866890911726,28.709415841929307
0.384615385,0.2,33.48333333,9/16/2012,31,14,home,7,TBB,510,228,53,76,41,34,Win,94,79,0,2,2,NYG,75,604,307,3,-0.23925306718794914,57.658084751046566,28.709415841929307,28.94866890911726
0.083333333,0.529411765,25.31666667,9/16/2012,18,24,away,-22,MIA,373,189,42,62,13,35,Loss,23,263,0,1,0,OAK,48,396,452,1,-5.455610096835745,49.03410345120274,21.7892466771835,27.24485677401924
0.529411765,0.083333333,34.68333333,9/16/2012,24,18,home,22,OAK,189,373,21,74,35,13,Win,263,23,1,0,1,MIA,48,452,396,0,5.455610096835745,49.03410345120274,27.24485677401924,21.7892466771835
0.307692308,0.583333333,28.6,9/16/2012,18,23,away,-3,LAR,197,301,96,59,28,31,Loss,176,151,1,2,3,WAS,59,373,452,1,-8.0700172174954,52.69219109032348,22.311086936414043,30.38110415390944
0.583333333,0.307692308,31.4,9/16/2012,23,18,home,3,WAS,301,197,60,64,31,28,Win,151,176,2,1,1,LAR,59,452,373,3,8.0700172174954,52.69219109032348,30.38110415390944,22.311086936414043
0.538461538,0.35714285700000004,25.35,9/16/2012,17,20,away,-20,SEA,247,133,47,57,7,27,Loss,49,182,1,2,0,DAL,34,296,315,2,0.7651564444048287,37.802215245365446,19.283685844885138,18.518529400480308
0.35714285700000004,0.538461538,34.65,9/16/2012,20,17,home,20,DAL,133,247,35,63,27,7,Win,182,49,2,1,2,SEA,34,315,296,0,-0.7651564444048287,37.802215245365446,18.518529400480308,19.283685844885138
0.111111111,0.588235294,16.35,9/16/2012,9,27,away,-28,LAC,174,268,59,40,10,38,Loss,38,148,0,4,1,TEN,48,212,416,1,0.029391226611931387,40.459656191913034,20.24452370926248,20.215132482650553
0.588235294,0.111111111,43.65,9/16/2012,27,9,home,28,TEN,268,174,41,75,38,10,Win,148,38,4,0,1,LAC,48,416,212,1,-0.029391226611931387,40.459656191913034,20.215132482650553,20.24452370926248
0.333333333,0.533333333,23.4,9/16/2012,16,21,away,-17,PIT,129,265,63,51,10,27,Loss,90,66,2,3,0,NYJ,37,219,331,1,0.7877412030909259,39.54605858937927,20.166899896235098,19.379158693144173
0.533333333,0.333333333,36.6,9/16/2012,21,16,home,17,NYJ,265,129,107,62,27,10,Win,66,90,3,2,1,PIT,37,331,219,0,-0.7877412030909259,39.54605858937927,19.379158693144173,20.166899896235098
0.4,0.363636364,30.43333333,9/16/2012,15,24,away,-8,SFO,214,201,67,60,19,27,Loss,82,148,2,3,1,DET,46,296,349,1,0.2511165341602837,42.07468819416615,21.162902364163216,20.911785830002934
0.363636364,0.4,29.56666667,9/16/2012,24,15,home,8,DET,201,214,62,61,27,19,Win,148,82,3,2,1,SFO,46,349,296,1,-0.2511165341602837,42.07468819416615,20.911785830002934,21.162902364163216
0.333333333,0.384615385,27.33333333,9/17/2012,24,22,away,-6,ATL,218,208,96,67,21,27,Loss,118,67,3,1,0,DEN,48,336,275,4,-1.4075357241988193,43.98923379071215,21.290849033256663,22.698384757455486
0.384615385,0.333333333,32.66666667,9/17/2012,22,24,home,6,DEN,208,218,72,65,27,21,Win,67,118,1,3,4,ATL,48,275,336,0,1.4075357241988193,43.98923379071215,22.698384757455486,21.290849033256663
0.5,0.444444444,36.16666667,9/20/2012,24,22,away,29,CAR,280,267,38,68,36,7,Win,125,60,2,2,5,NYG,43,405,327,0,1.0101124849771814,56.85230200443559,28.931207244706385,27.921094759729208
0.444444444,0.5,23.83333333,9/20/2012,22,24,home,-29,NYG,267,280,22,55,7,36,Loss,60,125,2,2,0,CAR,43,327,405,5,-1.0101124849771814,56.85230200443559,27.921094759729208,28.931207244706385
0.38888888899999996,0.384615385,42.53333333,9/23/2012,27,14,away,3,NOS,237,205,40,92,3,0,Win,273,83,3,4,1,KCC,3,510,288,3,-11.252244877276187,39.06576210856906,13.906758615646439,25.159003492922622
0.384615385,0.38888888899999996,26.01666667,9/23/2012,14,27,home,-3,KCC,205,237,45,59,0,3,Loss,83,273,4,3,3,NOS,3,288,510,1,11.252244877276187,39.06576210856906,25.159003492922622,13.906758615646437
0.333333333,0.25,27.5,9/23/2012,22,31,away,7,WAS,385,179,80,58,38,31,Win,93,202,2,5,1,CIN,69,478,381,2,1.7005551926987823,52.77539014432596,27.23797266851237,25.53741747581359
0.25,0.333333333,32.5,9/23/2012,31,22,home,-7,CIN,179,385,60,74,31,38,Loss,202,93,5,2,2,WAS,69,381,478,1,-1.7005551926987823,52.77539014432596,25.53741747581359,27.23797266851237
0.25,0.41666666700000005,40.6,9/23/2012,36,21,away,-3,TEN,442,378,91,92,0,3,Loss,141,59,1,0,2,DET,3,583,437,1,-9.446536986286807,58.37200980747723,24.462736410595213,33.909273396882014
0.41666666700000005,0.25,27.81666667,9/23/2012,21,36,home,3,DET,378,442,32,61,3,0,Win,59,141,0,1,1,TEN,3,437,583,2,9.446536986286807,58.37200980747723,33.909273396882014,24.46273641059521
0.4,0.5,26.53333333,9/23/2012,19,25,away,-11,MIN,191,198,60,58,13,24,Loss,89,146,3,0,2,SFO,37,280,344,3,-3.0830045494049454,44.32851364200628,20.622754546300666,23.705759095705613
0.5,0.4,33.46666667,9/23/2012,25,19,home,11,SFO,198,191,10,76,24,13,Win,146,89,0,3,3,MIN,37,344,280,2,3.0830045494049454,44.32851364200628,23.705759095705613,20.622754546300666
0.307692308,0.526315789,27.6,9/23/2012,15,23,away,5,IND,148,313,67,54,22,17,Win,185,124,1,0,1,JAX,39,333,437,0,-11.172778824358943,47.33885653019986,18.08303885292046,29.255817677279403
0.526315789,0.307692308,32.4,9/23/2012,23,15,home,-5,JAX,313,148,106,75,17,22,Loss,124,185,0,1,0,IND,39,437,333,1,11.172778824358943,47.33885653019986,29.255817677279403,18.08303885292046
0.23076923100000002,0.28571428600000004,26.06666667,9/23/2012,12,20,away,-17,CHI,101,171,40,58,6,23,Loss,59,103,6,2,1,LAR,29,160,274,2,-6.236752434540449,28.569116918274553,11.166182241867052,17.4029346764075
0.28571428600000004,0.23076923100000002,33.93333333,9/23/2012,20,12,home,17,LAR,171,101,45,67,23,6,Win,103,59,2,6,2,CHI,29,274,160,1,6.236752434540449,28.569116918274553,17.4029346764075,11.166182241867052
0.28571428600000004,0.272727273,32.93333333,9/23/2012,19,17,away,10,CLE,206,207,75,70,24,14,Win,138,33,1,4,2,BUF,38,344,240,1,-5.100983517564762,35.49968725955134,15.199351870993286,20.30033538855805
0.272727273,0.28571428600000004,27.06666667,9/23/2012,17,19,home,-10,BUF,207,206,57,60,14,24,Loss,33,138,4,1,1,CLE,38,240,344,2,5.100983517564762,35.49968725955134,20.30033538855805,15.199351870993286
0.2,0.3125,26.93333333,9/23/2012,12,14,away,-6,DAL,91,259,69,55,10,16,Loss,75,38,2,4,3,TBB,26,166,297,2,-10.368194758015484,28.949858675684947,9.290831958834733,19.659026716850214
0.3125,0.2,33.06666667,9/23/2012,14,12,home,6,TBB,259,91,105,66,16,10,Win,38,75,4,2,2,DAL,26,297,166,3,10.368194758015484,28.949858675684947,19.659026716850214,9.290831958834731
0.352941176,0.526315789,35.38333333,9/23/2012,21,23,away,3,MIA,295,196,108,79,3,0,Win,93,185,2,0,2,NYJ,3,388,381,2,-21.47131527451797,42.25760268265019,10.393143704066109,31.86445897858408
0.526315789,0.352941176,33.55,9/23/2012,23,21,home,-3,NYJ,196,295,65,79,0,3,Loss,185,93,0,2,2,MIA,3,381,388,2,21.47131527451797,42.25760268265019,31.86445897858408,10.393143704066109
0.615384615,0.454545455,36.23333333,9/23/2012,25,15,away,24,LAC,265,164,15,68,27,3,Win,119,116,2,1,4,ATL,30,384,280,1,1.053706558455346,45.20152669583396,23.127616627144654,22.073910068689308
0.454545455,0.615384615,23.76666667,9/23/2012,15,25,home,-24,ATL,164,265,17,56,3,27,Loss,116,119,1,2,1,LAC,30,280,384,4,-1.053706558455346,45.20152669583396,22.073910068689308,23.127616627144654
0.35714285700000004,0.4,25.45,9/23/2012,16,16,away,-21,ARI,194,193,65,63,6,27,Loss,113,99,5,3,0,PHI,33,307,292,3,-0.08668160879180853,37.721157593586916,18.817237992397555,18.90391960118936
0.4,0.35714285700000004,34.55,9/23/2012,16,16,home,21,PHI,193,194,45,61,27,6,Win,99,113,3,5,3,ARI,33,292,307,0,0.08668160879180853,37.721157593586916,18.90391960118936,18.817237992397555
0.571428571,0.583333333,36.25,9/23/2012,24,21,away,-3,OAK,379,202,81,70,31,34,Loss,54,119,1,1,1,PIT,65,433,321,2,-2.794144508155191,56.50764158999367,26.856748540919238,29.65089304907443
0.583333333,0.571428571,23.75,9/23/2012,21,24,home,3,PIT,202,379,25,56,34,31,Win,119,54,1,1,2,OAK,65,321,433,1,2.794144508155191,56.50764158999367,29.65089304907443,26.856748540919238
0.5,0.352941176,31.66666667,9/23/2012,23,24,away,6,DEN,284,316,69,65,31,25,Win,152,59,1,3,1,HOU,56,436,375,2,-8.78647793418609,53.89540075531563,22.55446141056477,31.340939344750858
0.352941176,0.5,28.33333333,9/23/2012,24,23,home,-6,HOU,316,284,75,76,25,31,Loss,59,152,3,1,2,DEN,56,375,436,1,8.78647793418609,53.89540075531563,31.340939344750858,22.55446141056477
0.46666666700000003,0.5,31.05,9/23/2012,33,28,away,-1,BAL,319,382,83,77,30,31,Loss,77,121,2,0,1,NEP,61,396,503,0,5.829616182804651,58.69232917420616,32.260972678505404,26.431356495700754
0.5,0.46666666700000003,28.95,9/23/2012,28,33,home,1,NEP,382,319,135,65,31,30,Win,121,77,0,2,0,BAL,61,503,396,1,-5.829616182804651,58.69232917420616,26.431356495700754,32.260972678505404
0.46666666700000003,0.181818182,33.65,9/24/2012,22,14,away,-2,SEA,184,111,127,68,12,14,Loss,84,127,8,1,0,GBP,26,268,238,0,-1.7192146098382852,33.561812862590166,15.921299126375942,17.640513736214224
0.181818182,0.46666666700000003,26.35,9/24/2012,14,22,home,2,GBP,111,184,118,51,14,12,Win,127,84,1,8,0,SEA,26,238,268,0,1.7192146098382852,33.561812862590166,17.640513736214224,15.92129912637594
0.2,0.333333333,26.95,9/27/2012,20,23,away,-7,BAL,314,337,66,70,16,23,Loss,43,101,1,4,1,CLE,39,357,438,2,-7.090868726605932,42.570519219943435,17.73982524666875,24.830693973274684
0.333333333,0.2,33.05,9/27/2012,23,20,home,7,CLE,337,314,100,77,23,16,Win,101,43,4,1,2,BAL,39,438,357,1,7.090868726605932,42.570519219943435,24.830693973274684,17.73982524666875
0.333333333,0.428571429,27.56666667,9/30/2012,17,16,away,-24,HOU,167,202,73,60,14,38,Loss,158,95,4,0,0,TEN,52,325,297,3,-5.361773352591914,40.76213016876627,17.700178408087176,23.061951760679094
0.428571429,0.333333333,32.43333333,9/30/2012,16,17,home,24,TEN,202,167,3,59,38,14,Win,95,158,0,4,3,HOU,52,297,325,0,5.361773352591914,40.76213016876627,23.061951760679094,17.700178408087176
0.363636364,0.533333333,30.78333333,9/30/2012,33,19,away,24,BUF,333,340,10,77,52,28,Win,247,98,1,3,6,NEP,80,580,438,2,8.032553055049778,65.3022838452202,36.66741845013499,28.634865395085214
0.533333333,0.363636364,29.21666667,9/30/2012,19,33,home,-24,NEP,340,333,17,69,28,52,Loss,98,247,3,1,2,BUF,80,438,580,6,-8.032553055049778,65.3022838452202,28.634865395085214,36.66741845013499
0.333333333,0.153846154,36.93333333,9/30/2012,26,9,away,34,NYJ,134,100,67,68,34,0,Win,247,45,2,3,4,SFO,34,381,145,0,2.936652562438514,34.50784956093589,18.722251061687203,15.785598499248687
0.153846154,0.333333333,23.06666667,9/30/2012,9,26,home,-34,SFO,100,134,30,50,0,34,Loss,45,247,3,2,0,NYJ,34,145,381,4,-2.936652562438514,34.50784956093589,15.785598499248685,18.722251061687203
0.222222222,0.384615385,29.86666667,9/30/2012,19,15,away,-6,LAR,140,211,55,61,13,19,Loss,179,75,2,2,1,SEA,32,319,286,3,0.575889930024843,37.71972762490045,19.147808777462647,18.571918847437804
0.384615385,0.222222222,30.13333333,9/30/2012,15,19,home,6,SEA,211,140,37,60,19,13,Win,75,179,2,2,3,LAR,32,286,319,1,-0.575889930024843,37.71972762490045,18.571918847437804,19.147808777462647
0.363636364,0.384615385,30.1,9/30/2012,21,24,away,-2,ATL,205,305,64,63,28,30,Loss,199,121,3,7,1,CAR,58,404,426,1,-1.0415706100811728,49.59091481136716,24.274672100642995,25.31624271072417
0.384615385,0.363636364,29.9,9/30/2012,24,21,home,2,CAR,305,205,15,66,30,28,Win,121,199,7,3,1,ATL,58,426,404,1,1.0415706100811728,49.59091481136716,25.31624271072417,24.274672100642995
0.25,0.375,29.3,9/30/2012,15,23,away,7,DET,100,286,87,56,20,13,Win,127,55,2,5,1,MIN,33,227,341,0,-7.837030205262301,35.90919139050763,14.036080592622664,21.873110797884966
0.375,0.25,30.7,9/30/2012,23,15,home,-7,MIN,286,100,72,76,13,20,Loss,55,127,5,2,0,DET,33,341,227,1,7.837030205262301,35.90919139050763,21.873110797884966,14.036080592622664
0.25,0.4,33.86666667,9/30/2012,19,25,away,17,KCC,189,234,75,60,37,20,Win,104,115,3,2,6,LAC,57,293,349,1,0.795321375953856,46.0291185396808,23.412219957817328,22.616898581863474
0.4,0.25,26.13333333,9/30/2012,25,19,home,-17,LAC,234,189,80,66,20,37,Loss,115,104,2,3,1,KCC,57,349,293,6,-0.795321375953856,46.0291185396808,22.616898581863474,23.412219957817328
0.083333333,0.625,22.58333333,9/30/2012,12,26,away,-31,DEN,181,338,41,53,6,37,Loss,56,165,3,0,1,OAK,43,237,503,0,-3.168884363203574,47.3281533554561,22.079634496126264,25.248518859329838
0.625,0.083333333,37.41666667,9/30/2012,26,12,home,31,OAK,338,181,30,77,37,6,Win,165,56,0,3,0,DEN,43,503,237,1,3.168884363203574,47.3281533554561,25.248518859329838,22.079634496126264
0.375,0.25,35.0,9/30/2012,21,19,away,-3,ARI,394,269,40,74,0,3,Loss,86,28,4,8,2,MIA,3,480,297,4,-4.003994815994075,41.408170897081334,18.70208804054363,22.706082856537705
0.25,0.375,31.51666667,9/30/2012,19,21,home,3,MIA,269,394,62,71,3,0,Win,28,86,8,4,4,ARI,3,297,480,2,4.003994815994075,41.408170897081334,22.706082856537705,18.70208804054363
0.181818182,0.181818182,31.31666667,9/30/2012,20,17,away,17,JAX,244,143,50,65,27,10,Win,138,69,0,6,2,CIN,37,382,212,2,3.9372625072966603,37.80870708020961,20.872984793753133,16.935722286456475
0.181818182,0.181818182,28.68333333,9/30/2012,17,20,home,-17,CIN,143,244,37,58,10,27,Loss,69,138,6,0,2,JAX,37,212,382,2,-3.9372625072966603,37.80870708020961,16.935722286456475,20.872984793753133
0.181818182,0.25,32.31666667,9/30/2012,27,16,away,2,TBB,321,293,73,67,24,22,Win,153,80,1,1,1,WAS,46,474,373,0,-8.127285329121067,46.622723205168285,19.24771893802361,27.375004267144675
0.25,0.181818182,27.68333333,9/30/2012,16,27,home,-2,WAS,293,321,107,58,22,24,Loss,80,153,1,1,0,TBB,46,373,474,1,8.127285329121067,46.622723205168285,27.375004267144675,19.24771893802361
0.529411765,0.5,30.46666667,9/30/2012,25,30,away,-1,GBP,429,319,72,75,27,28,Loss,45,102,2,0,2,NOS,55,474,421,0,-0.4832327642208931,61.1184395544486,30.317603395113853,30.800836159334747
0.5,0.529411765,29.53333333,9/30/2012,30,25,home,1,NOS,319,429,43,66,28,27,Win,102,45,0,2,0,GBP,55,421,474,2,0.4832327642208931,61.1184395544486,30.800836159334747,30.317603395113853
0.2,0.333333333,26.65,9/30/2012,20,22,away,-2,PHI,309,231,55,61,17,19,Loss,57,191,0,2,0,NYG,36,366,422,1,0.2998415898418205,48.467276619292186,24.383559104567002,24.083717514725183
0.333333333,0.2,33.35,9/30/2012,22,20,home,2,NYG,231,309,49,68,19,17,Win,191,57,2,0,1,PHI,36,422,366,0,-0.2998415898418205,48.467276619292186,24.083717514725183,24.383559104567002
0.583333333,0.333333333,30.83333333,10/1/2012,18,26,away,16,DAL,267,389,25,54,34,18,Win,93,41,2,1,5,CHI,52,360,430,1,5.066550813306449,54.1482062458299,29.607378529568173,24.540827716261724
0.333333333,0.583333333,29.16666667,10/1/2012,26,18,home,-16,CHI,389,267,10,68,18,34,Loss,41,93,1,2,1,DAL,52,430,360,5,-5.066550813306449,54.1482062458299,24.540827716261724,29.607378529568173
0.36842105299999994,0.28571428600000004,34.36666667,10/4/2012,20,12,away,-14,LAR,237,131,35,76,3,17,Loss,45,111,9,1,1,ARI,20,282,242,1,-7.381115243148121,30.183708144807945,11.40129645082991,18.782411693978034
0.28571428600000004,0.36842105299999994,25.63333333,10/4/2012,12,20,home,14,ARI,131,237,60,54,17,3,Win,111,45,1,9,1,LAR,20,242,282,1,7.381115243148121,30.183708144807945,18.782411693978034,11.401296450829912
0.307692308,0.14285714300000002,28.81666667,10/7/2012,15,18,away,4,CIN,211,218,10,63,17,13,Win,68,80,2,3,3,MIA,30,279,298,2,3.7956888379815976,34.691058788447236,19.24337381321442,15.44768497523282
0.14285714300000002,0.307692308,31.18333333,10/7/2012,18,15,home,-4,MIA,218,211,46,65,13,17,Loss,80,68,3,2,2,CIN,30,298,279,3,-3.7956888379815976,34.691058788447236,15.447684975232818,19.24337381321442
0.25,0.545454545,24.6,10/7/2012,15,30,away,-14,NYG,291,259,91,54,27,41,Loss,84,243,0,0,2,CLE,68,375,502,3,0.4711739638273009,56.30834564925521,28.389759806541257,27.918585842713952
0.545454545,0.25,35.4,10/7/2012,30,15,home,14,CLE,259,291,25,71,41,27,Win,243,84,0,0,3,NYG,68,502,375,2,-0.4711739638273009,56.30834564925521,27.918585842713952,28.389759806541257
0.307692308,0.4,24.73333333,10/7/2012,21,28,away,-3,IND,207,345,89,61,27,30,Loss,149,119,5,4,1,GBP,57,356,464,1,-10.48514687640578,51.21506652340181,20.364959823498015,30.850106699903794
0.4,0.307692308,35.26666667,10/7/2012,28,21,home,3,GBP,345,207,100,89,30,27,Win,119,149,4,5,1,IND,57,464,356,1,10.48514687640578,51.21506652340181,30.850106699903794,20.364959823498015
0.4,0.428571429,26.48333333,10/7/2012,19,22,away,-2,PIT,168,220,35,56,14,16,Loss,78,123,3,0,0,PHI,30,246,343,2,0.41076457938868316,42.526346018777716,21.4685552990832,21.057790719694516
0.428571429,0.4,33.51666667,10/7/2012,22,19,home,2,PHI,220,168,106,68,16,14,Win,123,78,0,3,2,PIT,30,343,246,0,-0.41076457938868316,42.526346018777716,21.057790719694516,21.4685552990832
0.529411765,0.111111111,37.01666667,10/7/2012,28,12,away,7,WAS,338,187,13,81,24,17,Win,83,129,1,3,2,ATL,41,421,316,2,-1.3971939134708675,42.36365167522333,20.483228880876233,21.880422794347098
0.111111111,0.529411765,22.98333333,10/7/2012,12,28,home,-7,ATL,187,338,20,48,17,24,Loss,129,83,3,1,2,WAS,41,316,421,2,1.3971939134708675,42.36365167522333,21.880422794347098,20.483228880876233
0.272727273,0.46153846200000004,25.83333333,10/7/2012,15,19,away,3,KCC,165,124,33,55,9,6,Win,133,214,4,0,4,BAL,15,298,338,2,3.701013962888343,39.34365928308692,21.52233662298763,17.82132266009929
0.46153846200000004,0.272727273,34.16666667,10/7/2012,19,15,home,-3,BAL,124,165,60,68,6,9,Loss,214,133,0,4,2,KCC,15,338,298,4,-3.701013962888343,39.34365928308692,17.82132266009929,21.52233662298763
0.588235294,0.384615385,36.0,10/7/2012,26,10,away,38,JAX,287,129,80,73,41,3,Win,214,60,1,3,3,CHI,44,501,189,1,-10.22168980349408,46.63942375834614,18.20886697742603,28.43055678092011
0.384615385,0.588235294,24.0,10/7/2012,10,26,home,-38,CHI,129,287,49,53,3,41,Loss,60,214,3,1,1,JAX,44,189,501,3,10.22168980349408,46.63942375834614,28.43055678092011,18.20886697742603
0.5,0.181818182,35.61666667,10/7/2012,17,13,away,4,CAR,212,108,65,62,16,12,Win,98,82,2,4,2,SEA,28,310,190,3,1.7478149798431826,36.545287300551955,19.14655114019757,17.398736160354385
0.181818182,0.5,24.38333333,10/7/2012,13,17,home,-4,SEA,108,212,25,52,12,16,Loss,82,98,4,2,3,CAR,28,190,310,2,-1.7478149798431826,36.545287300551955,17.398736160354385,19.14655114019757
0.470588235,0.272727273,26.9,10/7/2012,18,25,away,-23,MIN,215,258,75,69,7,30,Loss,52,175,2,1,2,TEN,37,267,433,2,-9.500593279871339,46.707099980030335,18.6032533500795,28.103846629950837
0.272727273,0.470588235,33.1,10/7/2012,25,18,home,23,TEN,258,215,60,67,30,7,Win,175,52,1,2,2,MIN,37,433,267,2,9.500593279871339,46.707099980030335,28.103846629950837,18.6032533500795
0.2,0.636363636,23.76666667,10/7/2012,10,29,away,-42,SFO,115,310,30,46,3,45,Loss,89,311,1,0,1,BUF,48,204,621,2,8.780642202865614,51.950874404856876,30.365758303861245,21.58511610099563
0.636363636,0.2,36.23333333,10/7/2012,29,10,home,42,BUF,310,115,53,63,45,3,Win,311,89,0,1,2,SFO,48,621,204,1,-8.780642202865614,51.950874404856876,21.58511610099563,30.365758303861245
0.538461538,0.647058824,24.18333333,10/7/2012,22,35,away,-10,NEP,324,193,21,66,21,31,Loss,70,251,2,4,1,DEN,52,394,444,3,-0.5735671894771439,57.383448175057644,28.40494049279025,28.978507682267395
0.647058824,0.538461538,35.81666667,10/7/2012,35,22,home,10,DEN,193,324,59,89,31,21,Win,251,70,4,2,3,NEP,52,444,394,1,0.5735671894771439,57.383448175057644,28.978507682267395,28.40494049279025
0.333333333,0.5625,30.56666667,10/7/2012,27,21,away,-7,NOS,310,351,56,65,24,31,Loss,117,53,5,3,1,LAC,55,427,404,2,-1.5772730337234115,53.565655421839864,25.994191194058224,27.57146422778164
0.5625,0.333333333,29.43333333,10/7/2012,21,27,home,7,LAC,351,310,99,69,31,24,Win,53,117,3,5,2,NOS,55,404,427,1,1.5772730337234115,53.565655421839864,27.57146422778164,25.994191194058224
0.4,0.28571428600000004,35.26666667,10/8/2012,18,15,away,6,NYJ,209,217,50,63,23,17,Win,169,69,0,3,2,HOU,40,378,286,1,-3.167403284566296,41.99118960415815,19.411893159795927,22.579296444362225
0.28571428600000004,0.4,24.73333333,10/8/2012,15,18,home,-6,HOU,217,209,25,58,17,23,Loss,69,169,3,0,1,NYJ,40,286,378,2,3.167403284566296,41.99118960415815,22.579296444362225,19.411893159795927
0.46666666700000003,0.5625,29.95,10/11/2012,19,21,away,-3,TEN,356,265,50,63,23,26,Loss,56,94,1,3,1,PIT,49,412,359,1,-7.687594001671311,48.77987255223773,20.54613927528321,28.233733276954517
0.5625,0.46666666700000003,30.05,10/11/2012,21,19,home,3,PIT,265,356,45,69,26,23,Win,94,56,3,1,1,TEN,49,359,412,1,7.687594001671311,48.77987255223773,28.233733276954517,20.54613927528321
0.35714285700000004,0.41176470600000004,30.05,10/14/2012,20,16,away,-10,CLE,362,218,50,68,24,34,Loss,76,110,2,2,1,CIN,58,438,328,4,-1.760621013835431,44.857306746802315,21.54834286648344,23.308963880318874
0.41176470600000004,0.35714285700000004,29.95,10/14/2012,16,20,home,10,CIN,218,362,35,65,34,24,Win,110,76,2,2,4,CLE,58,328,438,1,1.760621013835431,44.857306746802315,23.308963880318874,21.54834286648344
0.272727273,0.5,26.33333333,10/14/2012,21,22,away,-26,NYJ,257,99,27,65,9,35,Loss,41,252,4,1,0,IND,44,298,351,4,-2.3032383234822262,46.14677798941386,21.92176983296582,24.225008156448045
0.5,0.272727273,33.66666667,10/14/2012,22,21,home,26,IND,99,257,110,64,35,9,Win,252,41,1,4,4,NYJ,44,351,298,0,2.3032383234822262,46.14677798941386,24.225008156448045,21.92176983296582
0.352941176,0.444444444,33.18333333,10/14/2012,15,19,away,-28,TBB,180,318,55,68,10,38,Loss,80,145,0,1,2,KCC,48,260,463,2,-2.746308516055638,44.02651309972129,20.640102291832825,23.386410807888467
0.444444444,0.352941176,26.81666667,10/14/2012,19,15,home,28,KCC,318,180,33,51,38,10,Win,145,80,1,0,2,TBB,48,463,260,2,2.746308516055638,44.02651309972129,23.386410807888467,20.640102291832825
0.384615385,0.222222222,36.43333333,10/14/2012,22,16,away,-3,ATL,325,241,110,68,20,23,Loss,149,45,3,1,3,OAK,43,474,286,3,1.514551133894181,51.773016108786294,26.643783621340237,25.129232487446057
0.222222222,0.384615385,23.56666667,10/14/2012,16,22,home,3,OAK,241,325,25,53,23,20,Win,45,149,1,3,3,ATL,43,286,474,3,-1.514551133894181,51.773016108786294,25.129232487446057,26.643783621340237
0.533333333,0.6,40.05,10/14/2012,30,19,away,-2,BAL,254,230,82,79,29,31,Loss,227,86,1,1,0,DAL,60,481,316,1,-1.2728374090525505,50.71236901751679,24.71976580423212,25.99260321328467
0.6,0.533333333,19.95,10/14/2012,19,30,home,2,DAL,230,254,76,49,31,29,Win,86,227,1,1,1,BAL,60,316,481,0,1.2728374090525505,50.71236901751679,25.99260321328467,24.71976580423212
0.23076923100000002,0.333333333,33.38333333,10/14/2012,22,12,away,-3,MIA,300,156,94,69,14,17,Loss,162,36,3,3,0,LAR,31,462,192,1,-0.80294516599246,37.883396633782574,18.540225733895056,19.343170899887518
0.333333333,0.23076923100000002,26.61666667,10/14/2012,12,22,home,3,LAR,156,300,40,49,17,14,Win,36,162,3,3,1,MIA,31,192,462,0,0.80294516599246,37.883396633782574,19.343170899887518,18.540225733895056
0.23076923100000002,0.470588235,30.68333333,10/14/2012,25,24,away,3,PHI,311,286,132,73,3,0,Win,138,71,0,3,3,DET,3,449,357,1,-11.139313504275966,51.894792668361816,20.377739582042924,31.517053086318892
0.470588235,0.23076923100000002,33.31666667,10/14/2012,24,25,home,-3,DET,286,311,60,78,0,3,Loss,71,138,3,0,1,PHI,3,357,449,3,11.139313504275966,51.894792668361816,31.517053086318892,20.377739582042924
0.444444444,0.333333333,34.0,10/14/2012,26,17,away,-1,SEA,388,283,80,85,23,24,Loss,87,85,1,2,2,NEP,47,475,368,2,3.8016346133530643,49.65705013923345,26.729342376293257,22.92770776294019
0.333333333,0.444444444,26.0,10/14/2012,17,26,home,1,NEP,283,388,35,55,24,23,Win,85,87,2,1,2,SEA,47,368,475,2,-3.8016346133530643,49.65705013923345,22.92770776294019,26.729342376293257
0.307692308,0.3125,31.36666667,10/14/2012,19,20,away,3,ARI,141,150,39,68,3,0,Win,165,182,2,5,2,BUF,3,306,332,2,-7.3106414463600995,35.653909740074326,14.171634146857112,21.482275593217214
0.3125,0.307692308,32.46666667,10/14/2012,20,19,home,-3,BUF,150,141,67,71,0,3,Loss,182,165,5,2,2,ARI,3,332,306,2,7.3106414463600995,35.653909740074326,21.482275593217214,14.171634146857112
0.470588235,0.5,31.53333333,10/14/2012,27,20,away,-12,WAS,327,178,29,80,26,38,Loss,94,183,4,1,1,MIN,64,421,361,3,-7.41208879723008,51.299600531541664,21.943755867155794,29.35584466438587
0.5,0.470588235,28.46666667,10/14/2012,20,27,home,12,MIN,178,327,66,55,38,26,Win,183,94,1,4,3,WAS,64,361,421,1,7.41208879723008,51.299600531541664,29.35584466438587,21.943755867155794
0.333333333,0.28571428600000004,32.25,10/14/2012,19,14,away,23,SFO,193,234,20,65,26,3,Win,149,80,0,6,3,NYG,29,342,314,0,-1.1549110763422128,38.88666033145119,18.86587462755449,20.0207857038967
0.28571428600000004,0.333333333,27.75,10/14/2012,14,19,home,-23,NYG,234,193,35,60,3,26,Loss,80,149,6,0,0,SFO,29,314,342,3,1.1549110763422128,38.88666033145119,20.0207857038967,18.86587462755449
0.35714285700000004,0.41666666700000005,27.98333333,10/14/2012,25,23,away,18,HOU,328,231,51,70,42,24,Win,99,90,2,3,3,GBP,66,427,321,0,-6.015578718101317,51.51373850365732,22.749079892778003,28.76465861087932
0.41666666700000005,0.35714285700000004,32.01666667,10/14/2012,23,25,home,-18,GBP,231,328,69,69,24,42,Loss,90,99,3,2,0,HOU,66,321,427,3,6.015578718101317,51.51373850365732,28.76465861087932,22.749079892778003
0.25,0.4,26.41666667,10/15/2012,18,23,away,11,LAC,309,217,81,52,35,24,Win,56,90,0,4,6,DEN,59,365,307,3,4.895288584021557,51.85540293505002,28.37534575953579,23.480057175514233
0.4,0.25,33.58333333,10/15/2012,23,18,home,-11,DEN,217,309,64,72,24,35,Loss,90,56,4,0,3,LAC,59,307,365,6,-4.895288584021557,51.85540293505002,23.480057175514233,28.37534575953579
0.307692308,0.272727273,27.98333333,10/18/2012,13,18,away,-7,SFO,115,138,20,54,6,13,Loss,136,175,2,2,1,SEA,19,251,313,1,7.676814542224699,31.505006865459737,19.59091070384222,11.914096161617518
0.272727273,0.307692308,32.01666667,10/18/2012,18,13,home,7,SEA,138,115,40,57,13,6,Win,175,136,2,2,1,SFO,19,313,251,1,-7.676814542224699,31.505006865459737,11.914096161617518,19.59091070384222
0.6,0.333333333,26.25,10/21/2012,23,26,away,7,TBB,377,411,55,63,35,28,Win,81,102,0,2,0,NOS,63,458,513,1,-1.7200468861621747,58.49979663603322,28.389874874935522,30.109921761097695
0.333333333,0.6,33.75,10/21/2012,26,23,home,-7,NOS,411,377,50,68,28,35,Loss,102,81,2,0,1,TBB,63,513,458,0,1.7200468861621747,58.49979663603322,30.109921761097695,28.389874874935522
0.428571429,0.2,33.61666667,10/21/2012,18,18,away,5,CAR,227,216,43,65,19,14,Win,85,112,0,2,2,DAL,33,312,328,1,-7.634417794226123,40.814086220156966,16.58983421296542,24.224252007191545
0.2,0.428571429,26.38333333,10/21/2012,18,18,home,-5,DAL,216,227,71,60,14,19,Loss,112,85,2,0,1,CAR,33,328,312,2,7.634417794226123,40.814086220156966,24.224252007191545,16.58983421296542
0.35714285700000004,0.1,35.08333333,10/21/2012,21,12,away,-7,MIN,230,43,82,69,14,21,Loss,126,166,7,3,2,ARI,35,356,209,2,4.842222130795308,33.66757362982598,19.254897880310644,14.412675749515337
0.1,0.35714285700000004,24.91666667,10/21/2012,12,21,home,7,ARI,43,230,35,47,21,14,Win,166,126,3,7,2,MIN,35,209,356,2,-4.842222130795308,33.66757362982598,14.412675749515337,19.254897880310644
0.642857143,0.583333333,29.68333333,10/21/2012,21,22,away,1,BUF,193,216,25,62,35,34,Win,197,166,2,1,2,TEN,69,390,382,0,-3.8576170725014176,53.4850074317336,24.81369517961609,28.67131225211751
0.583333333,0.642857143,30.31666667,10/21/2012,22,21,home,-1,TEN,216,193,65,60,34,35,Loss,166,197,1,2,0,BUF,69,382,390,2,3.8576170725014176,53.4850074317336,28.67131225211751,24.81369517961609
0.46153846200000004,0.666666667,32.71666667,10/21/2012,24,22,away,-4,NYG,232,329,55,69,23,27,Loss,248,64,3,1,2,WAS,50,480,393,4,-4.979137733721541,60.48124241912481,27.751052342701634,32.73019007642318
0.666666667,0.46153846200000004,27.28333333,10/21/2012,22,24,home,4,WAS,329,232,30,60,27,23,Win,64,248,1,3,4,NYG,50,393,480,2,4.979137733721541,60.48124241912481,32.73019007642318,27.751052342701634
0.46153846200000004,0.4,24.65,10/21/2012,19,21,away,-4,IND,264,173,75,58,13,17,Loss,55,148,0,3,1,CLE,30,319,321,0,-4.119820294394639,40.12021363388835,18.000196669746856,22.12001696414149
0.4,0.46153846200000004,35.35,10/21/2012,21,19,home,4,CLE,173,264,50,69,17,13,Win,148,55,3,0,0,IND,30,321,319,1,4.119820294394639,40.12021363388835,22.12001696414149,18.000196669746856
0.26666666699999997,0.533333333,21.73333333,10/21/2012,12,27,away,-30,HOU,121,239,56,59,13,43,Loss,55,181,4,2,0,BAL,56,176,420,2,-6.9238004004762885,37.22483274309397,15.15051617130884,22.07431657178513
0.533333333,0.26666666699999997,38.26666667,10/21/2012,27,12,home,30,BAL,239,121,60,76,43,13,Win,181,55,2,4,2,HOU,56,420,176,0,6.9238004004762885,37.22483274309397,22.07431657178513,15.15051617130884
0.6,0.363636364,32.96666667,10/21/2012,22,19,away,10,LAR,332,246,30,66,30,20,Win,70,108,3,3,1,GBP,50,402,354,0,0.45252295620963334,49.700193540732236,25.076358248470935,24.6238352922613
0.363636364,0.6,27.03333333,10/21/2012,19,22,home,-10,GBP,246,332,30,59,20,30,Loss,108,70,3,3,0,LAR,50,354,402,1,-0.45252295620963334,49.700193540732236,24.6238352922613,25.076358248470935
0.066666667,0.352941176,30.08333333,10/21/2012,10,20,away,-3,OAK,155,282,92,61,0,3,Loss,54,69,3,2,3,JAX,3,209,351,1,-14.971811830906864,36.34383367896674,10.686010924029937,25.657822754936802
0.352941176,0.066666667,32.01666667,10/21/2012,20,10,home,3,JAX,282,155,58,74,3,0,Win,69,54,2,3,1,OAK,3,351,209,3,14.971811830906864,36.34383367896674,25.657822754936802,10.686010924029937
0.533333333,0.529411765,35.81666667,10/21/2012,26,26,away,-3,NEP,297,250,60,78,0,3,Loss,106,131,4,1,1,NYJ,3,403,381,2,-3.9207233250977938,47.747664171681215,21.91347042329171,25.834193748389506
0.529411765,0.533333333,31.71666667,10/21/2012,26,26,home,3,NYJ,250,297,40,74,3,0,Win,131,106,1,4,2,NEP,3,381,403,1,3.9207233250977938,47.747664171681215,25.834193748389506,21.91347042329171
0.625,0.384615385,37.5,10/21/2012,22,11,away,7,CIN,264,105,50,70,24,17,Win,167,80,3,0,1,PIT,41,431,185,2,1.94906838835034,40.25213770324941,21.100603045799875,19.151534657449535
0.384615385,0.625,22.5,10/21/2012,11,22,home,-7,PIT,105,264,20,49,17,24,Loss,80,167,0,3,2,CIN,41,185,431,1,-1.94906838835034,40.25213770324941,19.151534657449535,21.100603045799875
0.307692308,0.352941176,25.41666667,10/22/2012,21,19,away,-6,CHI,243,125,47,67,7,13,Loss,97,171,3,5,0,DET,20,340,296,4,-6.8506246085825975,40.76577634949937,16.957575870458385,23.808200479040984
0.352941176,0.307692308,34.58333333,10/22/2012,19,21,home,6,DET,125,243,49,69,13,7,Win,171,97,5,3,4,CHI,20,296,340,0,6.8506246085825975,40.76577634949937,23.808200479040984,16.957575870458385
0.470588235,0.384615385,37.75,10/25/2012,23,16,away,19,MIN,257,229,49,78,36,17,Win,159,140,1,3,3,TBB,53,416,369,0,-11.485076721905997,45.70680794052711,17.110865609310558,28.595942331216555
0.384615385,0.470588235,22.25,10/25/2012,16,23,home,-19,TBB,229,257,32,59,17,36,Loss,140,159,3,1,0,MIN,53,369,416,3,11.485076721905997,45.70680794052711,28.595942331216555,17.110865609310558
0.333333333,0.75,25.28333333,10/28/2012,21,26,away,-4,DET,236,331,10,54,24,28,Loss,133,84,0,2,1,SEA,52,369,415,2,3.6888467365946678,53.7148501055966,28.701848421095633,25.013001684500964
0.75,0.333333333,34.71666667,10/28/2012,26,21,home,4,SEA,331,236,61,73,28,24,Win,84,133,2,0,2,DET,52,415,369,1,-3.6888467365946678,53.7148501055966,25.013001684500964,28.701848421095633
0.3125,0.384615385,30.8,10/28/2012,18,20,away,-9,GBP,279,172,77,71,15,24,Loss,62,66,2,2,1,JAX,39,341,238,1,-8.788562012230821,39.70463436920171,15.458036178485447,24.246598190716266
0.384615385,0.3125,29.2,10/28/2012,20,18,home,9,JAX,172,279,33,64,24,15,Win,66,62,2,2,1,GBP,39,238,341,1,8.788562012230821,39.70463436920171,24.246598190716266,15.458036178485447
0.526315789,0.25,36.63333333,10/28/2012,21,18,away,-1,CHI,297,131,21,77,22,23,Loss,119,79,2,6,3,CAR,45,416,210,2,-5.965979377890122,44.49273051641373,19.263375569261804,25.229354947151926
0.25,0.526315789,23.36666667,10/28/2012,18,21,home,1,CAR,131,297,40,53,23,22,Win,79,119,6,2,2,CHI,45,210,416,3,5.965979377890122,44.49273051641373,25.229354947151926,19.263375569261804
0.538461538,0.46153846200000004,32.91666667,10/28/2012,24,20,away,13,PHI,246,178,40,68,30,17,Win,146,92,2,3,0,ATL,47,392,270,0,-1.7027696345199272,43.10189127768724,20.699560821583656,22.40233045610358
0.46153846200000004,0.538461538,27.08333333,10/28/2012,20,24,home,-13,ATL,178,246,57,62,17,30,Loss,92,146,3,2,0,PHI,47,270,392,0,1.7027696345199272,43.10189127768724,22.40233045610358,20.699560821583656
0.583333333,0.3,28.9,10/28/2012,29,17,away,38,LAR,321,219,42,66,45,7,Win,152,107,0,2,2,NEP,52,473,326,0,6.405898120885055,52.13125092331025,29.26857452209765,22.862676401212596
0.3,0.583333333,31.1,10/28/2012,17,29,home,-38,NEP,219,321,102,57,7,45,Loss,107,152,2,0,0,LAR,52,326,473,2,-6.405898120885055,52.13125092331025,22.862676401212596,29.26857452209765
0.5,0.454545455,33.93333333,10/28/2012,30,20,away,6,TEN,286,227,45,74,6,0,Win,171,112,2,2,0,IND,6,457,339,1,-2.5809474857984314,50.625741358510545,24.022396936356056,26.60334442215449
0.454545455,0.5,30.88333333,10/28/2012,20,30,home,-6,IND,227,286,65,56,0,6,Loss,112,171,2,2,1,TEN,6,339,457,0,2.5809474857984314,50.625741358510545,26.60334442215449,24.022396936356056
0.375,0.26666666699999997,30.86666667,10/28/2012,17,15,away,-1,CLE,148,117,15,69,6,7,Loss,117,133,1,2,0,LAC,13,265,250,1,-8.635061808849741,25.90882994649538,8.63688406882282,17.27194587767256
0.26666666699999997,0.375,29.13333333,10/28/2012,15,17,home,1,LAC,117,148,35,62,7,6,Win,133,117,2,1,1,CLE,13,250,265,0,8.635061808849741,25.90882994649538,17.27194587767256,8.63688406882282
0.25,0.363636364,26.78333333,10/28/2012,17,25,away,-15,PIT,169,215,55,57,12,27,Loss,86,140,1,1,0,WAS,39,255,355,0,1.1077650479827152,36.654540552013486,18.8811527999981,17.773387752015385
0.363636364,0.25,33.21666667,10/28/2012,25,17,home,15,WAS,215,169,20,61,27,12,Win,140,86,1,1,0,PIT,39,355,255,0,-1.1077650479827152,36.654540552013486,17.773387752015385,18.8811527999981
0.307692308,0.294117647,28.78333333,10/28/2012,14,22,away,21,NYJ,139,258,31,59,30,9,Win,97,105,2,4,2,MIA,39,236,363,1,-7.064613095066932,35.27973287984992,14.107559892391492,21.172172987458424
0.294117647,0.307692308,31.21666667,10/28/2012,22,14,home,-21,MIA,258,139,45,79,9,30,Loss,105,97,4,2,1,NYJ,39,363,236,2,7.064613095066932,35.27973287984992,21.172172987458424,14.107559892391492
0.166666667,0.307692308,28.96666667,10/28/2012,15,17,away,10,KCC,209,197,20,62,26,16,Win,135,102,0,3,4,OAK,42,344,299,1,0.7545054238657531,41.458171839821055,21.106338631843403,20.351833207977652
0.307692308,0.166666667,31.03333333,10/28/2012,17,15,home,-10,OAK,197,209,40,59,16,26,Loss,102,135,3,0,1,KCC,42,299,344,4,-0.7545054238657531,41.458171839821055,20.351833207977652,21.106338631843403
0.2,0.5,27.7,10/28/2012,11,28,away,5,DAL,190,415,45,58,29,24,Win,103,19,1,4,6,NYG,53,293,434,2,-6.4067353302543575,48.44924706369856,21.0212558667221,27.427991196976457
0.5,0.2,32.3,10/28/2012,28,11,home,-5,NYG,415,190,10,83,24,29,Loss,19,103,4,1,2,DAL,53,434,293,6,6.4067353302543575,48.44924706369856,27.427991196976457,21.0212558667221
0.083333333,0.384615385,24.76666667,10/28/2012,14,29,away,-20,DEN,201,305,15,60,14,34,Loss,51,225,1,0,1,NOS,48,252,530,1,5.623509504105741,45.60156509745275,25.612537300779245,19.989027796673504
0.384615385,0.083333333,35.23333333,10/28/2012,29,14,home,20,NOS,305,201,34,71,34,14,Win,225,51,0,1,1,DEN,48,530,252,1,-5.623509504105741,45.60156509745275,19.989027796673504,25.612537300779245
0.5,0.14285714300000002,31.26666667,10/29/2012,15,16,away,21,ARI,204,258,80,52,24,3,Win,113,7,4,4,1,SFO,27,317,265,0,0.8327726305251932,32.50645508857719,16.66961385955119,15.836841229026
0.14285714300000002,0.5,28.73333333,10/29/2012,16,15,home,-21,SFO,258,204,51,65,3,24,Loss,7,113,4,4,0,ARI,27,265,317,1,-0.8327726305251932,32.50645508857719,15.836841229026,16.66961385955119
0.583333333,0.444444444,31.51666667,11/1/2012,21,18,away,-18,LAC,176,216,37,60,13,31,Loss,113,123,1,1,2,KCC,44,289,339,4,8.378131181325283,48.08567879267408,28.23190498699968,19.8537738056744
0.444444444,0.583333333,28.48333333,11/1/2012,18,21,home,18,KCC,216,176,54,47,31,13,Win,123,113,1,1,4,LAC,44,339,289,2,-8.378131181325283,48.08567879267408,19.8537738056744,28.23190498699968
0.428571429,0.25,37.01666667,11/4/2012,21,12,away,31,TEN,205,180,37,65,51,20,Win,160,159,3,2,5,CHI,71,365,339,1,-3.644737052710351,45.234640443385416,20.79495169533753,24.439688748047885
0.25,0.428571429,22.98333333,11/4/2012,12,21,home,-31,CHI,180,205,68,55,20,51,Loss,159,160,2,3,1,TEN,71,339,365,5,3.644737052710351,45.234640443385416,24.439688748047885,20.79495169533753
0.666666667,0.545454545,35.5,11/4/2012,26,19,away,17,JAX,285,215,42,68,31,14,Win,149,64,1,1,2,DET,45,434,279,0,-4.918813861317409,52.5487936186719,23.814989878677245,28.733803739994656
0.545454545,0.666666667,24.5,11/4/2012,19,26,home,-17,DET,215,285,40,59,14,31,Loss,64,149,1,1,0,JAX,45,279,434,2,4.918813861317409,52.5487936186719,28.733803739994656,23.814989878677245
0.26666666699999997,0.4,26.5,11/4/2012,16,20,away,-14,GBP,286,208,57,66,17,31,Loss,54,176,2,1,1,ARI,48,340,384,2,-3.9910491347827985,41.4965338049677,18.75274233509245,22.743791469875248
0.4,0.26666666699999997,33.5,11/4/2012,20,16,home,14,ARI,208,286,5,70,31,17,Win,176,54,1,2,2,GBP,48,384,340,1,3.9910491347827985,41.4965338049677,22.743791469875248,18.75274233509245
0.363636364,0.684210526,25.1,11/4/2012,20,27,away,-3,IND,281,419,79,58,20,23,Loss,84,97,2,1,0,MIA,43,365,516,0,-5.208244322191378,54.94648075752126,24.86911821766494,30.077362539856317
0.684210526,0.363636364,34.9,11/4/2012,27,20,home,3,MIA,419,281,91,75,23,20,Win,97,84,1,2,0,IND,43,516,365,0,5.208244322191378,54.94648075752126,30.077362539856317,24.86911821766494
0.454545455,0.2,24.66666667,11/4/2012,18,24,away,8,WAS,201,186,60,50,21,13,Win,129,151,0,4,0,CAR,34,330,337,0,-11.30226595782306,41.51749913167595,15.107616586926444,26.409882544749504
0.2,0.454545455,35.33333333,11/4/2012,24,18,home,-8,CAR,186,201,97,75,13,21,Loss,151,129,4,0,0,WAS,34,337,330,0,11.30226595782306,41.51749913167595,26.409882544749504,15.107616586926444
0.181818182,0.363636364,25.95,11/4/2012,17,21,away,-12,HOU,230,256,15,57,9,21,Loss,74,118,4,2,0,BUF,30,304,374,1,3.8723787452103835,41.93608355744395,22.904231151327167,19.031852406116784
0.363636364,0.181818182,34.05,11/4/2012,21,17,home,12,BUF,256,230,42,61,21,9,Win,118,74,2,4,1,HOU,30,374,304,0,-3.8723787452103835,41.93608355744395,19.031852406116784,22.904231151327167
0.35714285700000004,0.3125,31.53333333,11/4/2012,18,17,away,10,CLE,145,174,82,62,25,15,Win,137,116,1,1,2,BAL,40,282,290,0,-1.4727327002425428,31.754330503651047,15.140798901704251,16.613531601946796
0.3125,0.35714285700000004,28.46666667,11/4/2012,17,18,home,-10,BAL,174,145,31,65,15,25,Loss,116,137,1,1,0,CLE,40,290,282,2,1.4727327002425428,31.754330503651047,16.613531601946796,15.140798901704253
0.642857143,0.35714285700000004,30.61666667,11/4/2012,20,22,away,8,CIN,291,275,29,61,31,23,Win,68,91,0,5,1,DEN,54,359,366,2,-0.26185402364097854,49.540267955255295,24.63920696580716,24.901060989448137
0.35714285700000004,0.642857143,29.38333333,11/4/2012,22,20,home,-8,DEN,275,291,83,72,23,31,Loss,91,68,5,0,2,CIN,54,366,359,1,0.26185402364097854,49.540267955255295,24.901060989448137,24.63920696580716
0.41666666700000005,0.35714285700000004,28.06666667,11/4/2012,23,25,away,10,OAK,237,402,116,63,42,32,Win,278,22,1,2,3,TBB,74,515,424,1,-12.999783389184852,61.20171756967578,24.10096709024546,37.10075047943032
0.35714285700000004,0.41666666700000005,31.93333333,11/4/2012,25,23,home,-10,TBB,402,237,80,75,32,42,Loss,22,278,2,1,1,OAK,74,424,515,3,12.999783389184852,61.20171756967578,37.10075047943032,24.10096709024546
0.3,0.333333333,24.0,11/4/2012,16,28,away,-10,SEA,44,190,33,53,20,30,Loss,243,195,4,1,0,MIN,50,287,385,2,4.42274287846414,40.11122578326819,22.266984330866165,17.844241452402024
0.333333333,0.3,36.0,11/4/2012,28,16,home,10,MIN,190,44,49,71,30,20,Win,195,243,1,4,2,SEA,50,385,287,0,-4.42274287846414,40.11122578326819,17.844241452402024,22.266984330866165
0.46153846200000004,0.2,35.25,11/4/2012,22,13,away,4,NYG,191,114,119,69,24,20,Win,158,68,4,2,1,PIT,44,349,182,2,-0.9711807026225985,37.50601106899809,18.267415183187747,19.238595885810344
0.2,0.46153846200000004,24.75,11/4/2012,13,22,home,-4,PIT,114,191,40,48,20,24,Loss,68,158,2,4,2,NYG,44,182,349,1,0.9711807026225985,37.50601106899809,19.238595885810344,18.267415183187747
0.3,0.5,27.28333333,11/4/2012,18,21,away,-6,ATL,312,330,50,54,13,19,Loss,65,123,1,3,0,DAL,32,377,453,0,4.50859048410779,44.973796195169626,24.74119333963871,20.232602855530917
0.5,0.3,32.71666667,11/4/2012,21,18,home,6,DAL,330,312,15,63,19,13,Win,123,65,3,1,0,ATL,32,453,377,0,-4.50859048410779,44.973796195169626,20.232602855530917,24.74119333963871
0.375,0.5555555560000001,33.5,11/5/2012,24,20,away,-15,NOS,226,231,58,77,13,28,Loss,221,140,7,2,2,PHI,41,447,371,2,3.636830632746384,53.61601858919489,28.626424610970634,24.989593978224253
0.5555555560000001,0.375,26.5,11/5/2012,20,24,home,15,PHI,231,226,35,54,28,13,Win,140,221,2,7,2,NOS,41,371,447,2,-3.636830632746384,53.61601858919489,24.989593978224253,28.626424610970634
0.272727273,0.1,35.76666667,11/8/2012,24,20,away,17,JAX,221,300,40,65,27,10,Win,138,37,2,4,3,IND,37,359,337,2,0.9125529349275165,47.67680233893565,24.294677636931585,23.382124702004067
0.1,0.272727273,24.23333333,11/8/2012,20,24,home,-17,IND,300,221,115,63,10,27,Loss,37,138,4,2,2,JAX,37,337,359,3,-0.9125529349275165,47.67680233893565,23.382124702004067,24.294677636931585
0.666666667,0.333333333,36.68333333,11/11/2012,23,12,away,-10,TBB,323,205,5,65,24,34,Loss,103,74,2,1,0,LAC,58,426,279,2,5.179755372124951,44.955797058823904,25.067776215474428,19.888020843349477
0.333333333,0.666666667,23.31666667,11/11/2012,12,23,home,10,LAC,205,323,5,43,34,24,Win,74,103,1,2,2,TBB,58,279,426,0,-5.179755372124951,44.955797058823904,19.888020843349477,25.067776215474428
0.111111111,0.26666666699999997,25.6,11/11/2012,23,18,away,-10,MIN,308,207,57,61,24,34,Loss,60,196,2,2,0,DET,58,368,403,2,0.7455405611160977,44.20817332433722,22.476856942726656,21.73131638161056
0.26666666699999997,0.111111111,34.4,11/11/2012,18,23,home,10,DET,207,308,47,68,34,24,Win,196,60,2,2,2,MIN,58,403,368,0,-0.7455405611160977,44.20817332433722,21.73131638161056,22.476856942726656
0.23076923100000002,0.0,28.43333333,11/11/2012,18,19,away,22,CAR,295,198,60,61,36,14,Win,65,52,1,7,2,DEN,50,360,250,2,2.761208437555922,40.57566197634329,21.668435206949606,18.907226769393684
0.0,0.23076923100000002,31.56666667,11/11/2012,19,18,home,-22,DEN,198,295,45,64,14,36,Loss,52,65,7,1,2,CAR,50,250,360,2,-2.761208437555922,40.57566197634329,18.907226769393684,21.668435206949606
0.5,0.4,32.58333333,11/11/2012,25,21,away,-4,NOS,408,292,53,71,27,31,Loss,46,148,1,1,1,ATL,58,454,440,1,0.49619978262229125,52.95416519333855,26.72518248798042,26.228982705358128
0.4,0.5,27.41666667,11/11/2012,21,25,home,4,ATL,292,408,35,62,31,27,Win,148,46,1,1,1,NOS,58,440,454,1,-0.49619978262229125,52.95416519333855,26.228982705358128,26.72518248798042
0.35714285700000004,0.46153846200000004,29.75,11/11/2012,21,15,away,-18,CIN,189,199,5,70,13,31,Loss,129,76,4,0,1,NYG,44,318,275,4,0.027573244661716956,41.88250413661118,20.95503869063645,20.927465445974732
0.46153846200000004,0.35714285700000004,30.25,11/11/2012,15,21,home,18,NYG,199,189,40,58,31,13,Win,76,129,0,4,4,CIN,44,275,318,1,-0.027573244661716956,41.88250413661118,20.927465445974732,20.95503869063645
0.444444444,0.41666666700000005,33.36666667,11/11/2012,19,22,away,-35,BAL,350,341,105,73,20,55,Loss,72,78,3,0,1,OAK,75,422,419,3,-4.086621441321281,55.406404267842206,25.65989141326046,29.746512854581745
0.41666666700000005,0.444444444,26.63333333,11/11/2012,22,19,home,35,OAK,341,350,41,62,55,20,Win,78,72,0,3,3,BAL,75,419,422,1,4.086621441321281,55.406404267842206,29.746512854581745,25.65989141326046
0.636363636,0.583333333,33.83333333,11/11/2012,35,27,away,-6,NEP,319,230,148,71,31,37,Loss,162,117,3,1,0,BUF,68,481,347,3,1.9717803274306673,62.71113004996921,32.34145518869994,30.369674861269274
0.583333333,0.636363636,26.16666667,11/11/2012,27,35,home,6,BUF,230,319,73,68,37,31,Win,117,162,1,3,3,NEP,68,347,481,0,-1.9717803274306673,62.71113004996921,30.369674861269274,32.34145518869994
0.470588235,0.153846154,33.21666667,11/11/2012,17,13,away,34,MIA,116,201,39,60,37,3,Win,177,54,1,2,4,TEN,40,293,255,0,-1.6037699682511004,35.53952956340593,16.967879797577414,18.571649765828514
0.153846154,0.470588235,26.78333333,11/11/2012,13,17,home,-34,TEN,201,116,67,56,3,37,Loss,54,177,2,1,0,MIA,40,255,293,4,1.6037699682511004,35.53952956340593,18.571649765828514,16.967879797577414
0.181818182,0.384615385,23.81666667,11/11/2012,11,20,away,-21,SEA,101,189,35,50,7,28,Loss,84,174,3,4,2,NYJ,35,185,363,3,5.434649783918095,35.26795067601494,20.35130022996652,14.916650446048422
0.384615385,0.181818182,36.18333333,11/11/2012,20,11,home,21,NYJ,189,101,45,67,28,7,Win,174,84,4,3,3,SEA,35,363,185,2,-5.434649783918095,35.26795067601494,14.916650446048422,20.35130022996652
0.4375,0.181818182,40.75,11/11/2012,27,25,away,0,SFO,299,158,85,80,24,24,Tie,159,183,2,5,0,LAR,48,458,341,1,-8.738862342393917,38.72508323828271,14.993110447944396,23.73197279033831
0.181818182,0.4375,34.25,11/11/2012,25,27,home,0,LAR,158,299,66,64,24,24,Tie,183,159,5,2,1,SFO,48,341,458,0,8.738862342393917,38.72508323828271,23.73197279033831,14.993110447944396
0.384615385,0.1,27.96666667,11/11/2012,14,23,away,15,PHI,193,278,75,54,38,23,Win,101,91,3,2,2,DAL,61,294,369,0,3.616330719462605,40.40185790103068,22.009094310246642,18.39276359078404
0.1,0.384615385,32.03333333,11/11/2012,23,14,home,-15,DAL,278,193,50,66,23,38,Loss,91,101,2,3,0,PHI,61,369,294,2,-3.616330719462605,40.40185790103068,18.39276359078404,22.009094310246642
0.214285714,0.153846154,31.13333333,11/11/2012,13,8,away,7,CHI,88,134,35,62,13,6,Win,127,115,1,0,4,HOU,19,215,249,2,-7.5172715792293765,28.500964929275156,10.491846675022892,18.009118254252265
0.153846154,0.214285714,28.86666667,11/11/2012,8,13,home,-7,HOU,134,88,49,56,6,13,Loss,115,127,0,1,2,CHI,19,249,215,4,7.5172715792293765,28.500964929275156,18.009118254252265,10.49184667502289
0.153846154,0.375,29.3,11/12/2012,14,14,away,-3,PIT,148,154,76,63,0,3,Loss,142,95,2,1,1,KCC,3,290,249,1,-5.222029526284386,27.382734896040986,11.0803526848783,16.302382211162687
0.375,0.153846154,31.61666667,11/12/2012,14,14,home,3,KCC,154,148,19,62,3,0,Win,95,142,1,2,1,PIT,3,249,290,1,5.222029526284386,27.382734896040986,16.302382211162687,11.0803526848783
0.3,0.166666667,24.95,11/15/2012,16,18,away,-5,BUF,124,161,69,55,14,19,Loss,60,120,3,3,0,MIA,33,184,281,3,1.836714031914143,32.56009528031815,17.198404656116146,15.361690624202005
0.166666667,0.3,35.05,11/15/2012,18,16,home,5,MIA,161,124,100,61,19,14,Win,120,60,3,3,3,BUF,33,281,184,0,-1.836714031914143,32.56009528031815,15.361690624202005,17.198404656116146
0.46666666700000003,0.3125,33.05,11/18/2012,17,15,away,14,LAR,165,167,20,65,27,13,Win,124,114,3,1,3,NYJ,40,289,281,0,-8.658785425150612,36.254347234740926,13.797780904795157,22.45656632994577
0.3125,0.46666666700000003,26.95,11/18/2012,15,17,home,-14,NYJ,167,165,30,65,13,27,Loss,114,124,1,3,0,LAR,40,281,289,3,8.658785425150612,36.254347234740926,22.45656632994577,13.797780904795157
0.4,0.28571428600000004,30.71666667,11/18/2012,19,30,away,-3,DAL,192,257,129,70,0,3,Loss,119,63,2,7,1,CLE,3,311,320,1,-15.136905382344802,33.21959994943722,9.041347283546209,24.17825266589101
0.28571428600000004,0.4,38.16666667,11/18/2012,30,19,home,3,CLE,257,192,92,78,3,0,Win,63,119,7,2,1,DAL,3,320,311,1,15.136905382344802,33.21959994943722,24.17825266589101,9.041347283546209
0.38888888899999996,0.529411765,32.5,11/18/2012,25,18,away,6,CAR,236,234,50,77,6,0,Win,167,97,1,2,1,TBB,6,403,331,3,-19.342521360664684,46.912688139107146,13.785083389221228,33.12760474988592
0.529411765,0.38888888899999996,31.83333333,11/18/2012,18,25,home,-6,TBB,234,236,91,65,0,6,Loss,97,167,2,1,3,CAR,6,331,403,1,19.342521360664684,46.912688139107146,33.12760474988592,13.785083389221231
0.125,0.4375,27.31666667,11/18/2012,7,20,away,-4,ATL,41,296,43,56,19,23,Loss,137,58,3,1,6,ARI,42,178,354,1,-3.0841829408324513,31.07002784732247,13.992922453245011,17.07710539407746
0.4375,0.125,32.68333333,11/18/2012,20,7,home,4,ARI,296,41,35,71,23,19,Win,58,137,1,3,1,ATL,42,354,178,6,3.0841829408324513,31.07002784732247,17.077105394077464,13.99292245324501
0.28571428600000004,0.090909091,35.36666667,11/18/2012,22,16,away,22,KCC,220,171,54,69,28,6,Win,189,113,2,4,1,CIN,34,409,284,0,1.9955832532253233,35.01773263203968,18.5066579426325,16.51107468940718
0.090909091,0.28571428600000004,24.63333333,11/18/2012,16,22,home,-22,CIN,171,220,30,60,6,28,Loss,113,189,4,2,0,KCC,34,284,409,1,-1.9955832532253233,35.01773263203968,16.51107468940718,18.5066579426325
0.46153846200000004,0.4,30.3,11/18/2012,16,19,away,4,DET,219,252,80,59,24,20,Win,95,110,3,5,4,GBP,44,314,362,1,-1.7935466991427518,47.662144951868825,22.934299126363037,24.72784582550579
0.4,0.46153846200000004,29.7,11/18/2012,19,16,home,-4,GBP,252,219,50,68,20,24,Loss,110,95,5,3,1,DET,44,362,314,4,1.7935466991427518,47.662144951868825,24.72784582550579,22.934299126363037
0.28571428600000004,0.363636364,31.31666667,11/18/2012,17,39,away,-6,HOU,372,504,54,66,3,9,Loss,86,149,2,2,3,JAX,12,458,653,1,-11.45654723857588,58.84963351391878,23.696543137671448,35.153090376247334
0.363636364,0.28571428600000004,41.66666667,11/18/2012,39,17,home,6,JAX,504,372,20,92,9,3,Win,149,86,2,2,1,HOU,12,653,458,3,11.45654723857588,58.84963351391878,35.153090376247334,23.69654313767145
0.36842105299999994,0.454545455,31.4,11/18/2012,16,15,away,-25,WAS,177,192,70,71,6,31,Loss,80,169,4,2,0,PHI,37,257,361,3,-7.320055559818982,39.93175592443281,16.305850182306912,23.625905742125894
0.454545455,0.36842105299999994,28.6,11/18/2012,15,16,home,25,PHI,192,177,80,51,31,6,Win,169,80,2,4,3,WAS,37,361,257,0,7.320055559818982,39.93175592443281,23.625905742125894,16.305850182306912
0.545454545,0.333333333,28.6,11/18/2012,19,24,away,21,OAK,229,284,109,56,38,17,Win,151,120,0,3,2,NOS,55,380,404,0,-2.5168327721911936,53.60185980476939,25.542513516289098,28.05934628848029
0.333333333,0.545454545,31.4,11/18/2012,24,19,home,-21,NOS,284,229,40,69,17,38,Loss,120,151,3,0,0,OAK,55,404,380,2,2.5168327721911936,53.60185980476939,28.05934628848029,25.542513516289098
0.571428571,0.666666667,32.91666667,11/18/2012,28,25,away,-35,NEP,329,331,5,75,24,59,Loss,119,115,1,0,0,IND,83,448,446,4,7.935490360205122,62.37041267667351,35.152951518439316,27.217461158234194
0.666666667,0.571428571,27.08333333,11/18/2012,25,28,home,35,IND,331,329,70,60,59,24,Win,115,119,0,1,4,NEP,83,446,448,0,-7.935490360205122,62.37041267667351,27.217461158234194,35.152951518439316
0.1875,0.375,31.3,11/18/2012,13,21,away,-7,DEN,224,253,65,67,23,30,Loss,53,133,4,3,2,LAC,53,277,386,3,-5.213051827934297,40.058191559875986,17.422569865970843,22.635621693905144
0.375,0.1875,28.7,11/18/2012,21,13,home,7,LAC,253,224,30,70,30,23,Win,133,53,3,4,3,DEN,53,386,277,2,5.213051827934297,40.058191559875986,22.635621693905144,17.422569865970843
0.214285714,0.294117647,27.15,11/18/2012,12,17,away,3,PIT,153,175,68,57,13,10,Win,47,134,2,3,3,BAL,23,200,309,0,-0.08741036296377525,28.134972787673583,14.023781212354903,14.11119157531868
0.294117647,0.214285714,32.85,11/18/2012,17,12,home,-3,BAL,175,153,43,69,10,13,Loss,134,47,3,2,0,PIT,23,309,200,3,0.08741036296377525,28.134972787673583,14.11119157531868,14.023781212354903
0.25,0.333333333,29.91666667,11/19/2012,12,18,away,-25,SFO,58,232,55,56,7,32,Loss,85,121,6,2,0,CHI,39,143,353,2,2.790629351536289,30.611712858567785,16.701171105052037,13.910541753515748
0.333333333,0.25,30.08333333,11/19/2012,18,12,home,25,CHI,232,58,50,54,32,7,Win,121,85,2,6,2,SFO,39,353,143,0,-2.790629351536289,30.611712858567785,13.910541753515748,16.701171105052037
0.4,0.5,35.63333333,11/22/2012,26,29,away,3,DET,296,419,66,78,3,0,Win,205,106,2,3,1,HOU,3,501,525,1,-20.41532034370367,53.65344786813227,16.619063762214303,37.034384105917965
0.5,0.4,37.01666667,11/22/2012,29,26,home,-3,HOU,419,296,70,87,0,3,Loss,106,205,3,2,1,DET,3,525,501,1,20.41532034370367,53.65344786813227,37.034384105917965,16.6190637622143
0.5,0.470588235,31.7,11/22/2012,22,22,away,7,DAL,288,423,41,62,38,31,Win,149,35,3,2,3,WAS,69,437,458,1,-9.228215492460256,53.511825089957014,22.141804798748378,31.370020291208636
0.470588235,0.5,28.3,11/22/2012,22,22,home,-7,WAS,423,288,45,75,31,38,Loss,35,149,2,3,1,DAL,69,458,437,3,9.228215492460256,53.511825089957014,31.370020291208636,22.141804798748378
0.7333333329999999,0.3,29.56666667,11/22/2012,25,25,away,30,NYJ,323,286,37,66,49,19,Win,152,119,0,2,5,NEP,68,475,405,1,9.185712090033718,60.77519607815791,34.98045408409581,25.794741994062097
0.3,0.7333333329999999,30.43333333,11/22/2012,25,25,home,-30,NEP,286,323,35,67,19,49,Loss,119,152,2,0,1,NYJ,68,405,475,5,-9.185712090033718,60.77519607815791,25.7947419940621,34.98045408409581
0.111111111,0.1875,26.5,11/25/2012,13,14,away,-6,CLE,193,130,68,55,14,20,Loss,49,108,1,4,1,PIT,34,242,238,8,1.0074584407286693,31.867585932219804,16.437522186474236,15.430063745745567
0.1875,0.111111111,33.5,11/25/2012,14,13,home,6,PIT,130,193,90,64,20,14,Win,108,49,4,1,8,CLE,34,238,242,1,-1.0074584407286693,31.867585932219804,15.430063745745567,16.437522186474236
0.5,0.214285714,28.28333333,11/25/2012,21,13,away,8,KCC,273,116,35,63,17,9,Win,95,148,2,2,1,DEN,26,368,264,1,1.189910867002343,38.398115925361616,19.79401339618198,18.604102529179634
0.214285714,0.5,31.71666667,11/25/2012,13,21,home,-8,DEN,116,273,50,59,9,17,Loss,148,95,2,2,1,KCC,26,264,368,1,-1.189910867002343,38.398115925361616,18.604102529179634,19.79401339618198
0.25,0.529411765,29.23333333,11/25/2012,14,18,away,-24,CIN,119,194,25,61,10,34,Loss,99,221,4,2,0,OAK,44,218,415,2,-3.779586657508741,39.367606192515844,17.794009767503553,21.57359642501229
0.529411765,0.25,30.76666667,11/25/2012,18,14,home,24,OAK,194,119,25,66,34,10,Win,221,99,2,4,2,CIN,44,415,218,0,3.779586657508741,39.367606192515844,21.57359642501229,17.794009767503553
0.5,0.444444444,31.98333333,11/25/2012,16,23,away,-3,MIA,216,246,59,56,21,24,Loss,96,189,2,1,1,SEA,45,312,435,0,9.644021088892861,45.41792049201387,27.530970790453367,17.886949701560503
0.444444444,0.5,28.01666667,11/25/2012,23,16,home,3,SEA,246,216,15,55,24,21,Win,189,96,1,2,0,MIA,45,435,312,1,-9.644021088892861,45.41792049201387,17.886949701560503,27.530970790453367
0.4,0.5,30.61666667,11/25/2012,20,19,away,-5,JAX,250,221,42,70,19,24,Loss,110,100,1,7,1,TEN,43,360,321,2,-7.785732538810818,45.51531473208278,18.86479109663598,26.6505236354468
0.5,0.4,29.38333333,11/25/2012,19,20,home,5,TEN,221,250,30,60,24,19,Win,100,110,7,1,2,JAX,43,321,360,1,7.785732538810818,45.51531473208278,26.6505236354468,18.86479109663598
0.615384615,0.4,29.36666667,11/25/2012,20,16,away,1,TBB,345,276,15,57,24,23,Win,79,50,1,2,0,ATL,47,424,326,2,4.416671199542005,46.57593983295226,25.496305516247133,21.079634316705125
0.4,0.615384615,30.63333333,11/25/2012,16,20,home,-1,ATL,276,345,24,54,23,24,Loss,50,79,2,1,2,TBB,47,326,424,0,-4.416671199542005,46.57593983295226,21.079634316705125,25.496305516247133
0.307692308,0.5,28.36666667,11/25/2012,16,22,away,-7,IND,169,225,46,58,13,20,Loss,135,87,2,4,2,BUF,33,304,312,1,-1.3276938523360842,42.18789150463654,20.43009882615023,21.75779267848631
0.5,0.307692308,31.63333333,11/25/2012,22,16,home,7,BUF,225,169,37,70,20,13,Win,87,135,4,2,1,IND,33,312,304,2,1.3276938523360842,42.18789150463654,21.75779267848631,20.43009882615023
0.375,0.578947368,22.5,11/25/2012,15,23,away,-18,CHI,144,183,44,65,10,28,Loss,114,113,2,1,2,MIN,38,258,296,3,-11.780713984185606,40.1320524419891,14.175669228901747,25.956383213087356
0.578947368,0.375,37.5,11/25/2012,23,15,home,18,MIN,183,144,55,71,28,10,Win,113,114,1,2,3,CHI,38,296,258,2,11.780713984185606,40.1320524419891,25.956383213087356,14.175669228901748
0.5,0.2,39.03333333,11/25/2012,25,16,away,3,LAC,316,189,60,91,3,0,Win,127,91,5,6,0,BAL,3,443,280,0,-12.85728676794556,27.429957027338574,7.286335129696507,20.143621897642067
0.2,0.5,34.85,11/25/2012,16,25,home,-3,BAL,189,316,37,65,0,3,Loss,91,127,6,5,0,LAC,3,280,443,0,12.85728676794556,27.429957027338574,20.143621897642067,7.286335129696507
0.272727273,0.307692308,28.15,11/25/2012,15,24,away,14,ARI,194,301,84,54,31,17,Win,173,74,2,2,4,LAR,48,367,375,1,-5.110948113832716,45.14172021819779,20.015386052182535,25.126334166015255
0.307692308,0.272727273,31.85,11/25/2012,24,15,home,-14,LAR,301,194,56,77,17,31,Loss,74,173,2,2,1,ARI,48,375,367,4,5.110948113832716,45.14172021819779,25.126334166015255,20.015386052182535
0.46153846200000004,0.272727273,30.1,11/25/2012,18,19,away,10,NOS,231,231,68,56,31,21,Win,144,59,0,5,2,SFO,52,375,290,2,1.8893576127168927,42.68340828157181,22.28638294714435,20.397025334427457
0.272727273,0.46153846200000004,29.9,11/25/2012,19,18,home,-10,SFO,231,231,53,67,21,31,Loss,59,144,5,0,2,NOS,52,290,375,2,-1.8893576127168927,42.68340828157181,20.397025334427457,22.28638294714435
0.41666666700000005,0.5,28.78333333,11/25/2012,16,23,away,-28,NYG,201,243,49,58,10,38,Loss,116,147,5,1,0,GBP,48,317,390,2,2.78193791564086,48.67860421192824,25.73027106378455,22.94833314814369
0.5,0.41666666700000005,31.21666667,11/25/2012,23,16,home,28,GBP,243,201,24,62,38,10,Win,147,116,1,5,2,NYG,48,390,317,0,-2.78193791564086,48.67860421192824,22.94833314814369,25.73027106378455
0.5,0.25,35.2,11/26/2012,24,18,away,8,PHI,289,107,101,65,30,22,Win,109,204,2,1,3,CAR,52,398,311,0,4.791364440174831,52.088293942338936,28.439829191256884,23.648464751082052
0.25,0.5,24.8,11/26/2012,18,24,home,-8,CAR,107,289,30,48,22,30,Loss,204,109,1,2,0,PHI,52,311,398,3,-4.791364440174831,52.088293942338936,23.648464751082052,28.439829191256884
0.5,0.090909091,33.73333333,11/29/2012,24,15,away,-10,ATL,335,159,30,74,13,23,Loss,101,124,1,1,1,NOS,36,436,283,5,2.6921605854929087,43.82804898711784,23.260104786305373,20.567944200812466
0.090909091,0.5,26.26666667,11/29/2012,15,24,home,10,NOS,159,335,25,57,23,13,Win,124,101,1,1,5,ATL,36,283,436,1,-2.6921605854929087,43.82804898711784,20.567944200812466,23.260104786305373
0.1,0.41666666700000005,24.85,12/2/2012,21,20,away,-16,BUF,186,112,74,63,18,34,Loss,50,232,3,0,2,JAX,52,236,344,2,-5.272364420908264,41.794682097046376,18.261158838069058,23.53352325897732
0.41666666700000005,0.1,35.15,12/2/2012,20,21,home,16,JAX,112,186,100,63,34,18,Win,232,50,0,3,2,BUF,52,344,236,2,5.272364420908264,41.794682097046376,23.53352325897732,18.261158838069058
0.26666666699999997,0.352941176,22.36666667,12/2/2012,23,21,away,2,DET,372,313,36,74,35,33,Win,87,138,2,0,1,IND,68,459,451,3,-8.743795024964353,53.59782655417601,22.427015764605827,31.170810789570183
0.352941176,0.26666666699999997,37.63333333,12/2/2012,21,23,home,-2,IND,313,372,61,75,33,35,Loss,138,87,0,2,3,DET,68,451,459,1,8.743795024964353,53.59782655417601,31.170810789570183,22.427015764605827
0.6,0.428571429,22.78333333,12/2/2012,19,23,away,-6,KCC,220,197,45,51,21,27,Loss,165,158,2,1,0,CAR,48,385,355,0,-0.6497916419730756,47.46883457336352,23.409521465695224,24.0593131076683
0.428571429,0.6,37.21666667,12/2/2012,23,19,home,6,CAR,197,220,5,67,27,21,Win,158,165,1,2,0,KCC,48,355,385,0,0.6497916419730756,47.46883457336352,24.0593131076683,23.409521465695224
0.0,0.35714285700000004,21.86666667,12/2/2012,5,20,away,-1,NYJ,56,112,30,54,6,7,Loss,81,177,2,3,4,ARI,13,137,289,1,-4.5266932004129234,23.326430076141325,9.3998684378642,13.926561638277125
0.35714285700000004,0.0,38.13333333,12/2/2012,20,5,home,1,ARI,112,56,20,74,7,6,Win,177,81,3,2,1,NYJ,13,289,137,4,4.5266932004129234,23.326430076141325,13.926561638277125,9.3998684378642
0.42105263200000004,0.1875,38.9,12/2/2012,18,16,away,-3,LAR,191,208,97,71,0,3,Loss,148,85,3,2,0,SFO,3,339,293,1,-15.990099444372085,26.179371315668092,5.094635935648004,21.08473538002009
0.1875,0.42105263200000004,35.66666667,12/2/2012,16,18,home,3,SFO,208,191,65,68,3,0,Win,85,148,2,3,1,LAR,3,293,339,0,15.990099444372085,26.179371315668092,21.08473538002009,5.094635935648004
0.235294118,0.26666666699999997,33.8,12/2/2012,16,17,away,14,TEN,207,265,97,70,24,10,Win,124,89,0,6,6,HOU,34,331,354,0,-14.566222743180745,42.1299477776719,13.781862517245578,28.348085260426323
0.26666666699999997,0.235294118,26.2,12/2/2012,17,16,home,-14,HOU,265,207,35,68,10,24,Loss,89,124,6,0,0,TEN,34,354,331,6,14.566222743180745,42.1299477776719,28.348085260426323,13.781862517245578
0.5,0.5625,21.5,12/2/2012,16,22,away,-9,GBP,119,283,48,53,14,23,Loss,240,152,0,2,1,MIN,37,359,435,2,-4.704426887976487,51.73366482140075,23.51461896671213,28.21904585468862
0.5625,0.5,38.5,12/2/2012,22,16,home,9,MIN,283,119,78,73,23,14,Win,152,240,2,0,2,GBP,37,435,359,1,4.704426887976487,51.73366482140075,28.21904585468862,23.51461896671213
0.46666666700000003,0.23076923100000002,33.4,12/2/2012,25,15,away,7,MIA,213,176,50,76,23,16,Win,108,101,4,3,1,NEP,39,321,277,1,1.7524624133788311,35.76740582009471,18.75993411673677,17.00747170335794
0.23076923100000002,0.46666666700000003,26.6,12/2/2012,15,25,home,-7,NEP,176,213,77,59,16,23,Loss,101,108,3,4,1,MIA,39,277,321,1,-1.7524624133788311,35.76740582009471,17.00747170335794,18.75993411673677
0.533333333,0.5,34.58333333,12/2/2012,25,22,away,6,CHI,283,233,55,71,6,0,Win,176,132,2,0,0,SEA,6,459,365,1,-2.357765472927724,46.69922458131814,22.17072955419521,24.528495027122933
0.5,0.533333333,32.86666667,12/2/2012,22,25,home,-6,SEA,233,283,45,59,0,6,Loss,132,176,0,2,1,CHI,6,365,459,0,2.357765472927724,46.69922458131814,24.528495027122933,22.17072955419521
0.25,0.363636364,26.55,12/2/2012,18,25,away,-8,DEN,235,242,80,61,23,31,Loss,71,91,1,0,1,TBB,54,306,333,1,-4.557223715651751,42.9294990834045,19.186137683876375,23.743361399528126
0.363636364,0.25,33.45,12/2/2012,25,18,home,8,TBB,242,235,75,67,31,23,Win,91,71,0,1,1,DEN,54,333,306,1,4.557223715651751,42.9294990834045,23.743361399528126,19.186137683876375
0.5,0.333333333,33.3,12/2/2012,21,20,away,7,LAC,211,251,55,71,20,13,Win,128,46,1,4,2,CIN,33,339,297,3,-3.090005576011269,43.51208659605311,20.21104051002092,23.30104608603219
0.333333333,0.5,26.7,12/2/2012,20,21,home,-7,CIN,251,211,55,63,13,20,Loss,46,128,4,1,3,LAC,33,297,339,2,3.090005576011269,43.51208659605311,23.30104608603219,20.21104051002092
0.272727273,0.5625,32.5,12/2/2012,23,25,away,3,OAK,353,344,25,67,20,17,Win,122,85,1,1,1,CLE,37,475,429,2,-5.969240040550643,57.28313923764103,25.656949598545193,31.626189639095838
0.5625,0.272727273,27.5,12/2/2012,25,23,home,-3,CLE,344,353,65,72,17,20,Loss,85,122,1,1,2,OAK,37,429,475,1,5.969240040550643,57.28313923764103,31.626189639095838,25.656949598545193
0.384615385,0.272727273,34.35,12/2/2012,19,19,away,3,BAL,270,177,50,65,23,20,Win,96,111,2,3,2,PIT,43,366,288,3,6.641541188550589,42.01938795622179,24.33046457238619,17.6889233838356
0.272727273,0.384615385,25.65,12/2/2012,19,19,home,-3,PIT,177,270,70,58,20,23,Loss,111,96,3,2,3,BAL,43,288,366,2,-6.641541188550589,42.01938795622179,17.6889233838356,24.33046457238619
0.6,0.642857143,26.7,12/2/2012,23,22,away,-5,DAL,240,294,5,61,33,38,Loss,183,123,1,2,0,PHI,71,423,417,1,1.9136935773957466,55.055608736134296,28.484651156765022,26.570957579369274
0.642857143,0.6,33.3,12/2/2012,22,23,home,5,PHI,294,240,60,62,38,33,Win,123,183,2,1,1,DAL,71,417,423,0,-1.9136935773957466,55.055608736134296,26.570957579369274,28.484651156765022
0.6,0.5,33.21666667,12/3/2012,21,20,away,-1,WAS,273,163,73,63,16,17,Loss,117,207,1,0,1,NYG,33,390,370,0,-5.204614787031204,50.72382916447256,22.75960718872068,27.964221975751883
0.5,0.6,26.78333333,12/3/2012,20,21,home,1,NYG,163,273,56,52,17,16,Win,207,117,0,1,0,WAS,33,370,390,1,5.204614787031204,50.72382916447256,27.964221975751883,22.75960718872068
0.5,0.25,37.31666667,12/6/2012,30,14,away,13,OAK,288,263,25,78,26,13,Win,140,61,3,1,2,DEN,39,428,324,1,1.914193242300442,54.38251062607435,28.148351934187396,26.234158691886954
0.25,0.5,22.68333333,12/6/2012,14,30,home,-13,DEN,263,288,94,47,13,26,Loss,61,140,1,3,1,OAK,39,324,428,2,-1.914193242300442,54.38251062607435,26.234158691886954,28.148351934187396
0.41176470600000004,0.428571429,31.7,12/9/2012,22,17,away,-7,MIN,320,77,80,73,14,21,Loss,118,171,2,1,1,CHI,35,438,248,2,-8.183301733574774,43.959804657911604,17.888251462168416,26.07155319574319
0.428571429,0.41176470600000004,28.3,12/9/2012,17,22,home,7,CHI,77,320,54,56,21,14,Win,171,118,1,2,2,MIN,35,248,438,1,8.183301733574774,43.959804657911604,26.07155319574319,17.888251462168416
0.307692308,0.125,30.51666667,12/9/2012,17,16,away,7,JAX,104,168,15,62,17,10,Win,166,123,1,3,2,NYJ,27,270,291,2,-7.802100930409711,34.299013681704636,13.248456375647464,21.050557306057172
0.125,0.307692308,29.48333333,12/9/2012,16,17,home,-7,NYJ,168,104,54,70,10,17,Loss,123,166,3,1,2,JAX,27,291,270,2,7.802100930409711,34.299013681704636,21.050557306057172,13.248456375647462
0.363636364,0.333333333,28.61666667,12/9/2012,17,20,away,-4,IND,259,171,70,60,23,27,Loss,97,98,1,4,2,TEN,50,356,269,2,-4.8951554785054565,42.42064478281018,18.76274465215236,23.65790013065782
0.333333333,0.363636364,31.38333333,12/9/2012,20,17,home,4,TEN,171,259,43,68,27,23,Win,98,97,4,1,2,IND,50,269,356,2,4.8951554785054565,42.42064478281018,23.65790013065782,18.76274465215236
0.578947368,0.363636364,30.18333333,12/9/2012,20,19,away,1,CIN,239,190,49,70,20,19,Win,49,146,3,5,1,DAL,39,288,336,1,-3.029161498132667,39.65824319524323,18.314540848555282,21.343702346687948
0.363636364,0.578947368,29.81666667,12/9/2012,19,20,home,-1,DAL,190,239,70,58,19,20,Loss,146,49,5,3,1,CIN,39,336,288,1,3.029161498132667,39.65824319524323,21.343702346687948,18.314540848555282
0.545454545,0.384615385,36.76666667,12/9/2012,19,18,away,10,PIT,200,271,51,79,34,24,Win,94,69,1,2,2,LAC,58,294,340,0,-13.333406685937446,38.121119658228004,12.393856486145278,25.727263172082726
0.384615385,0.545454545,23.23333333,12/9/2012,18,19,home,-10,LAC,271,200,52,61,24,34,Loss,69,94,2,1,0,PIT,58,340,294,2,13.333406685937446,38.121119658228004,25.727263172082726,12.393856486145278
0.41176470600000004,0.25,29.4,12/9/2012,17,17,away,3,BUF,207,220,17,67,15,12,Win,78,61,1,5,2,LAR,27,285,281,1,-0.9655760754527165,37.43638167977319,18.235402802160237,19.200978877612954
0.25,0.41176470600000004,30.6,12/9/2012,17,17,home,-3,LAR,220,207,15,58,12,15,Loss,61,78,5,1,1,BUF,27,281,285,2,0.9655760754527165,37.43638167977319,19.200978877612954,18.235402802160237
0.090909091,0.333333333,26.51666667,12/9/2012,12,20,away,-23,CLE,130,198,35,52,7,30,Loss,180,154,5,3,0,KCC,37,310,352,1,1.0677634674195957,30.806691105972654,15.937227286696125,14.869463819276529
0.333333333,0.090909091,33.48333333,12/9/2012,20,12,home,23,KCC,198,130,55,68,30,7,Win,154,180,3,5,1,CLE,37,352,310,0,-1.0677634674195957,30.806691105972654,14.869463819276529,15.937227286696125
0.38888888899999996,0.375,29.85,12/9/2012,23,18,away,2,TBB,338,178,13,73,23,21,Win,29,136,6,2,0,PHI,44,367,314,1,-9.061455208767976,41.17323881756608,16.055891804399053,25.117347013167027
0.375,0.38888888899999996,30.15,12/9/2012,18,23,home,-2,PHI,178,338,64,68,21,23,Loss,136,29,2,6,1,TBB,44,314,367,0,9.061455208767976,41.17323881756608,25.117347013167027,16.055891804399053
0.5,0.363636364,29.36666667,12/9/2012,18,22,away,-3,WAS,173,244,56,58,0,3,Loss,186,179,2,3,1,BAL,3,359,423,2,-0.9550895627577858,44.30703661641139,21.6759735268268,22.631063089584586
0.363636364,0.5,34.01666667,12/9/2012,22,18,home,3,BAL,244,173,70,66,3,0,Win,179,186,3,2,2,WAS,3,423,359,1,0.9550895627577858,44.30703661641139,22.631063089584586,21.6759735268268
0.25,0.6,24.21666667,12/9/2012,25,23,away,-10,CAR,327,280,15,62,20,30,Loss,35,195,2,1,0,ATL,50,362,475,1,-0.22891433992520405,51.60338971311529,25.687237686595044,25.916152026520248
0.6,0.25,35.78333333,12/9/2012,23,25,home,10,ATL,280,327,10,68,30,20,Win,195,35,1,2,1,CAR,50,475,362,0,0.22891433992520405,51.60338971311529,25.916152026520248,25.687237686595044
0.384615385,0.2,29.46666667,12/9/2012,17,20,away,-14,SFO,133,166,43,57,13,27,Loss,94,155,2,4,0,MIA,40,227,321,1,7.62554612446257,33.29527743341028,20.460411778936425,12.834865654473854
0.2,0.384615385,30.53333333,12/9/2012,20,17,home,14,MIA,166,133,45,55,27,13,Win,155,94,4,2,1,SFO,40,321,227,0,-7.62554612446257,33.29527743341028,12.834865654473852,20.460411778936425
0.384615385,0.454545455,30.3,12/9/2012,22,24,away,-25,NYG,345,259,81,68,27,52,Loss,142,135,1,0,2,NOS,79,487,394,4,0.0176066264216459,60.131567160782936,30.07458689360229,30.056980267180645
0.454545455,0.384615385,29.7,12/9/2012,24,22,home,25,NOS,259,345,55,62,52,27,Win,135,142,0,1,4,NYG,79,394,487,2,-0.0176066264216459,60.131567160782936,30.056980267180645,30.07458689360229
0.28571428600000004,0.272727273,25.55,12/9/2012,10,22,away,-58,SEA,111,209,79,58,0,58,Loss,43,284,3,1,1,ARI,58,154,493,8,0.29014973024306556,41.3944787096172,20.842314219930135,20.55216448968707
0.272727273,0.28571428600000004,34.45,12/9/2012,22,10,home,58,ARI,209,111,97,65,58,0,Win,284,43,1,3,8,SEA,58,493,154,1,-0.29014973024306556,41.3944787096172,20.55216448968707,20.842314219930135
0.647058824,0.454545455,37.23333333,12/9/2012,27,15,away,-7,GBP,251,148,55,78,20,27,Loss,135,140,1,3,1,DET,47,386,288,2,-3.7615081983710095,49.46290982172786,22.850700811678426,26.612209010049437
0.454545455,0.647058824,22.76666667,12/9/2012,15,27,home,7,DET,148,251,50,52,27,20,Win,140,135,3,1,2,GBP,47,288,386,1,3.7615081983710095,49.46290982172786,26.612209010049437,22.850700811678426
0.28571428600000004,0.5,29.18333333,12/10/2012,19,27,away,-28,NEP,223,289,70,65,14,42,Loss,100,130,2,1,1,HOU,56,323,419,1,0.05204777405254646,47.155399530948046,23.603723652500296,23.55167587844775
0.5,0.28571428600000004,30.81666667,12/10/2012,27,19,home,28,HOU,289,223,56,70,42,14,Win,130,100,1,2,1,NEP,56,419,323,1,-0.05204777405254646,47.155399530948046,23.55167587844775,23.603723652500296
0.38888888899999996,0.25,37.66666667,12/13/2012,18,10,away,21,PHI,92,177,94,74,34,13,Win,157,42,6,1,5,CIN,47,249,219,2,-2.770767070757026,35.56168974517442,16.395461337208697,19.166228407965722
0.25,0.38888888899999996,22.33333333,12/13/2012,10,18,home,-21,CIN,177,92,76,53,13,34,Loss,42,157,1,6,2,PHI,47,219,249,5,2.770767070757026,35.56168974517442,19.166228407965722,16.395461337208697
0.3125,0.083333333,38.56666667,12/16/2012,21,12,away,17,BAL,187,222,51,75,34,17,Win,163,56,2,3,2,DEN,51,350,278,0,-2.24778959331589,32.81369092871446,15.282950667699282,17.530740261015175
0.083333333,0.3125,21.43333333,12/16/2012,12,21,home,-17,DEN,222,187,61,62,17,34,Loss,56,163,3,2,0,BAL,51,278,350,2,2.24778959331589,32.81369092871446,17.530740261015175,15.282950667699284
0.4,0.545454545,24.36666667,12/16/2012,13,26,away,-21,MIA,213,209,88,57,3,24,Loss,86,180,2,1,1,JAX,27,299,389,0,-5.6437660779884435,44.23645768731488,19.29634580466322,24.940111882651664
0.545454545,0.4,35.63333333,12/16/2012,26,13,home,21,JAX,209,213,41,66,24,3,Win,180,86,1,2,0,MIA,27,389,299,1,5.6437660779884435,44.23645768731488,24.940111882651664,19.29634580466322
0.46666666700000003,0.333333333,36.28333333,12/16/2012,25,13,away,17,CLE,308,233,45,74,38,21,Win,122,58,2,2,2,WAS,59,430,291,1,-4.638240851858711,42.14636045337426,18.754059800757773,23.392300652616484
0.333333333,0.46666666700000003,23.71666667,12/16/2012,13,25,home,-17,WAS,233,308,30,52,21,38,Loss,58,122,2,2,1,CLE,59,291,430,2,4.638240851858711,42.14636045337426,23.392300652616484,18.754059800757773
0.181818182,0.23076923100000002,30.45,12/16/2012,18,29,away,14,LAR,109,345,49,59,36,22,Win,213,87,2,4,2,MIN,58,322,432,0,-3.002337222071514,44.154628960685635,20.576145869307062,23.578483091378573
0.23076923100000002,0.181818182,29.55,12/16/2012,29,18,home,-14,MIN,345,109,47,77,22,36,Loss,87,213,4,2,0,LAR,58,432,322,2,3.002337222071514,44.154628960685635,23.578483091378573,20.576145869307062
0.307692308,0.363636364,28.9,12/16/2012,20,24,away,-41,NOS,319,298,84,72,0,41,Loss,67,149,2,1,0,TBB,41,386,447,5,-6.367895648998299,51.56547417872846,22.59878926486508,28.96668491386338
0.363636364,0.307692308,31.1,12/16/2012,24,20,home,41,TBB,298,319,55,65,41,0,Win,149,67,1,2,5,NOS,41,447,386,0,6.367895648998299,51.56547417872846,28.96668491386338,22.59878926486508
0.4,0.692307692,21.05,12/16/2012,10,22,away,-34,ATL,159,265,25,47,0,34,Loss,97,129,1,1,0,NYG,34,256,394,3,0.2967810040164487,43.659474525351065,21.978127764683755,21.68134676066731
0.692307692,0.4,38.95,12/16/2012,22,10,home,34,NYG,265,159,30,67,34,0,Win,129,97,1,1,3,ATL,34,394,256,0,-0.2967810040164487,43.659474525351065,21.68134676066731,21.978127764683755
0.125,0.384615385,26.9,12/16/2012,19,23,away,-12,HOU,148,239,79,57,17,29,Loss,124,178,5,3,0,IND,46,272,417,1,-0.7416706463863072,42.55838504673025,20.90835720017197,21.65002784655828
0.384615385,0.125,33.1,12/16/2012,23,19,home,12,IND,239,148,69,66,29,17,Win,178,124,3,5,1,HOU,46,417,272,0,0.7416706463863072,42.55838504673025,21.65002784655828,20.90835720017197
0.41176470600000004,0.0,33.38333333,12/16/2012,20,12,away,8,CHI,278,107,104,71,21,13,Win,113,83,3,4,1,GBP,34,391,190,2,-2.0499686510189035,37.154536420296125,17.552283884638612,19.602252535657513
0.0,0.41176470600000004,26.61666667,12/16/2012,12,20,home,-8,GBP,107,278,91,48,13,21,Loss,83,113,4,3,2,CHI,34,190,391,1,2.0499686510189035,37.154536420296125,19.602252535657513,17.552283884638612
0.454545455,0.384615385,28.95,12/16/2012,22,21,away,33,BUF,196,215,32,57,50,17,Win,270,118,2,3,3,SEA,67,466,333,0,6.0491859884614065,49.14552369086386,27.597354839662636,21.548168851201225
0.384615385,0.454545455,31.05,12/16/2012,21,22,home,-33,SEA,215,196,20,67,17,50,Loss,118,270,3,2,0,BUF,67,333,466,3,-6.0491859884614065,49.14552369086386,21.548168851201225,27.597354839662636
0.5,0.333333333,37.53333333,12/16/2012,29,12,away,24,LAC,217,94,48,74,31,7,Win,155,70,2,6,2,CAR,38,372,164,1,-2.3258299518765817,41.39405125636747,19.534110652245445,21.859940604122023
0.333333333,0.5,22.46666667,12/16/2012,12,29,home,-24,CAR,94,217,70,45,7,31,Loss,70,155,6,2,1,LAC,38,164,372,2,2.3258299518765817,41.39405125636747,21.859940604122023,19.534110652245445
0.333333333,0.166666667,31.23333333,12/16/2012,18,12,away,-28,ARI,228,97,63,74,10,38,Loss,84,99,2,1,1,DET,48,312,196,4,-3.115629003326031,32.34166930462443,14.613020150649199,17.728649153975233
0.166666667,0.333333333,28.76666667,12/16/2012,12,18,home,28,DET,97,228,50,51,38,10,Win,99,84,1,2,4,ARI,48,196,312,1,3.115629003326031,32.34166930462443,17.728649153975233,14.6130201506492
0.083333333,0.41176470600000004,19.9,12/16/2012,7,21,away,-15,OAK,109,182,60,46,0,15,Loss,10,203,4,0,1,KCC,15,119,385,1,-6.526377474285255,31.543938400176508,12.508780462945627,19.03515793723088
0.41176470600000004,0.083333333,40.1,12/16/2012,21,7,home,15,KCC,182,109,62,75,15,0,Win,203,10,0,4,1,OAK,15,385,119,1,6.526377474285255,31.543938400176508,19.03515793723088,12.508780462945627
0.41666666700000005,0.363636364,27.0,12/16/2012,20,23,away,-3,DAL,319,328,0,61,0,3,Loss,69,87,4,1,1,PIT,3,388,415,2,4.270356287138869,47.92148872715663,26.095922507147748,21.82556622000888
0.363636364,0.41666666700000005,34.4,12/16/2012,23,20,home,3,PIT,328,319,61,64,3,0,Win,87,69,1,4,2,DAL,3,415,388,1,-4.270356287138869,47.92148872715663,21.82556622000888,26.095922507147748
0.35714285700000004,0.133333333,30.21666667,12/16/2012,19,32,away,7,NEP,208,425,88,65,41,34,Win,180,95,1,3,4,SFO,75,388,520,2,-3.6659425672285924,52.59084367399008,24.462450553380744,28.128393120609335
0.133333333,0.35714285700000004,29.78333333,12/16/2012,32,19,home,-7,SFO,425,208,73,92,34,41,Loss,95,180,3,1,2,NEP,75,520,388,4,3.6659425672285924,52.59084367399008,28.128393120609335,24.462450553380744
0.41666666700000005,0.153846154,30.26666667,12/17/2012,20,12,away,-4,TEN,107,127,23,63,10,14,Loss,146,167,4,4,0,NYJ,24,253,294,5,-3.2110044486090725,37.37414853108294,17.08157204123693,20.292576489846006
0.153846154,0.41666666700000005,29.73333333,12/17/2012,12,20,home,4,NYJ,127,107,111,56,14,10,Win,167,146,4,4,5,TEN,24,294,253,0,3.2110044486090725,37.37414853108294,20.292576489846006,17.08157204123693
0.545454545,0.35714285700000004,28.86666667,12/22/2012,19,25,away,13,DET,271,443,20,55,31,18,Win,73,79,1,0,3,ATL,49,344,522,0,0.29776117237318545,53.104430690351535,26.70109593136236,26.403334758989175
0.35714285700000004,0.545454545,31.13333333,12/22/2012,25,19,home,-13,ATL,443,271,20,78,18,31,Loss,79,73,0,1,0,DET,49,522,344,3,-0.29776117237318545,53.104430690351535,26.403334758989175,26.70109593136236
0.26666666699999997,0.14285714300000002,28.25,12/23/2012,16,15,away,3,PIT,253,185,55,63,13,10,Win,14,95,6,4,3,CIN,23,267,280,3,3.3435799321823136,34.37697360716734,18.86027676967483,15.516696837492514
0.14285714300000002,0.26666666699999997,31.75,12/23/2012,15,16,home,-3,CIN,185,253,63,63,10,13,Loss,95,14,4,6,3,PIT,23,280,267,3,-3.3435799321823136,34.37697360716734,15.516696837492514,18.86027676967483
0.428571429,0.5,29.71666667,12/23/2012,17,18,away,-14,MIA,227,119,93,65,10,24,Loss,154,182,2,2,0,BUF,34,381,301,4,-5.2344216097944045,43.93149383675677,19.348536113481185,24.582957723275587
0.5,0.428571429,30.28333333,12/23/2012,18,17,home,14,BUF,119,227,25,62,24,10,Win,182,154,2,2,4,MIA,34,301,381,0,5.2344216097944045,43.93149383675677,24.582957723275587,19.348536113481185
0.363636364,0.470588235,24.01666667,12/23/2012,14,23,away,15,TBB,196,349,64,54,28,13,Win,89,80,0,5,5,LAR,41,285,429,2,-9.892014063247661,47.71914347852282,18.913564707637576,28.80557877088524
0.470588235,0.363636364,35.98333333,12/23/2012,23,14,home,-15,LAR,349,196,5,81,13,28,Loss,80,89,5,0,2,TBB,41,429,285,5,9.892014063247661,47.71914347852282,28.80557877088524,18.913564707637576
0.26666666699999997,0.4,29.08333333,12/23/2012,12,16,away,-11,CAR,142,159,70,59,6,17,Loss,47,112,1,2,2,OAK,23,189,271,1,-11.804162666629951,37.34185083946934,12.768844086419694,24.573006753049643
0.4,0.26666666699999997,30.91666667,12/23/2012,16,12,home,11,OAK,159,142,97,59,17,6,Win,112,47,2,1,1,CAR,23,271,189,2,11.804162666629951,37.34185083946934,24.573006753049643,12.768844086419694
0.5,0.333333333,29.38333333,12/23/2012,18,25,away,7,PHI,185,321,24,53,27,20,Win,128,90,1,5,2,WAS,47,313,411,1,0.600558895864812,47.79590651926757,24.19823270756619,23.597673811701377
0.333333333,0.5,30.61666667,12/23/2012,25,18,home,-7,WAS,321,185,25,75,20,27,Loss,90,128,5,1,1,PHI,47,411,313,2,-0.600558895864812,47.79590651926757,23.597673811701377,24.19823270756619
0.26666666699999997,0.181818182,25.6,12/23/2012,10,28,away,-48,GBP,101,343,35,59,7,55,Loss,79,117,7,1,0,TEN,62,180,460,2,-2.9054358113599825,37.8967446934752,17.49565444105761,20.40109025241759
0.181818182,0.26666666699999997,34.4,12/23/2012,28,10,home,48,TEN,343,101,10,76,55,7,Win,117,79,1,7,2,GBP,62,460,180,0,2.9054358113599825,37.8967446934752,20.40109025241759,17.49565444105761
0.578947368,0.2,41.98333333,12/23/2012,33,18,away,3,DAL,446,406,42,91,3,0,Win,116,40,0,2,1,NOS,3,562,446,0,-4.736426086803929,53.58905890451257,24.42631640885432,29.16274249565825
0.2,0.578947368,22.46666667,12/23/2012,18,33,home,-3,NOS,406,446,32,56,0,3,Loss,40,116,2,0,0,DAL,3,446,562,1,4.736426086803929,53.58905890451257,29.16274249565825,24.42631640885432
0.375,0.2,27.66666667,12/23/2012,16,22,away,7,KCC,198,155,48,65,20,13,Win,90,352,3,1,3,IND,33,288,507,0,-4.828272419321809,43.38503089159589,19.27837923613704,24.106651655458847
0.2,0.375,32.33333333,12/23/2012,22,16,home,-7,IND,155,198,75,67,13,20,Loss,352,90,1,3,0,KCC,33,507,288,3,4.828272419321809,43.38503089159589,24.106651655458847,19.27837923613704
0.333333333,0.26666666699999997,27.41666667,12/23/2012,23,22,away,7,JAX,246,343,39,71,23,16,Win,103,93,3,1,3,NEP,39,349,436,2,-1.0332841340095027,48.43302145660392,23.699868661297206,24.73315279530671
0.26666666699999997,0.333333333,32.58333333,12/23/2012,22,23,home,-7,NEP,343,246,47,75,16,23,Loss,93,103,1,3,2,JAX,39,436,349,3,1.0332841340095027,48.43302145660392,24.73315279530671,23.699868661297206
0.5,0.090909091,34.76666667,12/23/2012,22,11,away,17,HOU,171,153,52,73,23,6,Win,174,34,1,4,2,MIN,29,345,187,1,-7.316698091516281,34.45991607652677,13.571608992505244,20.888307084021523
0.090909091,0.5,25.23333333,12/23/2012,11,22,home,-17,MIN,153,171,60,53,6,23,Loss,34,174,4,1,1,HOU,29,187,345,2,7.316698091516281,34.45991607652677,20.888307084021523,13.571608992505244
0.166666667,0.181818182,30.15,12/23/2012,15,18,away,10,NYJ,136,156,53,56,27,17,Win,87,69,4,11,2,LAC,44,223,225,0,6.1335674914387015,27.834092580065178,16.98383003575194,10.850262544313239
0.181818182,0.166666667,29.85,12/23/2012,18,15,home,-10,LAC,156,136,40,59,17,27,Loss,69,87,11,4,0,NYJ,44,225,223,2,-6.1335674914387015,27.834092580065178,10.850262544313239,16.98383003575194
0.25,0.6,26.33333333,12/23/2012,20,29,away,-22,DEN,142,339,69,60,12,34,Loss,91,118,6,0,1,CLE,46,233,457,1,-2.6661699963038714,46.32476023803515,21.829295120865638,24.49546511716951
0.6,0.25,33.66666667,12/23/2012,29,20,home,22,CLE,339,142,84,75,34,12,Win,118,91,0,6,1,DEN,46,457,233,1,2.6661699963038714,46.32476023803515,24.49546511716951,21.829295120865638
0.2,0.611111111,20.65,12/23/2012,11,25,away,-19,BAL,119,309,52,45,14,33,Loss,67,224,3,0,0,NYG,47,186,533,0,-3.9332173708797065,41.37558509056718,18.721183859843734,22.654401230723444
0.611111111,0.2,39.35,12/23/2012,25,11,home,19,NYG,309,119,92,81,33,14,Win,224,67,0,3,0,BAL,47,533,186,0,3.9332173708797065,41.37558509056718,22.654401230723444,18.721183859843734
0.23076923100000002,0.2,28.08333333,12/23/2012,15,15,away,15,ARI,145,219,12,60,28,13,Win,152,29,1,4,3,CHI,41,297,248,1,-5.165828872519063,28.913638883907243,11.873905005694091,17.039733878213152
0.2,0.23076923100000002,31.91666667,12/23/2012,15,15,home,-15,CHI,219,145,25,72,13,28,Loss,29,152,4,1,1,ARI,41,248,297,3,5.165828872519063,28.913638883907243,17.039733878213152,11.873905005694091
0.272727273,0.846153846,24.85,12/23/2012,17,22,away,-29,SEA,231,170,58,56,13,42,Loss,82,176,1,1,1,SFO,55,313,346,2,2.2333230864891576,44.84704759424181,23.540185340365483,21.306862253876325
0.846153846,0.272727273,35.15,12/23/2012,22,17,home,29,SFO,170,231,45,62,42,13,Win,176,82,1,1,2,SEA,55,346,313,1,-2.2333230864891576,44.84704759424181,21.306862253876325,23.540185340365483
0.454545455,0.6,28.85,12/30/2012,19,19,away,-12,IND,250,184,64,60,16,28,Loss,102,81,4,1,0,HOU,44,352,265,2,-3.55026880645846,44.56858839711569,20.509159795328614,24.059428601787076
0.6,0.454545455,31.15,12/30/2012,19,19,home,12,HOU,184,250,24,62,28,16,Win,81,102,1,4,2,IND,44,265,352,0,3.55026880645846,44.56858839711569,24.059428601787076,20.509159795328614
0.4375,0.214285714,32.08333333,12/30/2012,18,15,away,5,ATL,222,213,15,65,22,17,Win,144,65,0,2,0,TBB,39,366,278,1,-5.983041070421859,33.1156677808567,13.566313355217417,19.54935442563928
0.214285714,0.4375,27.91666667,12/30/2012,15,18,home,-5,TBB,213,222,15,62,17,22,Loss,65,144,2,0,1,ATL,39,278,366,0,5.983041070421859,33.1156677808567,19.54935442563928,13.566313355217419
0.3,0.384615385,29.65,12/30/2012,18,17,away,-14,PIT,182,121,79,62,10,24,Loss,138,91,4,2,0,CLE,34,320,212,4,2.762028412096363,35.142717671507306,18.952373041801835,16.19034462970547
0.384615385,0.3,30.35,12/30/2012,17,18,home,14,CLE,121,182,58,53,24,10,Win,91,138,2,4,4,PIT,34,212,320,0,-2.762028412096363,35.142717671507306,16.19034462970547,18.952373041801835
0.27777777800000003,0.23076923100000002,35.65,12/30/2012,23,9,away,-6,CIN,146,142,102,83,17,23,Loss,206,47,4,2,0,BAL,40,352,189,1,-2.8131336680828958,27.63747556376856,12.412170947842833,15.225304615925728
0.23076923100000002,0.27777777800000003,24.35,12/30/2012,9,23,home,6,BAL,142,146,40,49,23,17,Win,47,206,2,4,1,CIN,40,189,352,0,2.8131336680828958,27.63747556376856,15.225304615925728,12.412170947842833
0.26666666699999997,0.5,34.15,12/30/2012,19,20,away,2,DET,245,255,35,68,26,24,Win,144,72,2,1,4,CHI,50,389,327,0,-3.948594272183078,46.05000567904385,21.050705703430385,24.999299975613464
0.5,0.26666666699999997,25.85,12/30/2012,20,19,home,-2,CHI,255,245,29,63,24,26,Loss,72,144,1,2,0,DET,50,327,389,4,3.948594272183078,46.05000567904385,24.999299975613464,21.050705703430385
0.41176470600000004,0.46666666700000003,32.33333333,12/30/2012,19,16,away,-19,BUF,199,225,45,72,9,28,Loss,133,109,1,0,1,NYJ,37,332,334,2,-5.702096567508384,43.657148181647074,18.977525807069345,24.67962237457773
0.46666666700000003,0.41176470600000004,27.66666667,12/30/2012,16,19,home,19,NYJ,225,199,24,57,28,9,Win,109,133,0,1,2,BUF,37,334,332,1,5.702096567508384,43.657148181647074,24.67962237457773,18.977525807069345
0.28571428600000004,0.625,28.45,12/30/2012,18,32,away,-35,NYG,207,212,52,65,7,42,Loss,110,185,1,1,0,PHI,49,317,397,1,6.100230305606111,52.11397689328727,29.107103599446692,23.00687329384058
0.625,0.28571428600000004,31.55,12/30/2012,32,18,home,35,PHI,212,207,5,58,42,7,Win,185,110,1,1,1,NYG,49,397,317,0,-6.100230305606111,52.11397689328727,23.00687329384058,29.107103599446692
0.4375,0.428571429,32.35,12/30/2012,21,12,away,-18,TEN,253,142,35,71,20,38,Loss,122,79,7,2,0,JAX,58,375,221,3,-6.15817746836319,40.40326014413845,17.12254133788763,23.28071880625082
0.428571429,0.4375,27.65,12/30/2012,12,21,home,18,JAX,142,253,43,51,38,20,Win,79,122,2,7,3,TEN,58,221,375,0,6.15817746836319,40.40326014413845,23.28071880625082,17.12254133788763
0.625,0.333333333,33.91666667,12/30/2012,28,22,away,6,NOS,257,378,36,74,44,38,Win,273,63,1,2,1,CAR,82,530,441,1,-5.047968723089145,60.62902149972463,27.790526388317744,32.838495111406885
0.333333333,0.625,26.08333333,12/30/2012,22,28,home,-6,CAR,378,257,55,63,38,44,Loss,63,273,2,1,1,NOS,82,441,530,1,5.047968723089145,60.62902149972463,32.838495111406885,27.790526388317744
0.46153846200000004,0.5,28.08333333,12/30/2012,24,25,away,-3,MIN,333,227,43,61,34,37,Loss,72,217,5,1,0,GBP,71,405,444,1,1.5484393414082582,56.196847361330626,28.87264335136944,27.324204009961186
0.5,0.46153846200000004,31.91666667,12/30/2012,25,24,home,3,GBP,227,333,98,66,37,34,Win,217,72,1,5,1,MIN,71,444,405,0,-1.5484393414082582,56.196847361330626,27.324204009961186,28.87264335136944
0.384615385,0.5,24.36666667,12/30/2012,16,28,away,-28,NEP,209,276,23,57,0,28,Loss,47,167,7,1,0,MIA,28,256,443,2,7.765521539274868,43.17899353766856,25.472257538471716,17.706735999196844
0.5,0.384615385,35.63333333,12/30/2012,28,16,home,28,MIA,276,209,48,75,28,0,Win,167,47,1,7,2,NEP,28,443,256,0,-7.765521539274868,43.17899353766856,17.706735999196844,25.472257538471716
0.181818182,0.41666666700000005,27.18333333,12/30/2012,20,17,away,-7,SEA,252,209,98,61,13,20,Loss,79,153,0,6,0,LAR,33,331,362,1,1.0870098426357782,41.16907802663323,21.128043934634505,20.041034091998725
0.41666666700000005,0.181818182,32.81666667,12/30/2012,17,20,home,7,LAR,209,252,80,55,20,13,Win,153,79,6,0,1,SEA,33,362,331,0,-1.0870098426357782,41.16907802663323,20.041034091998725,21.128043934634505
0.25,0.28571428600000004,23.95,12/30/2012,11,20,away,-14,SFO,207,278,34,53,13,27,Loss,55,129,2,1,0,ARI,40,262,407,2,2.473700676428077,34.938149455927146,18.705925066177613,16.232224389749533
0.28571428600000004,0.25,36.05,12/30/2012,20,11,home,14,ARI,278,207,25,67,27,13,Win,129,55,1,2,2,SFO,40,407,262,0,-2.473700676428077,34.938149455927146,16.232224389749533,18.705925066177613
0.533333333,0.181818182,28.3,12/30/2012,17,14,away,-3,LAC,150,140,67,57,21,24,Loss,115,70,0,2,0,OAK,45,265,210,1,-0.6260423654889711,35.6879828141544,17.530970224332716,18.157012589821687
0.181818182,0.533333333,31.7,12/30/2012,14,17,home,3,OAK,140,150,60,50,24,21,Win,70,115,2,0,1,LAC,45,210,265,0,0.6260423654889711,35.6879828141544,18.157012589821687,17.530970224332716
0.28571428600000004,0.583333333,22.5,12/30/2012,8,32,away,-35,DEN,26,316,32,48,3,38,Loss,93,172,4,0,1,KCC,41,119,488,0,1.812660269570614,39.3856012066378,20.599130738104208,18.786470468533594
0.583333333,0.28571428600000004,37.5,12/30/2012,32,8,home,35,KCC,316,26,30,76,38,3,Win,172,93,0,4,0,DEN,41,488,119,1,-1.812660269570614,39.3856012066378,18.786470468533594,20.599130738104208
0.538461538,0.454545455,26.56666667,12/30/2012,20,24,away,-10,WAS,196,87,6,61,18,28,Loss,100,274,2,1,0,DAL,46,296,361,3,-2.0570917009153007,42.73392062665671,20.338414462870706,22.395506163786006
0.454545455,0.538461538,33.43333333,12/30/2012,24,20,home,10,DAL,87,196,20,61,28,18,Win,274,100,1,2,3,WAS,46,361,296,0,2.0570917009153007,42.73392062665671,22.395506163786006,20.338414462870706
0.0,0.470588235,21.18333333,1/5/2013,12,24,away,-6,HOU,118,262,51,48,13,19,Loss,80,158,2,0,1,CIN,32,198,420,1,-2.102057967991982,36.87657579956351,17.387258915785765,19.489316883777747
0.470588235,0.0,38.81666667,1/5/2013,24,12,home,6,CIN,262,118,55,77,19,13,Win,158,80,0,2,1,HOU,32,420,198,1,2.102057967991982,36.87657579956351,19.489316883777747,17.387258915785765
0.35714285700000004,0.214285714,27.03333333,1/5/2013,17,20,away,-14,GBP,157,250,30,62,10,24,Loss,167,76,3,3,0,MIN,34,324,326,3,1.989218079774993,40.27697322789848,21.133095653836737,19.143877574061744
0.214285714,0.35714285700000004,32.96666667,1/5/2013,20,17,home,14,MIN,250,157,10,67,24,10,Win,76,167,3,3,3,GBP,34,326,324,0,-1.989218079774993,40.27697322789848,19.143877574061744,21.133095653836737
0.45,0.4,37.53333333,1/6/2013,25,18,away,-15,BAL,267,269,37,87,9,24,Loss,152,170,3,1,2,IND,33,419,439,2,-3.9580226537281327,50.71054136808096,23.376259357176416,27.334282010904545
0.4,0.45,22.46666667,1/6/2013,18,25,home,15,IND,269,267,70,56,24,9,Win,170,152,1,3,2,BAL,33,439,419,2,3.9580226537281327,50.71054136808096,27.334282010904545,23.376259357176416
0.384615385,0.454545455,34.33333333,1/6/2013,22,15,away,10,WAS,156,99,30,68,24,14,Win,224,104,5,2,2,SEA,38,380,203,1,-0.573338096123365,35.75649213454862,17.59157701921263,18.164915115335994
0.454545455,0.384615385,25.66666667,1/6/2013,15,22,home,-10,SEA,99,156,15,54,14,24,Loss,104,224,2,5,1,WAS,38,203,380,2,0.573338096123365,35.75649213454862,18.164915115335994,17.59157701921263
0.41176470600000004,0.4375,36.6,1/12/2013,21,30,away,0,DEN,324,273,56,74,0,0,Tie,155,125,1,3,3,BAL,0,479,398,1,-9.94847110241602,44.41439893440073,17.232963915992354,27.181435018408376
0.4375,0.41176470600000004,40.1,1/12/2013,30,21,home,0,BAL,273,324,87,87,0,0,Tie,125,155,3,1,1,DEN,0,398,479,3,9.94847110241602,44.41439893440073,27.181435018408376,17.232963915992354
0.41666666700000005,0.615384615,21.98333333,1/12/2013,20,29,away,-14,SFO,248,256,26,56,31,45,Loss,104,323,1,1,1,GBP,76,352,579,2,-0.3331767870702862,59.60005341630176,29.633438314615738,29.966615101686024
0.615384615,0.41666666700000005,38.01666667,1/12/2013,29,20,home,14,GBP,256,248,86,75,45,31,Win,323,104,1,1,2,SFO,76,579,352,1,0.3331767870702862,59.60005341630176,29.966615101686024,29.633438314615738
0.375,0.545454545,28.78333333,1/13/2013,28,24,away,-2,ATL,368,250,35,66,28,30,Loss,123,167,2,0,2,SEA,58,491,417,2,9.695102837135403,56.96745715791447,33.33127999752493,23.636177160389533
0.545454545,0.375,31.21666667,1/13/2013,24,28,home,2,SEA,250,368,11,61,30,28,Win,167,123,0,2,2,ATL,58,417,491,2,-9.695102837135403,56.96745715791447,23.63617716038953,33.33127999752494
0.26666666699999997,0.46153846200000004,31.4,1/13/2013,25,24,away,-13,NEP,334,335,20,75,28,41,Loss,91,122,1,1,0,HOU,69,425,457,1,1.7041659796249071,51.652497182973676,26.67833158129929,24.974165601674386
0.46153846200000004,0.26666666699999997,28.6,1/13/2013,24,25,home,13,HOU,335,334,56,65,41,28,Win,122,91,1,1,1,NEP,69,457,425,0,-1.7041659796249071,51.652497182973676,24.974165601674386,26.67833158129929
0.333333333,0.5555555560000001,27.93333333,1/20/2013,21,27,away,4,ATL,224,396,24,51,28,24,Win,149,81,1,1,2,SFO,52,373,477,1,11.14114437419057,54.04903867908002,32.595091526635294,21.453947152444726
0.5555555560000001,0.333333333,32.06666667,1/20/2013,27,21,home,-4,SFO,396,224,30,66,24,28,Loss,81,149,1,1,1,ATL,52,477,373,2,-11.14114437419057,54.04903867908002,21.453947152444726,32.595091526635294
0.41666666700000005,0.46666666700000003,31.1,1/20/2013,25,28,away,15,NEP,235,320,60,71,28,13,Win,121,108,2,0,3,BAL,41,356,428,0,1.1217962440663545,48.473201996968264,24.79749912051731,23.675702876450956
0.46666666700000003,0.41666666700000005,28.9,1/20/2013,28,25,home,-15,BAL,320,235,40,82,13,28,Loss,108,121,0,2,0,NEP,41,428,356,3,-1.1217962440663545,48.473201996968264,23.675702876450956,24.79749912051731
0.5625,0.222222222,32.38333333,2/3/2013,21,23,away,3,SFO,274,286,20,70,34,31,Win,93,182,2,3,2,BAL,65,367,468,1,6.794668254102893,48.50856502549811,27.6516166398005,20.856948385697606
0.222222222,0.5625,27.61666667,2/3/2013,23,21,home,-3,BAL,286,274,33,60,31,34,Loss,182,93,3,2,1,SFO,65,468,367,2,-6.794668254102893,48.50856502549811,20.856948385697606,27.6516166398005
0.363636364,0.533333333,33.8,9/5/2013,24,24,away,-22,DEN,335,445,53,87,27,49,Loss,58,65,4,3,2,BAL,76,393,510,2,-5.300517027901977,55.34830962569346,25.023896298895743,30.324413326797718
0.533333333,0.363636364,26.2,9/5/2013,24,24,home,22,BAL,445,335,61,68,49,27,Win,65,58,3,4,2,DEN,76,510,393,2,5.300517027901977,55.34830962569346,30.324413326797718,25.023896298895743
0.4,0.307692308,34.01666667,9/8/2013,17,14,away,7,PIT,117,163,60,63,16,9,Win,112,31,1,5,2,TEN,25,229,194,0,-2.5438394044681534,29.8601581990037,13.658159397267774,16.201998801735925
0.307692308,0.4,25.98333333,9/8/2013,14,17,home,-7,TEN,163,117,47,53,9,16,Loss,31,112,5,1,0,PIT,25,194,229,2,2.5438394044681534,29.8601581990037,16.201998801735925,13.658159397267774
0.5,0.071428571,32.78333333,9/8/2013,18,20,away,13,CLE,255,244,77,65,23,10,Win,20,47,4,6,3,MIA,33,275,291,1,-5.324162563881421,34.158184438820875,14.417010937469726,19.74117350135115
0.071428571,0.5,27.21666667,9/8/2013,20,18,home,-13,MIA,244,255,57,72,10,23,Loss,47,20,6,4,1,CLE,33,291,275,3,5.324162563881421,34.158184438820875,19.74117350135115,14.417010937469726
0.55,0.307692308,37.71666667,9/8/2013,26,15,away,2,BUF,273,150,36,89,23,21,Win,158,136,3,0,2,NEP,44,431,286,3,-7.389021311259986,44.981054816367575,18.796016752553793,26.18503806381378
0.307692308,0.55,22.28333333,9/8/2013,15,26,home,-2,NEP,150,273,75,61,21,23,Loss,136,158,0,3,3,BUF,44,286,431,2,7.389021311259986,44.981054816367575,26.18503806381378,18.796016752553793
0.636363636,0.428571429,28.5,9/8/2013,18,17,away,-3,CHI,277,242,84,55,21,24,Loss,63,81,1,0,1,CIN,45,340,323,3,-0.5378227025216002,47.61003810515525,23.536107701316823,24.073930403838425
0.428571429,0.636363636,31.5,9/8/2013,17,18,home,3,CIN,242,277,59,61,24,21,Win,81,63,0,1,3,CHI,45,323,340,1,0.5378227025216002,47.61003810515525,24.073930403838425,23.536107701316823
0.46153846200000004,0.454545455,30.23333333,9/8/2013,18,17,away,5,CAR,300,119,99,61,12,7,Win,70,134,2,1,2,SEA,19,370,253,1,0.5455234475797233,44.96521972810014,22.75537158783993,22.209848140260206
0.454545455,0.46153846200000004,29.76666667,9/8/2013,17,18,home,-5,SEA,119,300,46,50,7,12,Loss,134,70,1,2,1,CAR,19,253,370,2,-0.5455234475797233,44.96521972810014,22.209848140260206,22.75537158783993
0.333333333,0.263157895,31.5,9/8/2013,17,12,away,26,JAX,171,107,20,62,28,2,Win,121,71,1,6,2,KCC,30,292,178,0,-9.96083804087283,26.22865890856454,8.133910433845855,18.094748474718685
0.263157895,0.333333333,28.5,9/8/2013,12,17,home,-26,KCC,107,171,30,70,2,28,Loss,71,121,6,1,0,JAX,30,178,292,2,9.96083804087283,26.22865890856454,18.094748474718685,8.133910433845855
0.375,0.38888888899999996,27.63333333,9/8/2013,12,22,away,-1,NYJ,185,214,102,59,17,18,Loss,65,90,3,5,2,TBB,35,250,304,2,-12.43981783247835,37.214865349628006,12.38752375857483,24.827341591053177
0.38888888899999996,0.375,32.36666667,9/8/2013,22,12,home,1,TBB,214,185,45,73,18,17,Win,90,65,5,3,2,NYJ,35,304,250,2,12.43981783247835,37.214865349628006,24.827341591053177,12.387523758574828
0.538461538,0.6,32.78333333,9/8/2013,20,18,away,-4,IND,201,147,51,63,17,21,Loss,171,127,1,4,0,OAK,38,372,274,2,-0.18708670765222557,49.24836259670713,24.530637944527452,24.71772465217968
0.6,0.538461538,27.21666667,9/8/2013,18,20,home,4,OAK,147,201,31,53,21,17,Win,127,171,4,1,2,IND,38,274,372,0,0.18708670765222557,49.24836259670713,24.71772465217968,24.530637944527452
0.272727273,0.46153846200000004,24.81666667,9/8/2013,18,18,away,-6,NOS,279,341,19,55,17,23,Loss,88,78,3,2,1,ATL,40,367,419,2,5.57583828334716,45.525885249892994,25.550861766620077,19.975023483272917
0.46153846200000004,0.272727273,35.18333333,9/8/2013,18,18,home,6,ATL,341,279,57,66,23,17,Win,78,88,2,3,2,NOS,40,419,367,1,-5.57583828334716,45.525885249892994,19.975023483272917,25.550861766620077
0.2,0.384615385,23.68333333,9/8/2013,16,28,away,-10,DET,225,357,52,53,24,34,Loss,105,112,3,0,2,MIN,58,330,469,4,0.7077341077641641,53.58192194114581,27.144828024454988,26.43709391669082
0.384615385,0.2,36.31666667,9/8/2013,28,16,home,10,MIN,357,225,88,77,34,24,Win,112,105,0,3,4,DET,58,469,330,2,-0.7077341077641641,53.58192194114581,26.43709391669082,27.144828024454988
0.5,0.363636364,31.41666667,9/8/2013,25,20,away,-3,LAR,304,299,68,70,24,27,Loss,86,67,4,0,2,ARI,51,390,366,2,-4.067371359618636,50.23457534486599,23.083601992623677,27.15097335224231
0.363636364,0.5,28.58333333,9/8/2013,20,25,home,3,ARI,299,304,59,62,27,24,Win,67,86,0,4,2,LAR,51,366,390,2,4.067371359618636,50.23457534486599,27.15097335224231,23.083601992623677
0.4,0.5,21.41666667,9/8/2013,23,23,away,-6,SFO,322,404,44,58,28,34,Loss,63,90,2,2,0,GBP,62,385,494,2,-0.9178202504554704,55.92301857440205,27.50259916197329,28.42041941242876
0.5,0.4,38.58333333,9/8/2013,23,23,home,6,GBP,404,322,85,75,34,28,Win,90,63,2,2,2,SFO,62,494,385,0,0.9178202504554704,55.92301857440205,28.42041941242876,27.50259916197329
0.545454545,0.333333333,22.83333333,9/8/2013,21,22,away,-5,DAL,428,244,52,59,31,36,Loss,50,87,3,2,1,NYG,67,478,331,6,-2.6227581282045502,55.72627947177776,26.551760671786603,29.174518799991155
0.333333333,0.545454545,37.16666667,9/8/2013,22,21,home,5,NYG,244,428,40,74,36,31,Win,87,50,2,3,6,DAL,67,331,478,1,2.6227581282045502,55.72627947177776,29.174518799991155,26.551760671786603
0.46666666700000003,0.2,32.65,9/9/2013,26,25,away,6,WAS,180,308,65,77,33,27,Win,263,74,3,3,3,PHI,60,443,382,2,-9.148073592091311,53.080102491420945,21.96601444966482,31.114088041756126
0.2,0.46666666700000003,27.35,9/9/2013,25,26,home,-6,PHI,308,180,75,70,27,33,Loss,74,263,3,3,2,WAS,60,382,443,3,9.148073592091311,53.080102491420945,31.114088041756126,21.96601444966482
0.46153846200000004,0.5,36.51666667,9/9/2013,26,14,away,3,LAC,329,183,73,75,31,28,Win,120,80,2,2,1,HOU,59,449,263,1,-7.7001032346580525,46.746171088291085,19.523033926816517,27.22313716147457
0.5,0.46153846200000004,23.48333333,9/9/2013,14,26,home,-3,HOU,183,329,55,51,28,31,Loss,80,120,2,2,1,LAC,59,263,449,1,7.7001032346580525,46.746171088291085,27.22313716147457,19.523033926816517
0.333333333,0.222222222,34.0,9/12/2013,15,9,away,-3,NEP,189,178,66,71,10,13,Loss,129,54,4,1,0,NYJ,23,318,232,4,-4.359134609069512,29.670179309026985,12.655522349978735,17.01465695904825
0.222222222,0.333333333,26.0,9/12/2013,9,15,home,3,NYJ,178,189,30,64,13,10,Win,54,129,1,4,4,NEP,23,232,318,0,4.359134609069512,29.670179309026985,17.01465695904825,12.655522349978735
0.272727273,0.307692308,31.78333333,9/15/2013,20,19,away,-1,KCC,281,199,27,61,16,17,Loss,37,114,3,4,0,DAL,33,318,313,2,0.754847192338147,36.01734354415535,18.38609536824675,17.631248175908603
0.307692308,0.272727273,28.21666667,9/15/2013,19,20,home,1,DAL,199,281,45,65,17,16,Win,114,37,4,3,2,KCC,33,313,318,0,-0.754847192338147,36.01734354415535,17.631248175908603,18.38609536824675
0.4375,0.583333333,29.43333333,9/15/2013,19,24,away,-1,CHI,227,284,25,64,30,31,Loss,123,127,1,1,4,MIN,61,350,411,3,-2.0319663120636586,54.298845243692256,26.1334394658143,28.165405777877957
0.583333333,0.4375,30.56666667,9/15/2013,24,19,home,1,MIN,284,227,35,66,31,30,Win,127,123,1,1,3,CHI,61,411,350,4,2.0319663120636586,54.298845243692256,28.165405777877957,26.1334394658143
0.4375,0.428571429,33.68333333,9/15/2013,25,24,away,-1,BUF,183,287,30,76,23,24,Loss,125,149,6,1,2,CAR,47,308,436,1,-13.32565009592357,50.27646443949222,18.475407171784326,31.801057267707897
0.428571429,0.4375,26.31666667,9/15/2013,24,25,home,1,CAR,287,183,55,73,24,23,Win,149,125,1,6,1,BUF,47,436,308,2,13.32565009592357,50.27646443949222,31.801057267707897,18.475407171784326
0.26666666699999997,0.5,29.41666667,9/15/2013,13,19,away,-8,BAL,194,197,33,62,6,14,Loss,65,99,5,2,1,CLE,20,259,296,0,-4.105697546383741,28.468963531894403,12.181632992755333,16.28733053913907
0.5,0.26666666699999997,30.58333333,9/15/2013,19,13,home,8,CLE,197,194,41,71,14,6,Win,99,65,2,5,0,BAL,20,296,259,1,4.105697546383741,28.468963531894403,16.28733053913907,12.18163299275533
0.272727273,0.4,27.51666667,9/15/2013,18,28,away,-18,GBP,314,441,78,58,20,38,Loss,108,139,1,4,1,WAS,58,422,580,1,0.5263504877830929,58.76271797923978,29.644534233511436,29.118183745728345
0.4,0.272727273,32.48333333,9/15/2013,28,18,home,18,WAS,441,314,40,70,38,20,Win,139,108,4,1,1,GBP,58,580,422,1,-0.5263504877830929,58.76271797923978,29.118183745728345,29.644534233511436
0.666666667,0.454545455,40.28333333,9/15/2013,33,22,away,3,PHI,413,411,32,79,33,30,Win,126,100,1,2,0,LAC,63,539,511,2,0.416542199089478,67.98808738503888,34.20231479206418,33.7857725929747
0.454545455,0.666666667,19.71666667,9/15/2013,22,33,home,-3,LAC,411,413,77,58,30,33,Loss,100,126,2,1,2,PHI,63,511,539,0,-0.416542199089478,67.98808738503888,33.7857725929747,34.20231479206418
0.25,0.352941176,31.23333333,9/15/2013,14,25,away,-6,HOU,129,280,70,67,0,6,Loss,119,172,4,2,2,TEN,6,248,452,0,-18.131187721767233,37.37943722228766,9.624124750260215,27.755312472027448
0.352941176,0.25,33.23333333,9/15/2013,25,14,home,6,TEN,280,129,40,78,6,0,Win,172,119,2,4,0,HOU,6,452,248,2,18.131187721767233,37.37943722228766,27.755312472027448,9.624124750260215
0.41176470600000004,0.538461538,29.71666667,9/15/2013,24,19,away,-7,ATL,352,357,53,73,24,31,Loss,69,36,0,2,0,LAR,55,421,393,1,-7.61264828907801,49.19968151295194,20.793516611936965,28.406164901014975
0.538461538,0.41176470600000004,30.28333333,9/15/2013,19,24,home,7,LAR,357,352,53,61,31,24,Win,36,69,2,0,1,ATL,55,393,421,0,7.61264828907801,49.19968151295194,28.406164901014975,20.793516611936965
0.428571429,0.46666666700000003,29.43333333,9/15/2013,21,23,away,4,IND,297,315,0,66,24,20,Win,101,133,5,3,1,MIA,44,398,448,1,0.4992261387860992,49.54920275749232,25.024214448139208,24.52498830935311
0.46666666700000003,0.428571429,30.56666667,9/15/2013,23,21,home,-4,MIA,315,297,13,72,20,24,Loss,133,101,3,5,1,IND,44,448,398,1,-0.4992261387860992,49.54920275749232,24.52498830935311,25.024214448139208
0.35714285700000004,0.384615385,32.6,9/15/2013,21,14,away,2,TBB,296,113,35,70,16,14,Win,75,160,4,1,2,NOS,30,371,273,2,-6.906967478220729,40.828430615724706,16.96073156875199,23.867699046972717
0.384615385,0.35714285700000004,27.4,9/15/2013,14,21,home,-2,NOS,113,296,118,56,14,16,Loss,160,75,1,4,2,TBB,30,273,371,2,6.906967478220729,40.828430615724706,23.867699046972717,16.96073156875199
0.272727273,0.090909091,28.68333333,9/15/2013,16,24,away,-4,ARI,273,261,101,57,21,25,Loss,49,87,1,1,1,DET,46,322,348,1,2.6394961674654773,40.10822231532346,21.37385924139447,18.73436307392899
0.090909091,0.272727273,31.31666667,9/15/2013,24,16,home,4,DET,261,273,40,66,25,21,Win,87,49,1,1,1,ARI,46,348,322,1,-2.6394961674654773,40.10822231532346,18.73436307392899,21.37385924139447
0.533333333,0.090909091,28.03333333,9/15/2013,23,28,away,18,NYG,307,353,132,72,41,23,Win,107,23,0,1,4,DEN,64,414,376,1,-2.8494639017754686,56.564766155163134,26.85765112669383,29.707115028469303
0.090909091,0.533333333,31.96666667,9/15/2013,28,23,home,-18,DEN,353,307,16,69,23,41,Loss,23,107,1,0,1,NYG,64,376,414,4,2.8494639017754686,56.564766155163134,29.707115028469303,26.85765112669383
0.41176470600000004,0.28571428600000004,28.2,9/15/2013,15,16,away,-10,OAK,214,114,70,62,9,19,Loss,34,226,5,3,1,JAX,28,248,340,0,-8.728132853546072,38.21005363446614,14.740960390460035,23.469093244006107
0.28571428600000004,0.41176470600000004,31.8,9/15/2013,16,15,home,10,JAX,114,214,30,61,19,9,Win,226,34,3,5,0,OAK,28,340,248,1,8.728132853546072,38.21005363446614,23.469093244006107,14.740960390460035
0.25,0.3125,23.28333333,9/15/2013,12,19,away,-26,SEA,107,118,121,51,3,29,Loss,100,172,3,4,1,SFO,32,207,290,5,-2.297756074956439,32.94999496117392,15.326119443108741,17.62387551806518
0.3125,0.25,36.71666667,9/15/2013,19,12,home,26,SFO,118,107,84,70,29,3,Win,172,100,4,3,5,SEA,32,290,207,1,2.297756074956439,32.94999496117392,17.62387551806518,15.326119443108741
0.25,0.41176470600000004,24.43333333,9/16/2013,14,22,away,-10,CIN,234,280,29,55,10,20,Loss,44,127,2,0,0,PIT,30,278,407,2,-4.681871848423979,39.04871024296723,17.183419197271625,21.865291045695606
0.41176470600000004,0.25,35.56666667,9/16/2013,22,14,home,10,PIT,280,234,84,79,20,10,Win,127,44,0,2,2,CIN,30,407,278,0,4.681871848423979,39.04871024296723,21.865291045695606,17.183419197271625
0.31578947399999996,0.3,39.11666667,9/19/2013,19,21,away,10,PHI,248,167,65,78,26,16,Win,146,264,5,6,5,KCC,42,394,431,0,-3.848973471486847,47.36878286582418,21.759904697168665,25.608878168655515
0.3,0.31578947399999996,20.88333333,9/19/2013,21,19,home,-10,KCC,167,248,45,63,16,26,Loss,264,146,6,5,0,PHI,42,431,394,5,3.848973471486847,47.36878286582418,25.608878168655515,21.759904697168665
0.307692308,0.363636364,31.85,9/22/2013,27,19,away,-4,CIN,217,215,55,77,30,34,Loss,182,82,4,4,4,GBP,64,399,297,4,6.739928176783607,51.62958893957613,29.18475855817987,22.44483038139626
0.363636364,0.307692308,28.15,9/22/2013,19,27,home,4,GBP,215,217,43,56,34,30,Win,82,182,4,4,4,CIN,64,297,399,4,-6.739928176783607,51.62958893957613,22.44483038139626,29.18475855817987
0.307692308,0.46153846200000004,28.8,9/22/2013,24,27,away,7,WAS,378,300,71,66,27,20,Win,63,120,1,2,2,DET,47,441,420,1,-7.3365158324956,54.720462005572706,23.691973086538553,31.028488919034153
0.46153846200000004,0.307692308,31.2,9/22/2013,27,24,home,-7,DET,300,378,45,74,20,27,Loss,120,63,2,1,1,WAS,47,420,441,2,7.3365158324956,54.720462005572706,31.028488919034153,23.691973086538553
0.35714285700000004,0.4,26.98333333,9/22/2013,18,21,away,-20,NEP,226,202,48,66,3,23,Loss,97,156,3,3,1,TBB,26,323,358,1,-4.303635824923913,38.459194061051804,17.077779118063944,21.38141494298786
0.4,0.35714285700000004,33.01666667,9/22/2013,21,18,home,20,TBB,202,226,50,72,23,3,Win,156,97,3,3,1,NEP,26,358,323,1,4.303635824923913,38.459194061051804,21.38141494298786,17.077779118063944
0.25,0.571428571,23.21666667,9/22/2013,10,27,away,-38,CAR,90,208,45,50,0,38,Loss,60,194,7,1,2,NYG,38,150,402,3,-4.757324266924808,43.33704158811231,19.28985866059375,24.047182927518556
0.571428571,0.25,36.78333333,9/22/2013,27,10,home,38,NYG,208,90,32,74,38,0,Win,194,60,1,7,3,CAR,38,402,150,2,4.757324266924808,43.33704158811231,24.047182927518556,19.28985866059375
0.25,0.5,30.6,9/22/2013,18,16,away,-21,BAL,170,161,113,61,9,30,Loss,94,75,3,2,0,HOU,39,264,236,1,-3.476397880856762,33.838195398413994,15.180898758778618,18.657296639635376
0.5,0.25,29.4,9/22/2013,16,18,home,21,HOU,161,170,87,57,30,9,Win,75,94,2,3,1,BAL,39,236,264,0,3.476397880856762,33.838195398413994,18.657296639635376,15.180898758778616
0.4,0.470588235,28.86666667,9/22/2013,23,21,away,4,MIN,306,195,47,75,31,27,Win,103,134,3,6,3,CLE,58,409,329,4,-12.415162807416062,46.26991313084599,16.927375161714966,29.342537969131026
0.470588235,0.4,31.13333333,9/22/2013,21,23,home,-4,CLE,195,306,35,79,27,31,Loss,134,103,6,3,4,MIN,58,329,409,3,12.415162807416062,46.26991313084599,29.342537969131026,16.927375161714966
0.384615385,0.538461538,24.48333333,9/22/2013,16,27,away,-24,NOS,161,319,18,55,7,31,Loss,86,104,4,4,1,ARI,38,247,423,2,3.9002206735762712,43.331051831306496,23.615636252441384,19.715415578865112
0.538461538,0.384615385,35.51666667,9/22/2013,27,16,home,24,ARI,319,161,30,74,31,7,Win,104,86,4,4,2,NOS,38,423,247,1,-3.9002206735762712,43.331051831306496,19.715415578865112,23.615636252441384
0.076923077,0.454545455,26.53333333,9/22/2013,17,21,away,-24,DAL,197,203,41,67,7,31,Loss,35,193,6,1,1,LAR,38,232,396,1,-4.3987581303607115,36.662114791252606,16.131678330445947,20.53043646080666
0.454545455,0.076923077,33.46666667,9/22/2013,21,17,home,24,LAR,203,197,72,59,31,7,Win,193,35,1,6,1,DAL,38,396,232,1,4.3987581303607115,36.662114791252606,20.53043646080666,16.131678330445947
0.333333333,0.428571429,28.36666667,9/22/2013,19,23,away,-3,TEN,175,282,45,53,17,20,Loss,102,170,2,2,0,LAC,37,277,452,1,-4.447882976270762,45.72518727575024,20.638652149739737,25.0865351260105
0.428571429,0.333333333,31.63333333,9/22/2013,23,19,home,3,LAC,282,175,116,68,20,17,Win,170,102,2,2,1,TEN,37,452,277,0,4.447882976270762,45.72518727575024,25.0865351260105,20.638652149739737
0.454545455,0.583333333,37.15,9/22/2013,24,16,away,-4,MIA,231,195,59,68,23,27,Loss,146,90,0,5,2,ATL,50,377,285,2,1.9423366198011482,44.07104796260734,23.006692291204242,21.064355671403096
0.583333333,0.454545455,22.85,9/22/2013,16,24,home,4,ATL,195,231,13,55,27,23,Win,90,146,5,0,2,MIA,50,285,377,2,-1.9423366198011482,44.07104796260734,21.064355671403096,23.006692291204242
0.28571428600000004,0.4,27.41666667,9/22/2013,17,28,away,-28,SEA,214,323,45,66,17,45,Loss,51,156,3,2,2,JAX,62,265,479,3,1.0916290004454652,48.802447271167,24.94703813580623,23.855409135360766
0.4,0.28571428600000004,32.58333333,9/22/2013,28,17,home,28,JAX,323,214,24,67,45,17,Win,156,51,2,3,3,SEA,62,479,265,2,-1.0916290004454652,48.802447271167,23.855409135360766,24.94703813580623
0.41666666700000005,0.25,36.41666667,9/22/2013,23,14,away,20,SFO,152,139,10,67,27,7,Win,184,115,1,3,2,IND,34,336,254,0,3.3993543731379354,36.733086337206494,20.066220355172213,16.66686598203428
0.25,0.41666666700000005,23.58333333,9/22/2013,14,23,home,-20,IND,139,152,48,53,7,27,Loss,115,184,3,1,0,SFO,34,254,336,2,-3.3993543731379354,36.733086337206494,16.66686598203428,20.066220355172213
0.222222222,0.35714285700000004,25.78333333,9/22/2013,18,20,away,-7,NYJ,208,331,87,75,20,27,Loss,120,182,8,0,2,BUF,47,328,513,0,-17.904087484376756,46.9634391358288,14.529675825726024,32.433763310102776
0.35714285700000004,0.222222222,34.21666667,9/22/2013,20,18,home,7,BUF,331,208,168,70,27,20,Win,182,120,0,8,0,NYJ,47,513,328,2,17.904087484376756,46.9634391358288,32.433763310102776,14.529675825726022
0.333333333,0.272727273,31.6,9/22/2013,15,21,away,17,PIT,151,379,25,60,40,23,Win,107,80,2,3,5,CHI,63,258,459,0,0.4983136458018418,44.07406784724911,22.286190746525477,21.787877100723634
0.272727273,0.333333333,28.4,9/22/2013,21,15,home,-17,CHI,379,151,59,65,23,40,Loss,80,107,3,2,0,PIT,63,459,258,5,-0.4983136458018418,44.07406784724911,21.787877100723634,22.286190746525477
0.41666666700000005,0.5555555560000001,24.6,9/23/2013,13,31,away,-16,DEN,293,372,77,51,21,37,Loss,49,164,3,1,2,OAK,58,342,536,0,1.2892166673626342,60.68855015123708,30.98888340929986,29.69966674193722
0.5555555560000001,0.41666666700000005,35.4,9/23/2013,31,13,home,16,OAK,372,293,40,73,37,21,Win,164,49,1,3,0,DEN,58,536,342,2,-1.2892166673626342,60.68855015123708,29.69966674193722,30.98888340929986
0.4,0.176470588,31.75,9/26/2013,19,14,away,24,LAR,151,170,85,65,35,11,Win,219,18,2,5,2,SFO,46,370,188,2,-10.190104193636886,34.67437016113989,12.242132983751503,22.432237177388387
0.176470588,0.4,28.25,9/26/2013,14,19,home,-24,SFO,170,151,82,65,11,35,Loss,18,219,5,2,2,LAR,46,188,370,2,10.190104193636886,34.67437016113989,22.432237177388387,12.242132983751503
0.1,0.38888888899999996,25.91666667,9/29/2013,17,20,away,3,TBB,240,173,90,59,13,10,Win,56,80,1,2,3,ARI,23,296,253,3,-10.732199620130633,35.701080022834276,12.484440201351823,23.216639821482453
0.38888888899999996,0.1,34.08333333,9/29/2013,20,17,home,-3,ARI,173,240,73,76,10,13,Loss,80,56,2,1,3,TBB,23,253,296,3,10.732199620130633,35.701080022834276,23.216639821482453,12.484440201351822
0.1875,0.27777777800000003,23.56666667,9/29/2013,15,19,away,-3,BUF,321,147,59,63,20,23,Loss,24,203,4,2,3,BAL,43,345,350,5,-5.624250197911207,42.56333193804218,18.469540870065487,24.093791067976696
0.27777777800000003,0.1875,36.43333333,9/29/2013,19,15,home,3,BAL,147,321,99,79,23,20,Win,203,24,2,4,5,BUF,43,350,345,3,5.624250197911207,42.56333193804218,24.093791067976696,18.469540870065487
0.28571428600000004,0.5,28.85,9/29/2013,16,18,away,-11,CLE,203,247,25,64,6,17,Loss,63,89,2,3,0,CIN,23,266,336,2,-7.4434866685175525,33.98143928993857,13.26897631071051,20.71246297922806
0.5,0.28571428600000004,31.15,9/29/2013,18,16,home,11,CIN,247,203,80,71,17,6,Win,89,63,3,2,2,CLE,23,336,266,0,7.4434866685175525,33.98143928993857,20.71246297922806,13.26897631071051
0.214285714,0.352941176,31.8,9/29/2013,15,29,away,3,HOU,91,325,62,58,3,0,Win,179,151,5,4,3,SEA,3,270,476,2,-9.661212142864082,38.26366580613858,14.301226831637251,23.96243897450133
0.352941176,0.214285714,39.88333333,9/29/2013,29,15,home,-3,SEA,325,91,86,88,0,3,Loss,151,179,4,5,2,HOU,3,476,270,3,9.661212142864082,38.26366580613858,23.96243897450133,14.301226831637251
0.076923077,0.2,28.18333333,9/29/2013,18,23,away,-8,DET,286,228,30,66,32,40,Loss,131,159,3,1,3,CHI,72,417,387,4,2.7175319312601918,48.55679227362552,25.637162102442854,22.919630171182664
0.2,0.076923077,31.81666667,9/29/2013,23,18,home,8,CHI,228,286,25,66,40,32,Win,159,131,1,3,4,DET,72,387,417,3,-2.7175319312601918,48.55679227362552,22.919630171182664,25.637162102442854
0.46153846200000004,0.181818182,36.63333333,9/29/2013,26,14,away,34,JAX,280,165,58,70,37,3,Win,157,40,2,4,3,IND,40,437,205,1,-0.40457751531072716,45.10750873974054,22.351465612214906,22.756043127525633
0.181818182,0.46153846200000004,23.36666667,9/29/2013,14,26,home,-34,IND,165,280,65,54,3,37,Loss,40,157,4,2,1,JAX,40,205,437,3,0.40457751531072716,45.10750873974054,22.756043127525633,22.351465612214906
0.071428571,0.5625,24.06666667,9/29/2013,11,21,away,-24,KCC,200,288,65,61,7,31,Loss,98,102,3,1,3,NYG,38,298,390,3,-7.366042876698952,43.190818859789076,17.91238799154506,25.278430868244016
0.5625,0.071428571,35.93333333,9/29/2013,21,11,home,24,NYG,288,200,62,70,31,7,Win,102,98,1,3,3,KCC,38,390,298,3,7.366042876698952,43.190818859789076,25.278430868244016,17.91238799154506
0.533333333,0.363636364,36.45,9/29/2013,29,16,away,-7,MIN,357,248,50,77,27,34,Loss,77,145,5,1,0,PIT,61,434,393,2,-0.555973497048317,51.935024200525675,25.68952535173868,26.245498848786994
0.363636364,0.533333333,23.55,9/29/2013,16,29,home,7,PIT,248,357,89,51,34,27,Win,145,77,1,5,2,MIN,61,393,434,0,0.555973497048317,51.935024200525675,26.245498848786994,25.68952535173868
0.307692308,0.5555555560000001,29.36666667,9/29/2013,16,17,away,-25,TEN,239,244,66,62,13,38,Loss,91,78,5,2,0,NYJ,51,330,322,4,-6.952088568561294,43.42918562898258,18.238548530210643,25.190637098771937
0.5555555560000001,0.307692308,30.63333333,9/29/2013,17,16,home,25,NYJ,244,239,30,65,38,13,Win,78,91,2,5,4,TEN,51,322,330,0,6.952088568561294,43.42918562898258,25.190637098771937,18.238548530210643
0.5,0.625,26.63333333,9/29/2013,21,35,away,-32,DEN,284,331,62,69,20,52,Loss,166,141,3,1,0,PHI,72,450,472,0,0.857818301259746,61.45173309999857,31.15477570062916,30.29695739936941
0.625,0.5,33.36666667,9/29/2013,35,21,home,32,PHI,331,284,25,71,52,20,Win,141,166,1,3,0,DEN,72,472,450,0,-0.857818301259746,61.45173309999857,30.29695739936941,31.15477570062916
0.3125,0.294117647,27.63333333,9/29/2013,15,14,away,10,OAK,217,194,29,64,24,14,Win,122,104,1,7,3,WAS,38,339,298,1,-9.833991659758645,38.486183707298636,14.326096023769995,24.16008768352864
0.294117647,0.3125,32.36666667,9/29/2013,14,15,home,-10,WAS,194,217,25,65,14,24,Loss,104,122,7,1,1,OAK,38,298,339,3,9.833991659758645,38.486183707298636,24.16008768352864,14.326096023769995
0.333333333,0.41666666700000005,25.95,9/29/2013,21,27,away,-9,LAC,227,394,33,56,21,30,Loss,92,112,3,1,1,DAL,51,319,506,1,0.9195358528713786,50.42295061282258,25.67124323284698,24.751707379975603
0.41666666700000005,0.333333333,34.05,9/29/2013,27,21,home,9,DAL,394,227,85,70,30,21,Win,112,92,1,3,1,LAC,51,506,319,1,-0.9195358528713786,50.42295061282258,24.751707379975603,25.67124323284698
0.538461538,0.428571429,30.65,9/29/2013,21,26,away,7,ATL,316,399,93,62,30,23,Win,132,58,0,2,1,NEP,53,448,457,0,3.4943076666748745,53.27680224093583,28.385554953805354,24.891247287130476
0.428571429,0.538461538,29.35,9/29/2013,26,21,home,-7,NEP,399,316,55,71,23,30,Loss,58,132,2,0,0,ATL,53,457,448,1,-3.4943076666748745,53.27680224093583,24.891247287130476,28.385554953805354
0.333333333,0.46153846200000004,26.18333333,9/30/2013,19,23,away,-21,NOS,216,397,25,58,17,38,Loss,115,68,4,2,1,MIA,55,331,465,4,8.954968329500097,51.632126204638396,30.293547267069247,21.33857893756915
0.46153846200000004,0.333333333,33.81666667,9/30/2013,23,19,home,21,MIA,397,216,45,65,38,17,Win,68,115,2,4,4,NOS,55,465,331,1,-8.954968329500097,51.632126204638396,21.33857893756915,30.293547267069247
0.3125,0.41176470600000004,27.61666667,10/3/2013,20,19,away,-13,CLE,188,199,56,75,24,37,Loss,155,91,4,5,0,BUF,61,343,290,1,-10.76843583925607,35.41320754542621,12.32238585308507,23.09082169234114
0.41176470600000004,0.3125,32.38333333,10/3/2013,19,20,home,13,BUF,199,188,66,65,37,24,Win,91,155,5,4,1,CLE,61,290,343,0,10.76843583925607,35.41320754542621,23.09082169234114,12.32238585308507
0.25,0.42105263200000004,24.68333333,10/6/2013,16,22,away,-14,LAR,267,208,45,59,20,34,Loss,96,143,2,2,0,JAX,54,363,351,3,-8.912489461030514,44.61211627946824,17.84981340921886,26.76230287024938
0.42105263200000004,0.25,35.31666667,10/6/2013,22,16,home,14,JAX,208,267,53,72,34,20,Win,143,96,2,2,3,LAR,54,351,363,0,8.912489461030514,44.61211627946824,26.76230287024938,17.84981340921886
0.083333333,0.4,25.73333333,10/6/2013,15,21,away,-7,CIN,166,179,0,60,6,13,Loss,82,162,4,4,2,NEP,19,248,341,2,10.564286356565544,34.1901537162653,22.377220036415423,11.812933679849877
0.4,0.083333333,34.26666667,10/6/2013,21,15,home,7,NEP,179,166,59,70,13,6,Win,162,82,4,4,2,CIN,19,341,248,2,-10.564286356565544,34.1901537162653,11.812933679849877,22.377220036415423
0.083333333,0.28571428600000004,31.28333333,10/6/2013,20,19,away,9,TEN,233,234,61,67,26,17,Win,120,105,2,3,3,KCC,43,353,339,2,-3.5866016248037527,40.90627963837817,18.65983900678721,22.246440631590964
0.28571428600000004,0.083333333,28.71666667,10/6/2013,19,20,home,-9,KCC,234,233,35,66,17,26,Loss,105,120,3,2,2,TEN,43,339,353,3,3.5866016248037527,40.90627963837817,22.246440631590964,18.65983900678721
0.473684211,0.384615385,32.11666667,10/6/2013,28,21,away,15,NYG,299,330,88,77,36,21,Win,140,53,1,1,4,PHI,57,439,383,0,-13.139414667296126,57.98184161463784,22.421213473670853,35.56062814096698
0.384615385,0.473684211,27.88333333,10/6/2013,21,28,home,-15,PHI,330,299,136,70,21,36,Loss,53,140,1,1,0,NYG,57,383,439,4,13.139414667296126,57.98184161463784,35.56062814096698,22.421213473670853
0.375,0.4,36.0,10/6/2013,17,20,away,8,CHI,283,340,10,65,26,18,Win,64,94,1,3,1,NOS,44,347,434,0,4.391848690905,45.85569788316312,25.12377328703406,20.73192459612906
0.4,0.375,24.0,10/6/2013,20,17,home,-8,NOS,340,283,43,54,18,26,Loss,94,64,3,1,0,CHI,44,434,347,1,-4.391848690905,45.85569788316312,20.73192459612906,25.12377328703406
0.375,0.1875,36.26666667,10/6/2013,20,10,away,3,MIA,251,272,64,74,26,23,Win,133,22,2,6,0,BAL,49,384,294,2,-1.79207086680657,34.356775091426385,16.28235211230991,18.074422979116477
0.1875,0.375,23.73333333,10/6/2013,10,20,home,-3,BAL,272,251,65,57,23,26,Loss,22,133,6,2,2,MIA,49,294,384,0,1.79207086680657,34.356775091426385,18.074422979116477,16.28235211230991
0.166666667,0.583333333,31.36666667,10/6/2013,21,20,away,-6,IND,205,208,85,67,28,34,Loss,218,109,2,2,2,SEA,62,423,317,2,1.716986025175005,46.686990720952124,24.201988373063564,22.48500234788856
0.583333333,0.166666667,28.63333333,10/6/2013,20,21,home,6,SEA,208,205,35,60,34,28,Win,109,218,2,2,2,IND,62,317,423,2,-1.716986025175005,46.686990720952124,22.48500234788856,24.201988373063564
0.46666666700000003,0.4375,27.68333333,10/6/2013,19,16,away,-13,GBP,222,269,50,64,9,22,Loss,64,180,5,1,0,DET,31,286,449,0,-5.451869464128356,44.656320732722506,19.602225634297074,25.05409509842543
0.4375,0.46666666700000003,32.31666667,10/6/2013,16,19,home,13,DET,269,222,72,64,22,9,Win,180,64,1,5,0,GBP,31,449,286,0,5.451869464128356,44.656320732722506,25.05409509842543,19.602225634297074
0.41666666700000005,0.333333333,31.06666667,10/6/2013,21,19,away,-16,ARI,258,160,79,66,6,22,Loss,95,90,7,2,3,CAR,28,353,250,4,0.11552573399494115,45.8881861688768,23.00185595143587,22.88633021744093
0.333333333,0.41666666700000005,28.93333333,10/6/2013,19,21,home,16,CAR,160,258,30,58,22,6,Win,90,95,2,7,4,ARI,28,250,353,3,-0.11552573399494115,45.8881861688768,22.88633021744093,23.00185595143587
0.692307692,0.666666667,32.56666667,10/6/2013,34,24,away,3,DAL,414,470,55,73,51,48,Win,103,52,0,4,2,DEN,99,517,522,2,6.155754585045054,74.09704535372872,40.12639996938689,33.97064538434183
0.666666667,0.692307692,27.43333333,10/6/2013,24,34,home,-3,DEN,470,414,81,54,48,51,Loss,52,103,4,0,2,DAL,99,522,517,2,-6.155754585045054,74.09704535372872,33.97064538434183,40.12639996938689
0.375,0.363636364,33.86666667,10/6/2013,17,17,away,-31,SFO,182,107,52,71,3,34,Loss,131,177,1,1,0,HOU,37,313,284,4,-4.4384229426132755,38.38204475907754,16.97181090823213,21.410233850845408
0.363636364,0.375,26.13333333,10/6/2013,17,17,home,31,HOU,107,182,17,52,34,3,Win,177,131,1,1,4,SFO,37,284,313,0,4.4384229426132755,38.38204475907754,21.410233850845408,16.97181090823213
0.363636364,0.333333333,30.91666667,10/6/2013,27,17,away,-10,OAK,391,195,30,69,17,27,Loss,36,104,2,4,0,LAC,44,427,299,5,1.728959106857232,53.279037914482345,27.50399851066979,25.775039403812556
0.333333333,0.363636364,29.08333333,10/6/2013,17,27,home,10,LAC,195,391,85,55,27,17,Win,104,36,4,2,5,OAK,44,299,427,0,-1.728959106857232,53.279037914482345,25.775039403812556,27.50399851066979
0.545454545,0.5,24.55,10/7/2013,15,26,away,2,ATL,170,299,24,46,30,28,Win,118,64,4,2,1,NYJ,58,288,363,0,4.657513129521762,44.04491426553621,24.351213697528983,19.693700568007223
0.5,0.545454545,35.45,10/7/2013,26,15,home,-2,NYJ,299,170,46,70,28,30,Loss,64,118,2,4,0,ATL,58,363,288,1,-4.657513129521762,44.04491426553621,19.693700568007223,24.351213697528983
0.636363636,0.454545455,27.08333333,10/10/2013,21,26,away,-6,CHI,232,262,31,53,21,27,Loss,123,110,1,0,0,NYG,48,355,372,3,1.9187244238378014,54.68135282295342,28.30003862339561,26.38131419955781
0.454545455,0.636363636,32.91666667,10/10/2013,26,21,home,6,NYG,262,232,51,65,27,21,Win,110,123,0,1,3,CHI,48,372,355,0,-1.9187244238378014,54.68135282295342,26.38131419955781,28.30003862339561
0.571428571,0.35714285700000004,33.48333333,10/13/2013,24,23,away,14,CLE,248,269,65,72,31,17,Win,118,126,1,2,2,DET,48,366,395,1,-8.27164896071079,49.32846580090054,20.528408420094873,28.800057380805665
0.35714285700000004,0.571428571,26.51666667,10/13/2013,23,24,home,-14,DET,269,248,87,66,17,31,Loss,126,118,2,1,1,CLE,48,395,366,2,8.27164896071079,49.32846580090054,28.800057380805665,20.528408420094873
0.352941176,0.14285714300000002,31.36666667,10/13/2013,15,15,away,2,BAL,298,313,55,65,19,17,Win,140,47,3,5,1,GBP,36,438,360,2,5.510320152520997,42.838213184732886,24.17426666862694,18.663946516105945
0.14285714300000002,0.352941176,28.63333333,10/13/2013,15,15,home,-2,GBP,313,298,40,61,17,19,Loss,47,140,5,3,2,BAL,36,360,438,1,-5.510320152520997,42.838213184732886,18.663946516105945,24.17426666862694
0.38888888899999996,0.470588235,42.86666667,10/13/2013,26,20,away,3,BUF,318,192,78,84,3,0,Win,165,130,3,5,1,CIN,3,483,322,1,-10.958862086985953,42.82577716341609,15.93345753821507,26.892319625201022
0.470588235,0.38888888899999996,25.4,10/13/2013,20,26,home,-3,CIN,192,318,27,69,0,3,Loss,130,165,5,3,1,BUF,3,322,483,1,10.958862086985953,42.82577716341609,26.892319625201022,15.93345753821507
0.428571429,0.428571429,24.83333333,10/13/2013,15,27,away,25,HOU,117,267,74,41,38,13,Win,99,153,0,5,4,LAR,51,216,420,0,-1.5108343472639607,48.83283805811272,23.66100185542438,25.17183620268834
0.428571429,0.428571429,35.16666667,10/13/2013,27,15,home,-25,LAR,267,117,95,73,13,38,Loss,153,99,5,0,0,HOU,51,420,216,4,1.5108343472639607,48.83283805811272,25.17183620268834,23.66100185542438
0.26666666699999997,0.28571428600000004,34.0,10/13/2013,18,16,away,-17,KCC,153,105,68,71,7,24,Loss,121,111,9,3,1,OAK,31,274,216,3,-6.151518214768787,33.16806943766858,13.508275611449896,19.65979382621868
0.28571428600000004,0.26666666699999997,26.0,10/13/2013,16,18,home,17,OAK,105,153,20,61,24,7,Win,111,121,3,9,3,KCC,31,216,274,1,6.151518214768787,33.16806943766858,19.65979382621868,13.508275611449896
0.583333333,0.428571429,36.45,10/13/2013,22,17,away,25,MIN,236,215,40,66,35,10,Win,131,75,1,3,2,CAR,45,367,290,0,-7.575360930200583,46.25039634058752,19.33751770519347,26.91287863539405
0.428571429,0.583333333,23.55,10/13/2013,17,22,home,-25,CAR,215,236,55,60,10,35,Loss,75,131,3,1,0,MIN,45,290,367,2,7.575360930200583,46.25039634058752,26.91287863539405,19.33751770519347
0.375,0.272727273,35.81666667,10/13/2013,16,18,away,13,NYJ,255,184,49,61,19,6,Win,73,83,4,3,2,PIT,25,328,267,0,2.282072847705882,37.66656472152634,19.974318784616113,17.69224593691023
0.272727273,0.375,24.18333333,10/13/2013,18,16,home,-13,PIT,184,255,60,57,6,19,Loss,83,73,3,4,0,NYJ,25,267,328,2,-2.282072847705882,37.66656472152634,17.69224593691023,19.974318784616113
0.5,0.4,26.23333333,10/13/2013,21,19,away,11,TBB,287,257,31,65,31,20,Win,138,94,1,2,1,PHI,51,425,351,1,-6.326558291512044,48.88084530681424,21.277143507651097,27.60370179916314
0.4,0.5,33.76666667,10/13/2013,19,21,home,-11,PHI,257,287,72,66,20,31,Loss,94,138,2,1,1,TBB,51,351,425,1,6.326558291512044,48.88084530681424,27.60370179916314,21.277143507651097
0.35714285700000004,0.538461538,31.25,10/13/2013,20,26,away,-16,DEN,291,295,62,71,19,35,Loss,71,112,2,0,3,JAX,54,362,407,2,-7.164175479107623,54.203163949507214,23.519494235199794,30.68366971430742
0.538461538,0.35714285700000004,28.75,10/13/2013,26,20,home,16,JAX,295,291,31,71,35,19,Win,112,71,0,2,2,DEN,54,407,362,3,7.164175479107623,54.203163949507214,30.68366971430742,23.519494235199794
0.333333333,0.384615385,26.63333333,10/13/2013,13,24,away,-7,SEA,157,253,44,52,13,20,Loss,66,151,3,2,2,TEN,33,223,404,2,2.5175990143580407,41.894798906643935,22.206198960500988,19.688599946142947
0.384615385,0.333333333,33.36666667,10/13/2013,24,13,home,7,TEN,253,157,65,66,20,13,Win,151,66,2,3,2,SEA,33,404,223,2,-2.5175990143580407,41.894798906643935,19.688599946142947,22.206198960500988
0.384615385,0.28571428600000004,25.68333333,10/13/2013,16,20,away,-12,SFO,294,238,38,63,20,32,Loss,109,149,1,2,2,ARI,52,403,387,4,-1.633903741660518,45.371857463680854,21.868976861010168,23.502880602670686
0.28571428600000004,0.384615385,34.31666667,10/13/2013,20,16,home,12,ARI,238,294,35,69,32,20,Win,149,109,2,1,4,SFO,52,387,403,2,1.633903741660518,45.371857463680854,23.502880602670686,21.868976861010168
0.35714285700000004,0.333333333,28.15,10/13/2013,20,26,away,-3,NEP,230,235,56,63,27,30,Loss,131,141,1,5,1,NOS,57,361,376,2,1.694337417379149,43.28844318150197,22.49139029944056,20.797052882061408
0.333333333,0.35714285700000004,31.85,10/13/2013,26,20,home,3,NOS,235,230,33,83,30,27,Win,141,131,5,1,2,NEP,57,376,361,1,-1.694337417379149,43.28844318150197,20.797052882061408,22.49139029944056
0.5,0.41666666700000005,34.53333333,10/13/2013,25,18,away,-15,DAL,217,165,104,75,16,31,Loss,216,48,3,1,1,WAS,47,433,213,2,-10.012747672579376,43.31024734757416,16.64874983749739,26.66149751007677
0.41666666700000005,0.5,25.46666667,10/13/2013,18,25,home,15,WAS,165,217,80,50,31,16,Win,48,216,1,3,2,DAL,47,213,433,1,10.012747672579376,43.31024734757416,26.66149751007677,16.64874983749739
0.2,0.5,21.48333333,10/14/2013,12,24,away,-10,LAC,193,227,28,48,9,19,Loss,74,147,1,2,0,IND,28,267,374,1,1.9152719895330428,38.572639692578164,20.2439558410556,18.328683851522563
0.5,0.2,38.51666667,10/14/2013,24,12,home,10,IND,227,193,25,72,19,9,Win,147,74,2,1,1,LAC,28,374,267,0,-1.9152719895330428,38.572639692578164,18.328683851522563,20.2439558410556
0.583333333,0.333333333,27.66666667,10/17/2013,21,22,away,12,ARI,209,204,70,64,34,22,Win,135,30,3,7,2,SEA,56,344,234,2,-0.2360739143663082,39.00474023843414,19.384333162033915,19.620407076400223
0.333333333,0.583333333,32.33333333,10/17/2013,22,21,home,-12,SEA,204,209,22,70,22,34,Loss,30,135,7,3,2,ARI,56,234,344,2,0.2360739143663082,39.00474023843414,19.620407076400223,19.384333162033915
0.473684211,0.23076923100000002,30.2,10/20/2013,15,19,away,2,MIA,178,173,53,66,23,21,Win,90,120,4,2,3,BUF,44,268,293,1,-3.674233360923821,36.411643888596565,16.36870526383637,20.042938624760193
0.23076923100000002,0.473684211,29.8,10/20/2013,19,15,home,-2,BUF,173,178,32,64,21,23,Loss,120,90,2,4,1,MIA,44,293,268,3,3.674233360923821,36.411643888596565,20.042938624760193,16.36870526383637
0.083333333,0.523809524,23.66666667,10/20/2013,21,27,away,-3,NYJ,205,206,100,70,0,3,Loss,90,177,4,4,1,NEP,3,295,383,1,-9.359052269919562,33.942607545627595,12.291777637854018,21.650829907773577
0.523809524,0.083333333,46.21666667,10/20/2013,27,21,home,3,NEP,206,205,45,89,3,0,Win,177,90,4,4,1,NYJ,3,383,295,1,9.359052269919562,33.942607545627595,21.650829907773577,12.291777637854016
0.3125,0.222222222,36.21666667,10/20/2013,22,19,away,14,PHI,294,194,75,75,17,3,Win,74,84,2,3,3,DAL,20,368,278,2,-10.759468699634844,40.34677365074471,14.793652475554932,25.553121175189776
0.222222222,0.3125,23.78333333,10/20/2013,19,22,home,-14,DAL,194,294,33,75,3,17,Loss,84,74,3,2,2,PHI,20,278,368,3,10.759468699634844,40.34677365074471,25.553121175189776,14.793652475554932
0.25,0.538461538,26.06666667,10/20/2013,21,28,away,-4,WAS,219,290,30,52,41,45,Loss,140,209,2,1,1,CHI,86,359,499,1,-1.526642769711568,52.21824611273557,25.345801671512,26.87244444122357
0.538461538,0.25,33.93333333,10/20/2013,28,21,home,4,CHI,290,219,47,73,45,41,Win,209,140,1,2,1,WAS,86,499,359,1,1.526642769711568,52.21824611273557,26.87244444122357,25.345801671512
0.583333333,0.272727273,37.5,10/20/2013,27,18,away,18,JAX,276,275,61,67,24,6,Win,158,78,1,6,1,LAC,30,434,353,0,-2.422916419992376,49.458933982614894,23.51800878131126,25.940925201303635
0.272727273,0.583333333,22.5,10/20/2013,18,27,home,-18,LAC,275,276,45,59,6,24,Loss,78,158,6,1,0,JAX,30,353,434,1,2.422916419992376,49.458933982614894,25.940925201303635,23.51800878131126
0.294117647,0.333333333,37.81666667,10/20/2013,23,15,away,-8,ATL,226,273,103,75,23,31,Loss,111,18,3,0,1,TBB,54,337,291,1,-5.136441776407027,39.28211229698342,17.072835260288198,22.209277036695223
0.333333333,0.294117647,22.18333333,10/20/2013,15,23,home,8,TBB,273,226,101,44,31,23,Win,18,111,0,3,1,ATL,54,291,337,1,5.136441776407027,39.28211229698342,22.209277036695223,17.072835260288198
0.4,0.684210526,25.48333333,10/20/2013,18,22,away,3,DET,364,357,50,53,27,24,Win,57,77,1,0,0,CIN,51,421,434,0,-1.604757305253051,52.12652113421868,25.260881914482813,26.865639219735865
0.684210526,0.4,34.51666667,10/20/2013,22,18,home,-3,CIN,357,364,30,76,24,27,Loss,77,57,0,1,0,DET,51,434,421,0,1.604757305253051,52.12652113421868,26.865639219735865,25.260881914482813
0.307692308,0.222222222,26.66666667,10/20/2013,15,21,away,-15,CAR,254,180,68,59,15,30,Loss,63,102,4,2,0,LAR,45,317,282,3,-1.890775927811898,41.89556909250198,20.002396582345042,21.893172510156937
0.222222222,0.307692308,33.33333333,10/20/2013,21,15,home,15,LAR,180,254,59,57,30,15,Win,102,63,2,4,3,CAR,45,282,317,0,1.890775927811898,41.89556909250198,21.893172510156937,20.002396582345042
0.5,0.35714285700000004,35.76666667,10/20/2013,19,15,away,14,TEN,196,298,42,64,31,17,Win,153,70,2,3,2,SFO,48,349,368,0,-5.897023086720388,43.738575386959695,18.920776150119654,24.81779923684004
0.35714285700000004,0.5,24.23333333,10/20/2013,15,19,home,-14,SFO,298,196,100,57,17,31,Loss,70,153,3,2,0,TEN,48,368,349,2,5.897023086720388,43.738575386959695,24.81779923684004,18.920776150119654
0.333333333,0.46666666700000003,27.8,10/20/2013,14,20,away,-1,KCC,221,231,40,54,16,17,Loss,73,126,5,2,2,HOU,33,294,357,1,-1.9426621652072273,40.44781788185037,19.252577858321573,21.195240023528797
0.46666666700000003,0.333333333,32.2,10/20/2013,20,14,home,1,HOU,231,221,24,68,17,16,Win,126,73,2,5,1,KCC,33,357,294,2,1.9426621652072273,40.44781788185037,21.195240023528797,19.252577858321573
0.38888888899999996,0.538461538,26.63333333,10/20/2013,17,26,away,-18,GBP,133,253,106,68,13,31,Loss,83,104,3,1,0,CLE,44,216,357,1,-10.447919453250497,39.905237019051874,14.728658782900688,25.176578236151187
0.538461538,0.38888888899999996,33.36666667,10/20/2013,26,17,home,18,CLE,253,133,97,66,31,13,Win,104,83,1,3,1,GBP,44,357,216,0,10.447919453250497,39.905237019051874,25.176578236151187,14.728658782900688
0.5,0.583333333,28.98333333,10/20/2013,19,17,away,-3,PIT,205,145,67,61,16,19,Loss,82,141,1,3,1,BAL,35,287,286,0,3.510214971306645,38.19479479491279,20.852504883109717,17.34228991180307
0.583333333,0.5,31.01666667,10/20/2013,17,19,home,3,BAL,145,205,50,55,19,16,Win,141,82,3,1,0,PIT,35,286,287,1,-3.510214971306645,38.19479479491279,17.34228991180307,20.852504883109717
0.3125,0.294117647,28.21666667,10/20/2013,23,19,away,-6,IND,365,213,103,73,33,39,Loss,64,121,4,2,1,DEN,72,429,334,3,-6.797493162027719,48.261133881569904,20.731820359771092,27.529313521798812
0.294117647,0.3125,31.78333333,10/20/2013,19,23,home,6,DEN,213,365,52,71,39,33,Win,121,64,2,4,3,IND,72,334,429,1,6.797493162027719,48.261133881569904,27.529313521798812,20.731820359771092
0.38888888899999996,0.36842105299999994,23.63333333,10/21/2013,13,17,away,-16,NYG,176,193,38,68,7,23,Loss,30,64,1,2,1,MIN,30,206,257,3,-17.259931294807615,32.26260801505212,7.501338360122254,24.76126965492987
0.36842105299999994,0.38888888899999996,36.36666667,10/21/2013,17,13,home,16,MIN,193,176,72,73,23,7,Win,64,30,2,1,3,NYG,30,257,206,1,17.259931294807615,32.26260801505212,24.76126965492987,7.501338360122254
0.41666666700000005,0.28571428600000004,34.55,10/24/2013,21,19,away,18,TBB,195,249,59,62,31,13,Win,129,48,3,3,1,CAR,44,324,297,0,-10.105297425025238,39.6741967960257,14.784449685500228,24.88974711052547
0.28571428600000004,0.41666666700000005,25.45,10/24/2013,19,21,home,-18,CAR,249,195,21,68,13,31,Loss,48,129,3,3,0,TBB,44,297,324,1,10.105297425025238,39.6741967960257,24.88974711052547,14.78444968550023
0.470588235,0.2,34.98333333,10/27/2013,23,19,away,-10,NEP,145,100,61,79,17,27,Loss,156,152,6,3,1,MIA,44,301,252,3,1.1364839473340904,34.28651885217009,17.71150139975209,16.575017452418
0.2,0.470588235,25.01666667,10/27/2013,19,23,home,10,MIA,100,145,35,62,27,17,Win,152,156,3,6,3,NEP,44,252,301,1,-1.1364839473340904,34.28651885217009,16.575017452418,17.71150139975209
0.25,0.526315789,23.91666667,10/27/2013,13,20,away,-6,KCC,283,195,70,52,17,23,Loss,57,136,1,6,0,CLE,40,340,331,1,-2.6279380325995456,35.72612995091168,16.549095959156066,19.17703399175561
0.526315789,0.25,36.08333333,10/27/2013,20,13,home,6,CLE,195,283,31,71,23,17,Win,136,57,6,1,1,KCC,40,331,340,0,2.6279380325995456,35.72612995091168,19.17703399175561,16.549095959156066
0.666666667,0.28571428600000004,28.48333333,10/27/2013,25,20,away,32,JAX,177,228,35,55,42,10,Win,221,90,0,0,1,SFO,52,398,318,1,-4.269377958103432,48.38620630157517,22.05841417173587,26.327792129839303
0.28571428600000004,0.666666667,31.51666667,10/27/2013,20,25,home,-32,SFO,228,177,76,70,10,42,Loss,90,221,0,0,1,JAX,52,318,398,1,4.269377958103432,48.38620630157517,26.327792129839303,22.05841417173587
0.42105263200000004,0.25,38.08333333,10/27/2013,16,15,away,8,PHI,237,152,92,71,15,7,Win,88,48,1,4,3,NYG,22,325,200,1,-6.653053506703467,38.23802133415965,15.792483913728091,22.445537420431556
0.25,0.42105263200000004,21.91666667,10/27/2013,15,16,home,-8,NYG,152,237,48,58,7,15,Loss,48,88,4,1,1,PHI,22,200,325,3,6.653053506703467,38.23802133415965,22.445537420431556,15.792483913728091
0.23076923100000002,0.272727273,24.81666667,10/27/2013,13,29,away,-1,DET,206,480,31,56,30,31,Loss,62,143,0,1,4,DAL,61,268,623,0,-1.8893605716596822,51.10382514444603,24.607232286393174,26.496592858052853
0.272727273,0.23076923100000002,35.18333333,10/27/2013,29,13,home,1,DAL,480,206,61,78,31,30,Win,143,62,1,0,0,DET,61,623,268,4,1.8893605716596822,51.10382514444603,26.496592858052853,24.607232286393174
0.384615385,0.46666666700000003,27.5,10/27/2013,20,21,away,-18,NOS,211,309,45,68,17,35,Loss,88,77,4,4,0,BUF,52,299,386,3,-1.0054158256120438,45.682887431011444,22.338735802699702,23.344151628311742
0.46666666700000003,0.384615385,32.5,10/27/2013,21,20,home,18,BUF,309,211,59,64,35,17,Win,77,88,4,4,3,NOS,52,386,299,0,1.0054158256120438,45.682887431011444,23.344151628311742,22.338735802699702
0.4,0.545454545,33.28333333,10/27/2013,15,20,away,-40,CIN,147,323,69,65,9,49,Loss,93,79,4,1,1,NYJ,58,240,402,2,0.6148352150876129,43.86821837907793,22.24152679708277,21.62669158199516
0.545454545,0.4,26.71666667,10/27/2013,20,15,home,40,NYJ,323,147,45,56,49,9,Win,79,93,1,4,2,CIN,58,402,240,1,-0.6148352150876129,43.86821837907793,21.62669158199516,22.24152679708277
0.26666666699999997,0.35714285700000004,29.98333333,10/27/2013,20,13,away,-3,OAK,241,82,12,69,18,21,Loss,35,197,5,2,3,PIT,39,276,279,2,-2.807309383161524,38.486165456679004,17.83942803675874,20.646737419920264
0.35714285700000004,0.26666666699999997,30.01666667,10/27/2013,13,20,home,3,PIT,82,241,39,59,21,18,Win,197,35,2,5,2,OAK,39,279,276,3,2.807309383161524,38.486165456679004,20.646737419920264,17.83942803675874
0.428571429,0.333333333,28.0,10/27/2013,22,29,away,-24,DEN,154,339,5,70,21,45,Loss,112,107,3,2,4,WAS,66,266,446,5,-6.5034944849990834,52.6005898549422,23.04854768497156,29.55204216997064
0.333333333,0.428571429,32.0,10/27/2013,29,22,home,24,WAS,339,154,57,80,45,21,Win,107,112,2,3,5,DEN,66,446,266,4,6.5034944849990834,52.6005898549422,29.55204216997064,23.04854768497156
0.4,0.3,34.31666667,10/27/2013,20,17,away,-14,ARI,265,147,55,79,13,27,Loss,27,201,4,3,1,ATL,40,292,348,4,-2.046706858247436,38.235522896172526,18.094408018962547,20.14111487720998
0.3,0.4,25.68333333,10/27/2013,17,20,home,14,ATL,147,265,52,51,27,13,Win,201,27,3,4,4,ARI,40,348,292,1,2.046706858247436,38.235522896172526,20.14111487720998,18.094408018962547
0.7222222220000001,0.25,40.9,10/27/2013,26,15,away,13,MIN,282,132,120,73,44,31,Win,182,111,2,3,0,GBP,75,464,243,0,1.1188949370343888,47.86723331420009,24.49306412561724,23.37416918858285
0.25,0.7222222220000001,19.1,10/27/2013,15,26,home,-13,GBP,132,282,46,43,31,44,Loss,111,182,3,2,0,MIN,75,243,464,0,-1.1188949370343888,47.86723331420009,23.37416918858285,24.49306412561724
0.181818182,0.35714285700000004,21.85,10/28/2013,7,23,away,5,LAR,91,139,83,40,14,9,Win,44,200,7,3,2,SEA,23,135,339,0,2.9039321173894965,29.31685030537949,16.110391211384492,13.206459093994997
0.35714285700000004,0.181818182,38.15,10/28/2013,23,7,home,-5,SEA,139,91,53,71,9,14,Loss,200,44,3,7,0,LAR,23,339,135,2,-2.9039321173894965,29.31685030537949,13.206459093994997,16.110391211384492
0.5,0.214285714,40.03333333,10/31/2013,28,15,away,-2,MIA,302,188,63,93,0,2,Loss,163,157,5,3,1,CIN,2,465,345,4,-9.03131043297933,41.138973100539495,16.05383133378008,25.085141766759413
0.214285714,0.5,28.33333333,10/31/2013,15,28,home,2,CIN,188,302,25,61,2,0,Win,157,163,3,5,4,MIA,2,345,465,1,9.03131043297933,41.138973100539495,25.085141766759413,16.05383133378008
0.23076923100000002,0.307692308,29.76666667,11/3/2013,15,25,away,10,BUF,115,229,38,54,23,13,Win,95,241,2,0,3,KCC,36,210,470,0,-2.576263672615055,40.13290849145707,18.77832240942101,21.354586082036064
0.307692308,0.23076923100000002,30.23333333,11/3/2013,25,15,home,-10,KCC,229,115,48,77,13,23,Loss,241,95,0,2,0,BUF,36,470,210,3,2.576263672615055,40.13290849145707,21.354586082036064,18.77832240942101
0.583333333,0.384615385,27.15,11/3/2013,22,21,away,7,LAR,165,203,30,61,28,21,Win,198,160,4,2,2,TEN,49,363,363,2,-7.042018159611439,49.16069728184584,21.059339561117202,28.10135772072864
0.384615385,0.583333333,32.85,11/3/2013,21,22,home,-7,TEN,203,165,44,69,21,28,Loss,160,198,2,4,2,LAR,49,363,363,2,7.042018159611439,49.16069728184584,28.10135772072864,21.059339561117202
0.272727273,0.28571428600000004,29.53333333,11/3/2013,23,14,away,-6,NYJ,366,140,59,66,20,26,Loss,41,198,2,2,0,NOS,46,407,338,2,1.1782816925918969,43.76276126812756,22.47052148035973,21.292239787767834
0.28571428600000004,0.272727273,30.46666667,11/3/2013,14,23,home,6,NOS,140,366,62,58,26,20,Win,198,41,2,2,2,NYJ,46,338,407,0,-1.1782816925918969,43.76276126812756,21.292239787767834,22.47052148035973
0.384615385,0.35714285700000004,31.45,11/3/2013,22,20,away,-4,DAL,224,314,35,68,23,27,Loss,169,36,2,3,1,MIN,50,393,350,2,-2.2487264470086332,44.99323828005742,21.37225591652439,23.620982363533027
0.35714285700000004,0.384615385,28.55,11/3/2013,20,22,home,4,MIN,314,224,45,63,27,23,Win,36,169,3,2,2,DAL,50,350,393,1,2.2487264470086332,44.99323828005742,23.620982363533027,21.37225591652439
0.4,0.571428571,23.48333333,11/3/2013,12,27,away,-24,CAR,211,242,59,48,10,34,Loss,78,131,1,1,2,ATL,44,289,373,4,0.00766241973731141,49.50428615890696,24.755974289322133,24.748311869584825
0.571428571,0.4,36.51666667,11/3/2013,27,12,home,24,ATL,242,211,15,71,34,10,Win,131,78,1,1,4,CAR,44,373,289,2,-0.00766241973731141,49.50428615890696,24.748311869584825,24.755974289322133
0.333333333,0.705882353,25.96666667,11/3/2013,25,27,away,-6,WAS,341,291,63,63,0,6,Loss,69,209,1,0,1,LAC,6,410,500,2,-8.21645737704456,54.97846329111959,23.381002957037516,31.597460334082072
0.705882353,0.333333333,40.05,11/3/2013,27,25,home,6,LAC,291,341,65,72,6,0,Win,209,69,0,1,2,WAS,6,500,410,1,8.21645737704456,54.97846329111959,31.597460334082072,23.381002957037516
0.533333333,0.666666667,36.61666667,11/3/2013,24,26,away,-3,SEA,145,217,99,65,0,3,Loss,205,198,3,0,3,TBB,3,350,415,0,-4.505378234245006,49.396713105285066,22.44566743552003,26.951045669765037
0.666666667,0.533333333,30.2,11/3/2013,26,24,home,3,TBB,217,145,67,61,3,0,Win,198,205,0,3,0,SEA,3,415,350,3,4.505378234245006,49.396713105285066,26.951045669765037,22.44566743552003
0.4,0.333333333,22.1,11/3/2013,21,29,away,29,OAK,418,350,52,57,49,20,Win,124,210,1,3,2,PHI,69,542,560,0,-8.379894012597585,66.24471320222214,28.932409594812277,37.312303607409866
0.333333333,0.4,37.9,11/3/2013,29,21,home,-29,PHI,350,418,70,92,20,49,Loss,210,124,3,1,0,OAK,69,560,542,2,8.379894012597585,66.24471320222214,37.312303607409866,28.932409594812277
0.384615385,0.583333333,31.2,11/3/2013,24,33,away,-24,NEP,371,413,96,73,31,55,Loss,108,197,5,3,1,PIT,86,479,610,3,6.927058952382765,66.28963935668233,36.60834915453255,29.681290202149782
0.583333333,0.384615385,28.8,11/3/2013,33,24,home,24,PIT,413,371,30,71,55,31,Win,197,108,3,5,3,NEP,86,610,479,1,-6.927058952382765,66.28963935668233,29.681290202149782,36.60834915453255
0.4375,0.26666666699999997,29.16666667,11/3/2013,18,19,away,-6,CLE,223,242,80,67,18,24,Loss,55,73,5,2,1,BAL,42,278,315,2,-3.5383283202013915,34.51167187770769,15.486671778753148,19.025000098954543
0.26666666699999997,0.4375,30.83333333,11/3/2013,19,18,home,6,BAL,242,223,55,68,24,18,Win,73,55,2,5,2,CLE,42,315,278,1,3.5383283202013915,34.51167187770769,19.025000098954543,15.48667177875315
0.307692308,0.428571429,23.8,11/3/2013,17,22,away,3,HOU,245,340,15,58,27,24,Win,69,143,4,1,0,IND,51,314,483,0,-3.415544219647792,46.868352301444546,21.726404040898377,25.14194826054617
0.428571429,0.307692308,36.2,11/3/2013,22,17,home,-3,IND,340,245,86,68,24,27,Loss,143,69,1,4,0,HOU,51,483,314,0,3.415544219647792,46.868352301444546,25.14194826054617,21.726404040898377
0.428571429,0.111111111,33.15,11/4/2013,25,17,away,7,GBP,271,113,45,75,27,20,Win,171,199,1,5,1,CHI,47,442,312,0,0.671142527671682,42.823163417047304,21.747152972359494,21.07601044468781
0.111111111,0.428571429,26.85,11/4/2013,17,25,home,-7,CHI,113,271,0,55,20,27,Loss,199,171,5,1,0,GBP,47,312,442,1,-0.671142527671682,42.823163417047304,21.07601044468781,21.747152972359494
0.5625,0.6,36.01666667,11/7/2013,27,22,away,-7,MIN,242,216,63,77,27,34,Loss,191,91,4,1,1,WAS,61,433,307,0,-5.095116278131251,49.433218780597024,22.169051251232887,27.264167529364137
0.6,0.5625,23.98333333,11/7/2013,22,27,home,7,WAS,216,242,7,52,34,27,Win,91,191,1,4,0,MIN,61,307,433,1,5.095116278131251,49.433218780597024,27.264167529364137,22.169051251232887
0.363636364,0.4375,25.6,11/10/2013,19,23,away,14,GBP,211,297,65,58,27,13,Win,204,99,3,1,2,PHI,40,415,396,1,0.5391422493566704,52.88223386973485,26.71068805954576,26.171545810189087
0.4375,0.363636364,34.4,11/10/2013,23,19,home,-14,PHI,297,211,31,75,13,27,Loss,99,204,1,3,1,GBP,40,396,415,2,-0.5391422493566704,52.88223386973485,26.171545810189087,26.71068805954576
0.41666666700000005,0.41176470600000004,28.41666667,11/10/2013,21,19,away,2,CHI,219,300,51,61,21,19,Win,145,38,0,2,1,DET,40,364,338,1,-6.969941219894875,44.73837407326829,18.884216426686706,25.854157646581584
0.41176470600000004,0.41666666700000005,31.58333333,11/10/2013,19,21,home,-2,DET,300,219,39,71,19,21,Loss,38,145,2,0,1,CHI,40,338,364,1,6.969941219894875,44.73837407326829,25.854157646581584,18.884216426686706
0.214285714,0.470588235,24.73333333,11/10/2013,16,19,away,-13,PIT,132,164,28,64,10,23,Loss,95,136,3,4,1,BUF,33,227,300,1,-4.385371995768473,32.57169013526586,14.093159069748694,18.478531065517167
0.470588235,0.214285714,35.26666667,11/10/2013,19,16,home,13,BUF,164,132,42,67,23,10,Win,136,95,4,3,1,PIT,33,300,227,1,4.385371995768473,32.57169013526586,18.478531065517167,14.093159069748694
0.263157895,0.1875,37.96666667,11/10/2013,21,18,away,-3,BAL,244,104,134,87,0,3,Loss,120,85,5,5,3,CIN,3,364,189,3,-12.737204472184512,27.47733205356868,7.370063790692086,20.107268262876595
0.1875,0.263157895,31.58333333,11/10/2013,18,21,home,3,CIN,104,244,65,71,3,0,Win,85,120,5,5,3,BAL,3,189,364,3,12.737204472184512,27.47733205356868,20.107268262876595,7.370063790692084
0.25,0.5555555560000001,29.4,11/10/2013,13,19,away,2,TEN,160,279,19,56,29,27,Win,54,83,3,1,4,JAX,56,214,362,2,-7.448870434652449,42.06381394271421,17.307471754030882,24.75634218868333
0.5555555560000001,0.25,30.6,11/10/2013,19,13,home,-2,JAX,279,160,45,70,27,29,Loss,83,54,1,3,2,TEN,56,362,214,4,7.448870434652449,42.06381394271421,24.75634218868333,17.307471754030882
0.166666667,0.5,27.96666667,11/10/2013,12,19,away,-4,NYG,106,118,65,55,20,24,Loss,107,133,4,3,3,OAK,44,213,251,2,-1.7018477572991024,38.224184849912724,18.261168546306813,19.96301630360591
0.5,0.166666667,32.03333333,11/10/2013,19,12,home,4,OAK,118,106,5,63,24,20,Win,133,107,3,4,2,NYG,44,251,213,3,1.7018477572991024,38.224184849912724,19.96301630360591,18.261168546306813
0.6,0.333333333,35.5,11/10/2013,25,16,away,23,ATL,279,162,80,69,33,10,Win,211,64,1,2,1,SEA,43,490,226,0,1.5979973676763493,42.18474282924962,21.891370098462986,20.293372730786636
0.333333333,0.6,24.5,11/10/2013,16,25,home,-23,SEA,162,279,15,54,10,33,Loss,64,211,2,1,0,ATL,43,226,490,1,-1.5979973676763493,42.18474282924962,20.293372730786636,21.891370098462986
0.46666666700000003,0.166666667,30.63333333,11/10/2013,12,21,away,30,IND,232,388,46,55,38,8,Win,140,18,2,3,5,LAR,46,372,406,1,1.4317811132569958,49.2733249902001,25.35255305172855,23.920771938471553
0.166666667,0.46666666700000003,29.36666667,11/10/2013,21,12,home,-30,LAR,388,232,20,69,8,38,Loss,18,140,3,2,1,IND,46,406,372,5,-1.4317811132569958,49.2733249902001,23.920771938471553,25.35255305172855
0.41176470600000004,0.153846154,32.05,11/10/2013,15,10,away,1,SFO,141,46,25,66,10,9,Win,109,105,3,6,2,CAR,19,250,151,2,-3.2809178235171217,26.803853594701685,11.761467885592282,15.042385709109404
0.153846154,0.41176470600000004,27.95,11/10/2013,10,15,home,-1,CAR,46,141,25,52,9,10,Loss,105,109,6,3,2,SFO,19,151,250,2,3.2809178235171217,26.803853594701685,15.042385709109404,11.761467885592282
0.375,0.4375,21.95,11/10/2013,22,20,away,8,LAC,313,198,28,60,28,20,Win,84,131,2,4,0,DEN,48,397,329,1,1.3808739750737675,44.97584147043532,23.178357722754544,21.797483747680776
0.4375,0.375,38.05,11/10/2013,20,22,home,-8,DEN,198,313,40,68,20,28,Loss,131,84,4,2,1,LAC,48,329,397,0,-1.3808739750737675,44.97584147043532,21.797483747680776,23.178357722754544
0.375,0.3,28.86666667,11/10/2013,17,19,away,-3,ARI,159,235,53,67,24,27,Loss,76,97,3,1,3,HOU,51,235,332,1,-5.416283218307762,36.79350151998267,15.688609150837454,21.104892369145215
0.3,0.375,31.13333333,11/10/2013,19,17,home,3,HOU,235,159,29,62,27,24,Win,97,76,1,3,1,ARI,51,332,235,3,5.416283218307762,36.79350151998267,21.104892369145215,15.688609150837454
0.0,0.75,20.46666667,11/10/2013,9,40,away,-32,NOS,104,383,82,43,17,49,Loss,89,242,3,1,1,DAL,66,193,625,0,4.173706032547734,49.51763153468478,26.845668783616258,22.671962751068524
0.75,0.0,39.53333333,11/10/2013,40,9,home,32,DAL,383,104,44,80,49,17,Win,242,89,1,3,0,NOS,66,625,193,1,-4.173706032547734,49.51763153468478,22.671962751068524,26.845668783616258
0.333333333,0.25,25.2,11/11/2013,16,18,away,-3,TBB,211,124,70,58,19,22,Loss,2,140,2,2,1,MIA,41,213,264,1,-3.675077359993238,31.028871791597922,13.676897215802342,17.35197457579558
0.25,0.333333333,34.8,11/11/2013,18,16,home,3,MIA,124,211,70,60,22,19,Win,140,2,2,2,1,TBB,41,264,213,1,3.675077359993238,31.028871791597922,17.35197457579558,13.676897215802342
0.46153846200000004,0.545454545,32.38333333,11/14/2013,24,20,away,3,TEN,229,218,51,69,30,27,Win,137,122,1,2,1,IND,57,366,340,0,-1.5692960471357835,48.437768613773095,23.434236283318654,25.00353233045444
0.545454545,0.46153846200000004,27.61666667,11/14/2013,20,24,home,-3,IND,218,229,34,54,27,30,Loss,122,137,2,1,0,TEN,57,340,366,1,1.5692960471357835,48.437768613773095,25.00353233045444,23.434236283318654
0.470588235,0.307692308,33.7,11/17/2013,23,22,away,-8,PHI,236,276,39,77,16,24,Loss,191,126,4,3,0,WAS,40,427,402,2,-7.632074300674648,49.44002703826616,20.903976368795757,28.536050669470402
0.307692308,0.470588235,26.3,11/17/2013,22,23,home,8,WAS,276,236,68,62,24,16,Win,126,191,3,4,2,PHI,40,402,427,0,7.632074300674648,49.44002703826616,28.536050669470402,20.903976368795757
0.444444444,0.384615385,35.68333333,11/17/2013,23,18,away,-3,CHI,143,215,46,75,0,3,Loss,174,104,3,2,0,BAL,3,317,319,2,-6.426547238793642,35.942610278644395,14.758031519925375,21.18457875871902
0.384615385,0.444444444,30.63333333,11/17/2013,18,23,home,3,BAL,215,143,111,59,3,0,Win,104,174,2,3,2,CHI,3,319,317,0,6.426547238793642,35.942610278644395,21.18457875871902,14.758031519925376
0.375,0.375,27.73333333,11/17/2013,21,24,away,-10,PIT,344,358,45,73,27,37,Loss,107,40,2,1,0,DET,64,451,398,3,-6.456106017329146,50.695589751016676,22.119741866843764,28.575847884172912
0.375,0.375,32.26666667,11/17/2013,24,21,home,10,DET,358,344,23,73,37,27,Win,40,107,1,2,3,PIT,64,398,451,0,6.456106017329146,50.695589751016676,28.575847884172912,22.119741866843764
0.14285714300000002,0.272727273,26.76666667,11/17/2013,24,24,away,-13,TBB,268,224,45,66,28,41,Loss,152,186,3,2,0,ATL,69,420,410,3,-3.1198503105688395,46.95587093526907,21.918010312350113,25.037860622918956
0.272727273,0.14285714300000002,33.23333333,11/17/2013,24,24,home,13,ATL,224,268,121,65,41,28,Win,186,152,2,3,3,TBB,69,410,420,0,3.1198503105688395,46.95587093526907,25.037860622918956,21.918010312350113
0.181818182,0.42105263200000004,26.3,11/17/2013,12,14,away,-23,BUF,133,245,24,56,14,37,Loss,134,68,4,1,0,NYJ,51,267,313,4,-3.8272751479786002,35.996974472048876,16.08484966203514,19.912124810013736
0.42105263200000004,0.181818182,33.7,11/17/2013,14,12,home,23,NYJ,245,133,64,67,37,14,Win,68,134,1,4,4,BUF,51,313,267,0,3.8272751479786002,35.996974472048876,19.912124810013736,16.08484966203514
0.3125,0.14285714300000002,35.88333333,11/17/2013,19,14,away,13,JAX,402,242,42,69,27,14,Win,14,32,3,2,2,ARI,41,416,274,0,-3.5345904858281774,37.89602896999382,17.180719242082823,20.715309727911
0.14285714300000002,0.3125,24.11666667,11/17/2013,14,19,home,-13,ARI,242,402,40,60,14,27,Loss,32,14,2,3,0,JAX,41,274,416,2,3.5345904858281774,37.89602896999382,20.715309727911,17.180719242082823
0.27777777800000003,0.125,31.51666667,11/17/2013,12,14,away,5,HOU,176,304,77,65,28,23,Win,165,90,2,2,2,OAK,51,341,394,0,-18.37930939212326,38.98291943179096,10.30180501983385,28.68111441195711
0.125,0.27777777800000003,28.48333333,11/17/2013,14,12,home,-5,OAK,304,176,50,72,23,28,Loss,90,165,2,2,0,HOU,51,394,341,2,18.37930939212326,38.98291943179096,28.68111441195711,10.30180501983385
0.222222222,0.071428571,32.4,11/17/2013,15,10,away,-21,CIN,228,118,40,79,20,41,Loss,102,106,4,0,2,CLE,61,330,224,4,-8.771701205156141,27.202056304804916,9.215177549824386,17.98687875498053
0.071428571,0.222222222,27.6,11/17/2013,10,15,home,21,CLE,118,228,64,59,41,20,Win,106,102,0,4,4,CIN,61,224,330,2,8.771701205156141,27.202056304804916,17.98687875498053,9.215177549824388
0.363636364,0.2,31.4,11/17/2013,22,21,away,-4,MIA,281,239,76,63,16,20,Loss,154,104,3,4,1,LAC,36,435,343,1,6.509526119110436,45.135664450286185,25.82259528469831,19.313069165587876
0.2,0.363636364,28.6,11/17/2013,21,22,home,4,LAC,239,281,15,58,20,16,Win,104,154,4,3,1,MIA,36,343,435,1,-6.509526119110436,45.135664450286185,19.313069165587876,25.82259528469831
0.4,0.428571429,25.35,11/17/2013,12,23,away,-3,NOS,115,295,45,56,20,23,Loss,81,92,3,1,3,SFO,43,196,387,1,0.7380620565711364,39.21991369899548,19.978987877783307,19.24092582121217
0.428571429,0.4,34.65,11/17/2013,23,12,home,3,SFO,295,115,48,67,23,20,Win,92,81,1,3,1,NOS,43,387,196,3,-0.7380620565711364,39.21991369899548,19.24092582121217,19.978987877783307
0.35714285700000004,0.363636364,34.15,11/17/2013,19,16,away,-21,SEA,204,230,20,70,20,41,Loss,132,93,2,1,0,MIN,61,336,323,4,2.3601130647275284,41.7939977374319,22.077055401079715,19.716942336352187
0.363636364,0.35714285700000004,25.85,11/17/2013,16,19,home,21,MIN,230,204,96,50,41,20,Win,93,132,1,2,4,SEA,61,323,336,0,-2.3601130647275284,41.7939977374319,19.716942336352187,22.077055401079715
0.25,0.28571428600000004,24.76666667,11/17/2013,16,19,away,-14,NYG,339,256,38,54,13,27,Loss,55,78,0,4,1,GBP,40,394,334,3,7.656333953037656,48.4060646682692,28.031199310653427,20.374865357615775
0.28571428600000004,0.25,35.23333333,11/17/2013,19,16,home,14,GBP,256,339,30,63,27,13,Win,78,55,4,0,3,NYG,40,334,394,1,-7.656333953037656,48.4060646682692,20.374865357615775,28.031199310653427
0.307692308,0.375,30.11666667,11/17/2013,24,24,away,-10,DEN,200,323,53,73,17,27,Loss,144,104,3,0,1,KCC,44,344,427,1,-9.813289905207187,46.187623986264846,18.18716704052883,28.000456945736016
0.375,0.307692308,29.88333333,11/17/2013,24,24,home,10,KCC,323,200,82,76,27,17,Win,104,144,0,3,1,DEN,44,427,344,1,9.813289905207187,46.187623986264846,28.000456945736016,18.18716704052883
0.5,0.727272727,30.76666667,11/18/2013,28,20,away,-4,CAR,283,197,50,67,20,24,Loss,107,103,2,3,0,NEP,44,390,300,2,6.9092031583392615,53.01830213010299,29.963752644221124,23.054549485881864
0.727272727,0.5,29.23333333,11/18/2013,20,28,home,4,NEP,197,283,47,54,24,20,Win,103,107,3,2,2,CAR,44,300,390,0,-6.9092031583392615,53.01830213010299,23.054549485881864,29.963752644221124
0.538461538,0.5,26.23333333,11/21/2013,19,22,away,4,ATL,271,264,66,59,17,13,Win,103,91,1,5,1,NOS,30,374,355,0,0.970474437542376,44.92677564954749,22.948625043544933,21.978150606002554
0.5,0.538461538,33.76666667,11/21/2013,22,19,home,-4,NOS,264,271,25,66,13,17,Loss,91,103,5,1,0,ATL,30,355,374,1,-0.970474437542376,44.92677564954749,21.978150606002554,22.948625043544933
0.375,0.1875,40.55,11/24/2013,28,30,away,0,GBP,215,298,53,79,3,3,Tie,232,196,6,2,0,MIN,6,447,494,1,-13.357378782526897,43.88953779128159,15.266079504377345,28.623458286904246
0.1875,0.375,34.45,11/24/2013,30,28,home,0,MIN,298,215,50,89,3,3,Tie,196,232,2,6,1,GBP,6,494,447,0,13.357378782526897,43.88953779128159,28.623458286904246,15.266079504377347
0.28571428600000004,0.533333333,26.63333333,11/24/2013,10,25,away,3,DET,207,286,67,49,24,21,Win,22,104,4,2,5,TBB,45,229,390,0,-2.534526775471612,43.858806244659185,20.662139734593786,23.1966665100654
0.533333333,0.28571428600000004,33.36666667,11/24/2013,25,10,home,-3,TBB,286,207,39,72,21,24,Loss,104,22,2,4,0,DET,45,390,229,5,2.534526775471612,43.858806244659185,23.1966665100654,20.662139734593786
0.352941176,0.25,30.2,11/24/2013,20,13,away,4,MIA,159,280,56,69,20,16,Win,136,52,3,3,1,CAR,36,295,332,1,-9.6642363538292,37.114295136027785,13.72502939109929,23.389265744928494
0.25,0.352941176,29.8,11/24/2013,13,20,home,-4,CAR,280,159,55,62,16,20,Loss,52,136,3,3,1,MIA,36,332,295,1,9.6642363538292,37.114295136027785,23.389265744928494,13.725029391099293
0.28571428600000004,0.352941176,33.65,11/24/2013,19,19,away,16,CLE,217,312,8,68,27,11,Win,85,55,0,5,4,PIT,38,302,367,0,-4.303998298060199,37.16370822011669,16.429854961028244,20.733853259088445
0.352941176,0.28571428600000004,26.35,11/24/2013,19,19,home,-16,PIT,312,217,10,73,11,27,Loss,55,85,5,0,0,CLE,38,367,302,4,4.303998298060199,37.16370822011669,20.733853259088445,16.429854961028244
0.6,0.4,36.15,11/24/2013,30,20,away,-21,LAR,344,148,84,74,21,42,Loss,80,258,1,2,0,CHI,63,424,406,3,-3.803919600244779,56.407726585182466,26.301903492468846,30.10582309271362
0.4,0.6,23.85,11/24/2013,20,30,home,21,CHI,148,344,39,53,42,21,Win,258,80,2,1,3,LAR,63,406,424,0,3.803919600244779,56.407726585182466,30.10582309271362,26.301903492468846
0.46666666700000003,0.333333333,30.95,11/24/2013,24,26,away,3,KCC,387,281,97,67,41,38,Win,104,114,1,3,2,LAC,79,491,395,0,1.450307369702819,54.978855956512135,28.214581663107477,26.764274293404657
0.333333333,0.46666666700000003,29.05,11/24/2013,26,24,home,-3,LAC,281,387,62,59,38,41,Loss,114,104,3,1,0,KCC,79,395,491,2,-1.450307369702819,54.978855956512135,26.764274293404657,28.214581663107477
0.083333333,0.23076923100000002,25.91666667,11/24/2013,12,15,away,-16,BAL,118,245,56,55,3,19,Loss,102,67,3,4,1,NYJ,22,220,312,3,7.099757666551744,30.448335239285765,18.774046452918753,11.674288786367011
0.23076923100000002,0.083333333,34.08333333,11/24/2013,15,12,home,16,NYJ,245,118,41,62,19,3,Win,67,102,4,3,3,BAL,22,312,220,1,-7.099757666551744,30.448335239285765,11.674288786367011,18.774046452918753
0.41176470600000004,0.26666666699999997,33.68333333,11/24/2013,16,11,away,7,HOU,215,141,63,65,13,6,Win,118,77,4,2,1,JAX,19,333,218,0,-10.329639487706661,32.71510347917866,11.192731995735997,21.52237148344266
0.26666666699999997,0.41176470600000004,26.31666667,11/24/2013,11,16,home,-7,JAX,141,215,22,57,6,13,Loss,77,118,2,4,0,HOU,19,218,333,1,10.329639487706661,32.71510347917866,21.52237148344266,11.192731995735999
0.5555555560000001,0.3,35.8,11/24/2013,22,19,away,4,OAK,312,260,100,73,23,19,Win,114,93,2,0,2,TEN,42,426,353,0,-9.812293133654526,53.32015523775119,21.75393105204833,31.566224185702858
0.3,0.5555555560000001,24.2,11/24/2013,19,22,home,-4,TEN,260,312,50,55,19,23,Loss,93,114,0,2,0,OAK,42,353,426,2,9.812293133654526,53.32015523775119,31.566224185702858,21.75393105204833
0.384615385,0.5,23.18333333,11/24/2013,15,27,away,-29,ARI,159,290,89,55,11,40,Loss,80,120,1,3,0,IND,51,239,410,1,-3.72026074482212,42.634135796042656,19.456937525610268,23.17719827043239
0.5,0.384615385,36.81666667,11/24/2013,27,15,home,29,IND,290,159,84,71,40,11,Win,120,80,3,1,1,ARI,51,410,239,0,3.72026074482212,42.634135796042656,23.17719827043239,19.456937525610268
0.363636364,0.25,29.35,11/24/2013,24,22,away,3,NYG,204,154,85,62,24,21,Win,107,202,4,2,1,DAL,45,311,356,1,-1.9480764919208458,43.768055058731576,20.909989283405366,22.85806577532621
0.25,0.363636364,30.65,11/24/2013,22,24,home,-3,DAL,154,204,81,62,21,24,Loss,202,107,2,4,1,NYG,45,356,311,1,1.9480764919208458,43.768055058731576,22.85806577532621,20.909989283405366
0.5,0.428571429,38.96666667,11/24/2013,28,27,away,-3,NEP,132,324,85,86,0,3,Loss,280,116,2,3,3,DEN,3,412,440,4,-9.1228794255676,48.61141620244535,19.744268388438876,28.867147814006472
0.428571429,0.5,34.1,11/24/2013,27,28,home,3,DEN,324,132,36,84,3,0,Win,116,280,3,2,4,NEP,3,440,412,3,9.1228794255676,48.61141620244535,28.867147814006472,19.744268388438876
0.28571428600000004,0.26666666699999997,31.43333333,11/25/2013,15,10,away,21,WAS,228,76,25,59,27,6,Win,76,114,2,6,1,SFO,33,304,190,1,-3.528493098154125,25.650438141964308,11.060972521905091,14.589465620059217
0.26666666699999997,0.28571428600000004,28.56666667,11/25/2013,10,15,home,-21,SFO,76,228,30,58,6,27,Loss,114,76,6,2,1,WAS,33,190,304,1,3.528493098154125,25.650438141964308,14.589465620059217,11.060972521905091
0.2,0.75,19.56666667,11/28/2013,7,30,away,-30,DET,102,320,25,42,10,40,Loss,24,241,7,1,4,GBP,50,126,561,3,5.398149816244196,51.79954851294194,28.59884916459307,23.20069934834887
0.75,0.2,40.43333333,11/28/2013,30,7,home,30,GBP,320,102,50,79,40,10,Win,241,24,1,7,3,DET,50,561,126,4,-5.398149816244196,51.79954851294194,23.20069934834887,28.59884916459307
0.538461538,0.538461538,27.68333333,11/28/2013,16,23,away,-7,DAL,255,208,71,55,24,31,Loss,50,144,0,2,1,OAK,55,305,352,2,-4.046614958565176,49.25615990612049,22.604772473777658,26.65138743234283
0.538461538,0.538461538,32.31666667,11/28/2013,23,16,home,7,OAK,208,255,40,64,31,24,Win,144,50,2,0,2,DAL,55,352,305,1,4.046614958565176,49.25615990612049,26.65138743234283,22.604772473777658
0.538461538,0.588235294,30.06666667,11/28/2013,22,16,away,-2,BAL,257,237,51,62,20,22,Loss,72,74,0,2,0,PIT,42,329,311,0,-0.1810509221802663,40.61779247322567,20.2183707755227,20.39942169770297
0.588235294,0.538461538,29.93333333,11/28/2013,16,22,home,2,PIT,237,257,55,62,22,20,Win,74,72,2,0,0,BAL,42,311,329,0,0.1810509221802663,40.61779247322567,20.39942169770297,20.2183707755227
0.4,0.214285714,33.91666667,12/1/2013,24,18,away,-8,IND,185,160,74,74,14,22,Loss,162,104,1,5,1,TEN,36,347,264,4,-7.111518700720781,42.41039888795126,17.64944009361524,24.76095879433602
0.214285714,0.4,26.08333333,12/1/2013,18,24,home,8,TEN,160,185,50,62,22,14,Win,104,162,5,1,4,IND,36,264,347,1,7.111518700720781,42.41039888795126,24.76095879433602,17.64944009361524
0.4375,0.166666667,38.86666667,12/1/2013,25,10,away,20,NYJ,328,78,28,80,23,3,Win,125,99,1,4,3,MIA,26,453,177,1,-3.716550255982014,37.58442069811359,16.933935221065788,20.650485477047802
0.166666667,0.4375,21.13333333,12/1/2013,10,25,home,-20,MIA,78,328,25,54,3,23,Loss,99,125,4,1,1,NYJ,26,177,453,3,3.716550255982014,37.58442069811359,20.650485477047802,16.933935221065788
0.1,0.384615385,25.58333333,12/1/2013,10,20,away,-21,CAR,140,263,30,46,6,27,Loss,66,163,5,0,2,TBB,33,206,426,2,1.7913573476789466,40.01397573922646,20.902666543452703,19.111309195773757
0.384615385,0.1,34.41666667,12/1/2013,20,10,home,21,TBB,263,140,25,63,27,6,Win,163,66,0,5,2,CAR,33,426,206,2,-1.7913573476789466,40.01397573922646,19.111309195773757,20.902666543452703
0.333333333,0.3125,30.65,12/1/2013,24,23,away,-3,PHI,260,202,55,68,21,24,Loss,90,105,5,5,0,ARI,45,350,307,3,-0.8110936995805744,42.68316513594999,20.93603571818471,21.747129417765283
0.3125,0.333333333,29.35,12/1/2013,23,24,home,3,ARI,202,260,48,73,24,21,Win,105,90,5,5,3,PHI,45,307,350,0,0.8110936995805744,42.68316513594999,21.747129417765283,20.93603571818471
0.4375,0.46153846200000004,30.6,12/1/2013,22,24,away,4,CLE,202,342,35,72,32,28,Win,112,97,2,3,3,JAX,60,314,439,1,-11.236142116248395,47.823933039591765,18.293895461671685,29.53003757792008
0.46153846200000004,0.4375,29.4,12/1/2013,24,22,home,-4,JAX,342,202,50,73,28,32,Loss,97,112,3,2,1,CLE,60,439,314,3,11.236142116248395,47.823933039591765,29.53003757792008,18.293895461671685
0.181818182,0.235294118,34.13333333,12/1/2013,20,28,away,-3,MIN,345,250,51,65,0,3,Loss,135,246,4,5,1,CHI,3,480,496,1,-9.334587713205991,43.020298176465836,16.842855231629922,26.177442944835914
0.235294118,0.181818182,39.15,12/1/2013,28,20,home,3,CHI,250,345,60,86,3,0,Win,246,135,5,4,1,MIN,3,496,480,1,9.334587713205991,43.020298176465836,26.177442944835914,16.842855231629922
0.41666666700000005,0.454545455,33.76666667,12/1/2013,28,19,away,3,HOU,365,264,0,69,34,31,Win,88,121,1,1,1,NEP,65,453,385,1,9.547878774907135,52.72135149639078,31.134615135648957,21.586736360741824
0.454545455,0.41666666700000005,26.23333333,12/1/2013,19,28,home,-3,NEP,264,365,25,59,31,34,Loss,121,88,1,1,1,HOU,65,385,453,1,-9.547878774907135,52.72135149639078,21.586736360741824,31.134615135648957
0.5555555560000001,0.35714285700000004,38.15,12/1/2013,26,19,away,3,BUF,272,210,75,83,3,0,Win,151,195,6,0,2,ATL,3,423,405,1,-11.423098360606476,47.24562466690527,17.9112631531494,29.334361513755873
0.35714285700000004,0.5555555560000001,24.85,12/1/2013,19,26,home,-3,ATL,210,272,49,63,0,3,Loss,195,151,0,6,1,BUF,3,405,423,2,11.423098360606476,47.24562466690527,29.334361513755873,17.9112631531494
0.307692308,0.333333333,26.93333333,12/1/2013,19,20,away,-10,SFO,198,255,105,67,13,23,Loss,114,83,3,4,1,LAR,36,312,338,1,-8.184658578965209,40.29270530420361,16.054023362619198,24.23868194158441
0.333333333,0.307692308,33.06666667,12/1/2013,20,19,home,10,LAR,255,198,85,62,23,13,Win,83,114,4,3,1,SFO,36,338,312,1,8.184658578965209,40.29270530420361,24.23868194158441,16.054023362619198
0.571428571,0.384615385,28.06666667,12/1/2013,25,27,away,7,KCC,403,293,75,66,35,28,Win,132,159,0,0,1,DEN,63,535,452,2,-0.9789625699689659,63.59381094786477,31.3074241889479,32.28638675891687
0.384615385,0.571428571,31.93333333,12/1/2013,27,25,home,-7,DEN,293,403,102,67,28,35,Loss,159,132,0,0,2,KCC,63,452,535,1,0.9789625699689659,63.59381094786477,32.28638675891686,31.307424188947902
0.5,0.46153846200000004,29.66666667,12/1/2013,19,19,away,7,LAC,190,243,30,61,17,10,Win,164,91,0,2,3,CIN,27,354,334,2,1.1175147494571407,46.39394317168135,23.755728960569247,22.638214211112103
0.46153846200000004,0.5,30.33333333,12/1/2013,19,19,home,-7,CIN,243,190,45,63,10,17,Loss,91,164,2,0,2,LAC,27,334,354,3,-1.1175147494571407,46.39394317168135,22.638214211112103,23.755728960569247
0.333333333,0.3125,28.41666667,12/1/2013,16,18,away,7,WAS,206,184,1,54,24,17,Win,80,139,3,5,1,NYG,41,286,323,1,-3.8303447732249705,36.70790122385036,16.438778225312692,20.269122998537664
0.3125,0.333333333,31.58333333,12/1/2013,18,16,home,-7,NYG,184,206,55,68,17,24,Loss,139,80,5,3,1,WAS,41,323,286,1,3.8303447732249705,36.70790122385036,20.269122998537664,16.438778225312692
0.4,0.5,26.36666667,12/2/2013,12,23,away,-27,SEA,144,302,52,56,7,34,Loss,44,127,1,1,0,NOS,41,188,429,1,-1.988495728321336,37.77379452405139,17.89264939786503,19.88114512618636
0.5,0.4,33.63333333,12/2/2013,23,12,home,27,NOS,302,144,66,69,34,7,Win,127,44,1,1,1,SEA,41,429,188,0,1.988495728321336,37.77379452405139,19.88114512618636,17.89264939786503
0.470588235,0.28571428600000004,35.36666667,12/5/2013,23,18,away,-7,JAX,323,132,177,80,20,27,Loss,83,149,3,1,0,HOU,47,406,281,2,-19.43739542989929,45.3138874328798,12.938246001490256,32.375641431389546
0.28571428600000004,0.470588235,24.63333333,12/5/2013,18,23,home,7,HOU,132,323,57,57,27,20,Win,149,83,1,3,2,JAX,47,281,406,0,19.43739542989929,45.3138874328798,32.375641431389546,12.938246001490256
0.428571429,0.470588235,28.91666667,12/8/2013,18,16,away,6,PIT,186,328,36,60,34,28,Win,181,84,2,3,1,MIA,62,367,412,1,-1.0979135685734986,44.32367357575377,21.61288000359014,22.710793572163634
0.470588235,0.428571429,31.08333333,12/8/2013,16,18,home,-6,MIA,328,186,63,63,28,34,Loss,84,181,3,2,1,PIT,62,412,367,1,1.0979135685734986,44.32367357575377,22.710793572163634,21.61288000359014
0.090909091,0.26666666699999997,28.16666667,12/8/2013,14,13,away,-21,TBB,147,81,114,62,6,27,Loss,67,165,7,1,2,BUF,33,214,246,5,-9.020828075432735,31.24998734246129,11.114579633514275,20.135407708947014
0.26666666699999997,0.090909091,31.83333333,12/8/2013,13,14,home,21,BUF,81,147,76,62,27,6,Win,165,67,1,7,5,TBB,33,246,214,2,9.020828075432735,31.24998734246129,20.135407708947014,11.114579633514277
0.333333333,0.538461538,30.56666667,12/8/2013,19,18,away,-10,NYJ,233,209,31,65,27,37,Loss,150,143,3,1,1,OAK,64,383,352,1,-2.8887358834009857,49.09191005603221,23.101587086315615,25.990322969716598
0.538461538,0.333333333,29.43333333,12/8/2013,18,19,home,10,OAK,209,233,36,58,37,27,Win,143,150,1,3,1,NYJ,64,352,383,1,2.8887358834009857,49.09191005603221,25.990322969716598,23.101587086315615
0.181818182,0.2,34.16666667,12/8/2013,20,13,away,35,WAS,154,192,30,61,45,10,Win,192,65,0,6,2,KCC,55,346,257,1,-3.691429145192771,31.083529407384816,13.696050131096023,17.387479276288794
0.2,0.181818182,25.83333333,12/8/2013,13,20,home,-35,KCC,192,154,27,65,10,45,Loss,65,192,6,0,1,WAS,55,257,346,2,3.691429145192771,31.083529407384816,17.387479276288794,13.696050131096023
0.46666666700000003,0.4,31.66666667,12/8/2013,24,30,away,-1,NEP,386,397,75,70,26,27,Loss,108,87,1,4,2,CLE,53,494,484,0,2.0424548238169526,56.36167615022839,29.202065487022672,27.15961066320572
0.4,0.46666666700000003,28.33333333,12/8/2013,30,24,home,1,CLE,397,386,41,77,27,26,Win,87,108,4,1,0,NEP,53,484,494,2,-2.0424548238169526,56.36167615022839,27.15961066320572,29.202065487022672
0.294117647,0.375,27.8,12/8/2013,15,23,away,-3,BAL,265,228,90,63,26,29,Loss,114,97,0,2,3,MIN,55,379,325,1,-7.628837843306923,41.314867831441475,16.843014994067275,24.4718528373742
0.375,0.294117647,32.2,12/8/2013,23,15,home,3,MIN,228,265,45,79,29,26,Win,97,114,2,0,1,BAL,55,325,379,3,7.628837843306923,41.314867831441475,24.4718528373742,16.843014994067275
0.2,0.5,22.25,12/8/2013,21,28,away,-14,CIN,326,275,47,58,28,42,Loss,63,155,0,0,0,IND,70,389,430,0,4.687209221462803,50.63828480953645,27.662747015499626,22.975537794036825
0.5,0.2,37.75,12/8/2013,28,21,home,14,IND,275,326,60,70,42,28,Win,155,63,0,0,0,CIN,70,430,389,0,-4.687209221462803,50.63828480953645,22.975537794036825,27.662747015499626
0.333333333,0.25,28.55,12/8/2013,11,23,away,-14,PHI,151,179,48,58,20,34,Loss,80,299,0,0,1,DET,54,231,478,3,0.9940400611572997,43.76138940711074,22.37771473413402,21.38367467297672
0.25,0.333333333,31.45,12/8/2013,23,11,home,14,DET,179,151,5,68,34,20,Win,299,80,0,0,3,PHI,54,478,231,1,-0.9940400611572997,43.76138940711074,21.38367467297672,22.37771473413402
0.46153846200000004,0.46666666700000003,26.46666667,12/8/2013,18,20,away,-1,GBP,202,222,15,59,21,22,Loss,83,112,1,5,2,ATL,43,285,334,2,1.4230306462274167,41.890056812811764,21.65654372951959,20.233513083292173
0.46666666700000003,0.46153846200000004,33.53333333,12/8/2013,20,18,home,1,ATL,222,202,10,70,22,21,Win,112,83,5,1,2,GBP,43,334,285,2,-1.4230306462274167,41.890056812811764,20.233513083292173,21.65654372951959
0.222222222,0.384615385,20.66666667,12/8/2013,15,39,away,-23,DEN,158,397,66,48,28,51,Loss,96,154,2,0,0,TEN,79,254,551,2,-2.697269057329372,52.998241662356165,25.150486302513396,27.84775535984277
0.384615385,0.222222222,39.33333333,12/8/2013,39,15,home,23,TEN,397,158,60,91,51,28,Win,154,96,0,2,2,DEN,79,551,254,0,2.697269057329372,52.998241662356165,27.84775535984277,25.150486302513396
0.41666666700000005,0.384615385,27.53333333,12/8/2013,13,19,away,-2,SFO,178,155,85,50,17,19,Loss,86,163,2,2,1,SEA,36,264,318,1,0.8343556565037402,35.79148696173491,18.312921309119325,17.478565652615586
0.384615385,0.41666666700000005,32.46666667,12/8/2013,19,13,home,2,SEA,155,178,70,64,19,17,Win,163,86,2,2,1,SFO,36,318,264,1,-0.8343556565037402,35.79148696173491,17.478565652615586,18.312921309119325
0.272727273,0.571428571,24.88333333,12/8/2013,14,25,away,-20,ARI,157,262,90,50,10,30,Loss,100,107,4,1,1,LAR,40,257,369,2,2.1115692354767397,43.00997037586758,22.56076980567216,20.449200570195423
0.571428571,0.272727273,35.11666667,12/8/2013,25,14,home,20,LAR,262,157,31,65,30,10,Win,107,100,1,4,2,ARI,40,369,257,1,-2.1115692354767397,43.00997037586758,20.449200570195423,22.56076980567216
0.375,0.666666667,23.06666667,12/8/2013,18,25,away,-23,LAC,241,244,72,54,14,37,Loss,92,144,2,2,1,NYG,51,333,388,3,-1.9228870631858257,51.74523529984464,24.911174118329406,26.83406118151523
0.666666667,0.375,36.93333333,12/8/2013,25,18,home,23,NYG,244,241,30,70,37,14,Win,144,92,2,2,3,LAC,51,388,333,1,1.9228870631858257,51.74523529984464,26.83406118151523,24.911174118329406
0.4,0.583333333,32.45,12/8/2013,16,24,away,-18,NOS,111,304,35,62,13,31,Loss,128,69,5,2,0,CAR,44,239,373,0,-2.796468190689776,42.12886785186169,19.66619983058596,22.462668021275732
0.583333333,0.4,27.55,12/8/2013,24,16,home,18,CAR,304,111,45,61,31,13,Win,69,128,2,5,0,NOS,44,373,239,0,2.796468190689776,42.12886785186169,22.462668021275732,19.66619983058596
0.5,0.727272727,23.26666667,12/9/2013,24,33,away,-17,CHI,130,341,50,55,28,45,Loss,198,149,2,1,0,DAL,73,328,490,0,1.6204999472065733,55.188559648439835,28.404529797823205,26.78402985061663
0.727272727,0.5,36.73333333,12/9/2013,33,24,home,17,DAL,341,130,15,69,45,28,Win,149,198,1,2,0,CHI,73,490,328,0,-1.6204999472065733,55.188559648439835,26.78402985061663,28.404529797823205
0.5,0.222222222,38.81666667,12/12/2013,24,19,away,7,DEN,160,277,35,66,27,20,Win,177,18,2,1,1,LAC,47,337,295,0,6.178867243453449,42.58644760457848,24.382657424015964,18.203790180562518
0.222222222,0.5,21.18333333,12/12/2013,19,24,home,-7,LAC,277,160,43,53,20,27,Loss,18,177,1,2,0,DEN,47,295,337,1,-6.178867243453449,42.58644760457848,18.203790180562518,24.382657424015964
0.384615385,0.533333333,32.58333333,12/15/2013,25,22,away,7,JAX,168,195,67,72,27,20,Win,198,159,4,5,4,BUF,47,366,354,2,-11.991549822686327,51.69752110190368,19.852985639608676,31.844535462295006
0.533333333,0.384615385,27.41666667,12/15/2013,22,25,home,-7,BUF,195,168,80,72,20,27,Loss,159,198,5,4,2,JAX,47,354,366,4,11.991549822686327,51.69752110190368,31.844535462295006,19.852985639608676
0.5,0.35714285700000004,26.13333333,12/15/2013,22,19,away,-1,ATL,373,189,66,67,26,27,Loss,103,54,1,3,2,WAS,53,476,243,7,-4.551240073842962,51.10993022807627,23.279345077116655,27.830585150959617
0.35714285700000004,0.5,33.86666667,12/15/2013,19,22,home,1,WAS,189,373,73,62,27,26,Win,54,103,3,1,7,ATL,53,243,476,2,4.551240073842962,51.10993022807627,27.830585150959617,23.279345077116655
0.333333333,0.333333333,26.81666667,12/15/2013,12,19,away,-22,IND,132,179,114,63,3,25,Loss,107,152,4,1,1,HOU,28,239,331,2,-13.42811756128856,35.625082098104365,11.098482268407903,24.526599829696462
0.333333333,0.333333333,33.18333333,12/15/2013,19,12,home,22,HOU,179,132,36,69,25,3,Win,152,107,1,4,2,IND,28,331,239,1,13.42811756128856,35.625082098104365,24.526599829696462,11.098482268407903
0.642857143,0.333333333,34.8,12/15/2013,23,20,away,7,CLE,261,273,40,64,38,31,Win,179,93,2,0,2,CHI,69,440,366,3,0.25385356854366536,53.546261473316385,26.900057520930027,26.646203952386358
0.333333333,0.642857143,25.2,12/15/2013,20,23,home,-7,CHI,273,261,90,56,31,38,Loss,93,179,0,2,3,CLE,69,366,440,2,-0.25385356854366536,53.546261473316385,26.646203952386358,26.900057520930027
0.23076923100000002,0.1,33.96666667,12/15/2013,21,12,away,23,NYG,193,156,50,67,23,0,Win,134,25,4,4,5,SEA,23,327,181,1,6.290802500994026,34.50816050266124,20.399481501827633,14.108679000833607
0.1,0.23076923100000002,26.03333333,12/15/2013,12,21,home,-23,SEA,156,193,38,53,0,23,Loss,25,134,4,4,1,NYG,23,181,327,5,-6.290802500994026,34.50816050266124,14.108679000833607,20.399481501827633
0.5,0.615384615,23.56666667,12/15/2013,25,29,away,-18,MIN,396,370,94,65,30,48,Loss,79,85,4,3,1,PHI,78,475,455,1,0.43831005574363147,63.453870586049106,31.946090320896367,31.50778026515274
0.615384615,0.5,36.43333333,12/15/2013,29,25,home,18,PHI,370,396,25,73,48,30,Win,85,79,3,4,1,MIN,78,455,475,1,-0.43831005574363147,63.453870586049106,31.50778026515274,31.946090320896367
0.4,0.1,39.83333333,12/15/2013,22,13,away,19,TBB,189,144,62,71,33,14,Win,187,39,2,4,2,SFO,47,376,183,0,-2.325677898335197,32.21197219107529,14.943147146370045,17.268825044705245
0.1,0.4,20.16666667,12/15/2013,13,22,home,-19,SFO,144,189,32,50,14,33,Loss,39,187,4,2,0,TBB,47,183,376,2,2.325677898335197,32.21197219107529,17.268825044705245,14.943147146370046
0.529411765,0.363636364,31.35,12/15/2013,29,20,away,-4,MIA,357,289,2,78,20,24,Loss,96,89,1,4,1,NEP,44,453,378,1,6.699441491393525,49.35786525748408,28.028653374438804,21.329211883045275
0.363636364,0.529411765,28.65,12/15/2013,20,29,home,4,NEP,289,357,21,64,24,20,Win,89,96,4,1,1,MIA,44,378,453,1,-6.699441491393525,49.35786525748408,21.329211883045275,28.028653374438804
0.533333333,0.454545455,26.98333333,12/15/2013,19,21,away,-10,CAR,140,261,20,60,20,30,Loss,157,131,4,2,0,NYJ,50,297,392,1,-4.243872627817731,47.0454458372871,21.400786604734684,25.644659232552414
0.454545455,0.533333333,33.01666667,12/15/2013,21,19,home,10,NYJ,261,140,59,62,30,20,Win,131,157,2,4,1,CAR,50,392,297,0,4.243872627817731,47.0454458372871,25.644659232552414,21.400786604734684
0.444444444,0.5,25.88333333,12/15/2013,19,26,away,25,OAK,306,331,91,51,56,31,Win,78,130,2,0,7,KCC,87,384,461,1,-1.415174771219931,64.12405864741451,31.354441938097295,32.76961670931722
0.5,0.444444444,34.11666667,12/15/2013,26,19,home,-25,KCC,331,306,90,74,31,56,Loss,130,78,0,2,1,OAK,87,461,384,7,1.415174771219931,64.12405864741451,32.76961670931722,31.354441938097292
0.333333333,0.5,32.2,12/15/2013,30,17,away,-11,LAR,371,158,77,80,16,27,Loss,61,144,4,0,0,NOS,43,432,302,3,-2.9877735599608144,49.30865224424264,23.16043934214091,26.148212902101726
0.5,0.333333333,27.8,12/15/2013,17,30,home,11,NOS,158,371,30,54,27,16,Win,144,61,0,4,3,LAR,43,302,432,0,2.9877735599608144,49.30865224424264,26.148212902101726,23.16043934214091
0.5,0.5,30.96666667,12/15/2013,24,32,away,3,TEN,215,394,69,68,3,0,Win,145,66,2,3,3,ARI,3,360,460,0,-8.082041838503228,51.635968903792744,21.776963532644757,29.859005371147987
0.5,0.5,33.73333333,12/15/2013,32,24,home,-3,ARI,394,215,16,80,0,3,Loss,66,145,3,2,0,TEN,3,460,360,3,8.082041838503228,51.635968903792744,29.859005371147987,21.776963532644757
0.538461538,0.222222222,28.3,12/15/2013,26,27,away,1,DAL,283,332,59,68,37,36,Win,150,134,2,3,2,GBP,73,433,466,1,-0.9285017386376806,57.16078606395998,28.116142162661152,29.04464390129883
0.222222222,0.538461538,31.7,12/15/2013,27,26,home,-1,GBP,332,283,79,69,36,37,Loss,134,150,3,2,1,DAL,73,466,433,2,0.9285017386376806,57.16078606395998,29.04464390129883,28.116142162661152
0.28571428600000004,0.2,28.4,12/15/2013,19,19,away,-10,PIT,222,184,50,67,20,30,Loss,57,106,1,1,1,CIN,50,279,290,1,1.6204321784921252,33.8249939674926,17.722713072992363,16.10228089450024
0.2,0.28571428600000004,31.6,12/15/2013,19,19,home,10,CIN,184,222,25,62,30,20,Win,106,57,1,1,1,PIT,50,290,279,1,-1.6204321784921252,33.8249939674926,16.10228089450024,17.722713072992363
0.28571428600000004,0.307692308,27.58333333,12/16/2013,18,19,away,2,DET,215,230,60,60,18,16,Win,90,119,1,1,3,BAL,34,305,349,0,2.842070144681717,41.08033273899804,21.961201441839876,19.119131297158162
0.307692308,0.28571428600000004,32.41666667,12/16/2013,19,18,home,-2,BAL,230,215,89,63,16,18,Loss,119,90,1,1,0,DET,34,349,305,3,-2.842070144681717,41.08033273899804,19.119131297158162,21.961201441839876
0.28571428600000004,0.428571429,25.9,12/22/2013,14,18,away,-10,LAR,111,148,26,56,13,23,Loss,59,129,7,1,2,TBB,36,170,277,2,-4.781215027229784,32.97054093015663,14.094662951463423,18.875877978693207
0.428571429,0.28571428600000004,34.1,12/22/2013,18,14,home,10,TBB,148,111,85,60,23,13,Win,129,59,1,7,2,LAR,36,277,170,2,4.781215027229784,32.97054093015663,18.875877978693207,14.094662951463423
0.23076923100000002,0.272727273,35.65,12/22/2013,22,15,away,4,JAX,164,226,4,73,20,16,Win,182,63,3,2,1,TEN,36,346,289,1,-5.245850147858932,37.41781113964263,16.08598049589185,21.33183064375078
0.272727273,0.23076923100000002,24.35,12/22/2013,15,22,home,-4,TEN,226,164,15,57,16,20,Loss,63,182,2,3,1,JAX,36,289,346,1,5.245850147858932,37.41781113964263,21.33183064375078,16.08598049589185
0.4,0.4375,26.21666667,12/22/2013,16,17,away,1,WAS,214,197,42,52,24,23,Win,95,100,2,0,1,DAL,47,309,297,2,-4.53709713786945,37.80793179853006,16.635417330330306,21.172514468199758
0.4375,0.4,33.78333333,12/22/2013,17,16,home,-1,DAL,197,214,44,64,23,24,Loss,100,95,0,2,2,WAS,47,297,309,1,4.53709713786945,37.80793179853006,21.172514468199758,16.635417330330306
0.181818182,0.375,28.88333333,12/22/2013,25,14,away,24,HOU,397,153,67,70,37,13,Win,114,87,1,3,2,DEN,50,511,240,0,-7.313659047177323,44.87554466819435,18.780942810508513,26.094601857685838
0.375,0.181818182,31.11666667,12/22/2013,14,25,home,-24,DEN,153,397,57,66,13,37,Loss,87,114,3,1,0,HOU,50,240,511,2,7.313659047177323,44.87554466819435,26.094601857685838,18.780942810508513
0.27777777800000003,0.0,38.8,12/22/2013,20,10,away,-4,CAR,239,141,40,81,13,17,Loss,126,81,6,4,1,NOS,30,365,222,2,-0.5287729678699904,32.97139552401511,16.22131127807256,16.75008424594255
0.0,0.27777777800000003,21.2,12/22/2013,10,20,home,4,NOS,141,239,26,44,17,13,Win,81,126,4,6,2,CAR,30,222,365,1,0.5287729678699904,32.97139552401511,16.75008424594255,16.22131127807256
0.0,0.571428571,20.46666667,12/22/2013,10,24,away,-28,CIN,94,345,40,48,14,42,Loss,115,81,4,2,1,MIN,56,209,426,4,2.778028990085474,40.09133417135563,21.434681580720554,18.65665259063508
0.571428571,0.0,39.53333333,12/22/2013,24,10,home,28,MIN,345,94,55,77,42,14,Win,81,115,2,4,4,CIN,56,426,209,1,-2.778028990085474,40.09133417135563,18.65665259063508,21.434681580720554
0.14285714300000002,0.36842105299999994,23.48333333,12/22/2013,6,18,away,-19,BUF,89,187,37,52,0,19,Loss,14,203,7,1,1,MIA,19,103,390,2,-6.22893922007508,26.188572823061847,9.979816801493385,16.208756021568462
0.36842105299999994,0.14285714300000002,36.51666667,12/22/2013,18,6,home,19,MIA,187,89,31,77,19,0,Win,203,14,1,7,2,BUF,19,390,103,1,6.22893922007508,26.188572823061847,16.208756021568462,9.979816801493383
0.38888888899999996,0.125,38.33333333,12/22/2013,19,18,away,16,KCC,232,132,31,72,23,7,Win,135,155,1,5,4,IND,30,367,287,0,1.9056424443314093,39.487719980425666,20.696681212378536,18.79103876804713
0.125,0.38888888899999996,21.66666667,12/22/2013,18,19,home,-16,IND,132,232,65,53,7,23,Loss,155,135,5,1,0,KCC,30,287,367,4,-1.9056424443314093,39.487719980425666,18.79103876804713,20.696681212378536
0.41666666700000005,0.666666667,27.28333333,12/22/2013,19,25,away,-11,NYJ,168,214,24,64,13,24,Loss,115,208,3,0,0,CLE,37,283,422,2,-9.97080092218975,43.804594502715624,16.91689679026294,26.887697712452685
0.666666667,0.41666666700000005,32.71666667,12/22/2013,25,19,home,11,CLE,214,168,35,76,24,13,Win,208,115,0,3,2,NYJ,37,422,283,0,9.97080092218975,43.804594502715624,26.887697712452685,16.91689679026294
0.352941176,0.470588235,29.71666667,12/22/2013,15,24,away,3,DET,238,207,30,65,3,0,Win,41,148,2,2,3,NYG,3,279,355,2,-12.782081012677335,40.12707578032781,13.672497383825238,26.45457839650257
0.470588235,0.352941176,37.75,12/22/2013,24,15,home,-3,NYG,207,238,60,80,0,3,Loss,148,41,2,2,2,DET,3,355,279,3,12.782081012677335,40.12707578032781,26.45457839650257,13.672497383825236
0.31578947399999996,0.153846154,37.4,12/22/2013,16,10,away,7,SEA,168,89,46,70,17,10,Win,139,103,2,4,2,ARI,27,307,192,4,-0.9883080304919777,29.03642146463307,14.024056717070545,15.012364747562524
0.153846154,0.31578947399999996,22.6,12/22/2013,10,16,home,-7,ARI,89,168,102,51,10,17,Loss,103,139,4,2,4,SEA,27,192,307,2,0.9883080304919777,29.03642146463307,15.012364747562524,14.024056717070545
0.2,0.428571429,26.66666667,12/22/2013,21,26,away,7,GBP,192,219,58,59,38,31,Win,151,151,1,3,2,PIT,69,343,370,2,0.9750574095606921,48.49683521163263,24.73594631059666,23.76088890103597
0.428571429,0.2,33.33333333,12/22/2013,26,21,home,-7,PIT,219,192,90,72,31,38,Loss,151,151,3,1,2,GBP,69,370,343,2,-0.9750574095606921,48.49683521163263,23.76088890103597,24.73594631059666
0.307692308,0.545454545,25.3,12/22/2013,14,24,away,-13,LAC,206,196,73,54,13,26,Loss,59,148,1,1,3,OAK,39,265,344,2,-2.4362113041324776,47.19276569457111,22.378277195219315,24.814488499351793
0.545454545,0.307692308,34.7,12/22/2013,24,14,home,13,OAK,196,206,24,67,26,13,Win,148,59,1,1,2,LAC,39,344,265,3,2.4362113041324776,47.19276569457111,24.814488499351793,22.378277195219315
0.307692308,0.35714285700000004,31.96666667,12/22/2013,21,19,away,34,BAL,158,237,58,62,41,7,Win,142,121,2,4,4,NEP,48,300,358,0,5.396374874734843,39.30810571363021,22.35224029418253,16.955865419447683
0.35714285700000004,0.307692308,28.03333333,12/22/2013,19,21,home,-34,NEP,237,158,83,74,7,41,Loss,121,142,4,2,0,BAL,48,358,300,4,-5.396374874734843,39.30810571363021,16.955865419447683,22.35224029418253
0.35714285700000004,0.5555555560000001,29.66666667,12/22/2013,18,28,away,-43,PHI,196,225,10,63,11,54,Loss,61,289,5,2,1,CHI,65,257,514,2,5.617404941345509,51.52488143901053,28.57114319017802,22.953738248832508
0.5555555560000001,0.35714285700000004,30.33333333,12/22/2013,28,18,home,43,CHI,225,196,15,63,54,11,Win,289,61,2,5,2,PHI,65,514,257,1,-5.617404941345509,51.52488143901053,22.953738248832508,28.57114319017802
0.533333333,0.444444444,30.46666667,12/23/2013,25,20,away,-10,SFO,341,180,37,69,24,34,Loss,61,199,1,3,0,ATL,58,402,379,2,3.191825545908449,48.436886938587975,25.814356242248213,22.622530696339762
0.444444444,0.533333333,29.53333333,12/23/2013,20,25,home,10,ATL,180,341,45,54,34,24,Win,199,61,3,1,2,SFO,58,379,402,0,-3.191825545908449,48.436886938587975,22.622530696339762,25.814356242248213
0.4,0.46153846200000004,32.4,12/29/2013,22,18,away,13,MIA,220,204,36,70,20,7,Win,154,92,0,0,3,NYJ,27,374,296,0,-4.8570235624118325,43.41558816720918,19.279282302398673,24.136305864810506
0.46153846200000004,0.4,27.6,12/29/2013,18,22,home,-13,NYJ,204,220,38,62,7,20,Loss,92,154,0,0,0,MIA,27,296,374,3,4.8570235624118325,43.41558816720918,24.136305864810506,19.279282302398673
0.25,0.214285714,28.35,12/29/2013,12,14,away,-14,NYG,160,156,30,75,6,20,Loss,91,122,3,1,3,WAS,26,251,278,4,-18.051139086881452,30.6904861116196,6.3196735123690715,24.370812599250527
0.214285714,0.25,31.65,12/29/2013,14,12,home,14,WAS,156,160,20,68,20,6,Win,122,91,1,3,4,NYG,26,278,251,3,18.051139086881452,30.6904861116196,24.370812599250527,6.319673512369073
0.214285714,0.5,26.33333333,12/29/2013,19,23,away,-20,IND,308,299,50,70,10,30,Loss,42,80,3,1,0,JAX,40,350,379,2,-7.212973029361596,45.637282885875095,19.21215492825675,26.425127957618344
0.5,0.214285714,33.66666667,12/29/2013,23,19,home,20,JAX,299,308,10,70,30,10,Win,80,42,1,3,2,IND,40,379,350,0,7.212973029361596,45.637282885875095,26.425127957618344,19.21215492825675
0.4,0.41666666700000005,29.71666667,12/29/2013,15,17,away,-13,PIT,221,172,30,64,7,20,Loss,79,120,3,1,2,CLE,27,300,292,2,-1.463810416895651,35.402983500211604,16.969586541657975,18.43339695855363
0.41666666700000005,0.4,30.28333333,12/29/2013,17,15,home,13,CLE,172,221,15,61,20,7,Win,120,79,1,3,2,PIT,27,292,300,2,1.463810416895651,35.402983500211604,18.43339695855363,16.969586541657975
0.4,0.28571428600000004,27.75,12/29/2013,19,17,away,-6,TEN,223,160,55,57,10,16,Loss,65,151,1,1,1,HOU,26,288,311,4,-4.615252248442301,43.834915137596965,19.60983144457733,24.225083693019634
0.28571428600000004,0.4,32.25,12/29/2013,17,19,home,6,HOU,160,223,76,61,16,10,Win,151,65,1,1,4,TEN,26,311,288,1,4.615252248442301,43.834915137596965,24.225083693019634,19.60983144457733
0.26666666699999997,0.538461538,26.05,12/29/2013,17,21,away,-17,CIN,175,281,56,66,17,34,Loss,47,111,2,0,4,BAL,51,222,392,3,1.7065169543002359,43.59876290717291,22.652639930736573,20.94612297643634
0.538461538,0.26666666699999997,33.95,12/29/2013,21,17,home,17,BAL,281,175,76,66,34,17,Win,111,47,0,2,3,CIN,51,392,222,4,-1.7065169543002359,43.59876290717291,20.94612297643634,22.652639930736573
0.46666666700000003,0.4375,25.56666667,12/29/2013,16,20,away,1,ATL,149,231,38,57,21,20,Win,134,76,1,9,1,CAR,41,283,307,2,-6.092802713148257,39.653284966928545,16.780241126890143,22.873043840038402
0.4375,0.46666666700000003,34.43333333,12/29/2013,20,16,home,-1,CAR,231,149,56,69,20,21,Loss,76,134,9,1,2,ATL,41,307,283,1,6.092802713148257,39.653284966928545,22.873043840038402,16.780241126890143
0.333333333,0.272727273,32.61666667,12/29/2013,14,19,away,-1,MIN,182,171,52,60,13,14,Loss,63,174,5,3,2,DET,27,245,345,0,4.069390052588755,36.77405971053685,20.421724881562803,16.352334828974044
0.272727273,0.333333333,27.38333333,12/29/2013,19,14,home,1,DET,171,182,25,56,14,13,Win,174,63,3,5,0,MIN,27,345,245,2,-4.069390052588755,36.77405971053685,16.352334828974044,20.421724881562803
0.23076923100000002,0.538461538,25.8,12/29/2013,18,21,away,-25,NOS,215,370,78,62,17,42,Loss,75,98,2,1,0,TBB,59,290,468,1,-5.528823072474417,45.59361332690257,20.032395127214077,25.561218199688494
0.538461538,0.23076923100000002,34.2,12/29/2013,21,18,home,25,TBB,370,215,94,62,42,17,Win,98,75,1,2,1,NOS,59,468,290,0,5.528823072474417,45.59361332690257,25.561218199688494,20.032395127214077
0.5,0.5,35.15,12/29/2013,25,17,away,5,CHI,313,224,15,76,33,28,Win,160,121,3,1,2,GBP,61,473,345,2,1.9550803924662177,54.846673289061194,28.400876840763704,26.44579644829749
0.5,0.5,24.85,12/29/2013,17,25,home,-5,GBP,224,313,40,49,28,33,Loss,121,160,1,3,2,CHI,61,345,473,2,-1.9550803924662177,54.846673289061194,26.44579644829749,28.400876840763704
0.307692308,0.307692308,27.21666667,12/29/2013,19,24,away,-14,NEP,224,115,54,68,20,34,Loss,169,267,4,1,1,BUF,54,393,382,0,3.0731044097605693,42.308368525835,22.690736467797784,19.617632058037216
0.307692308,0.307692308,32.78333333,12/29/2013,24,19,home,14,BUF,115,224,31,68,34,20,Win,267,169,1,4,0,NEP,54,382,393,1,-3.0731044097605693,42.308368525835,19.617632058037216,22.690736467797784
0.181818182,0.307692308,26.33333333,12/29/2013,11,20,away,-18,SEA,145,158,87,50,9,27,Loss,13,111,2,4,0,LAR,36,158,269,2,1.2609442673326612,28.54260931923126,14.901776793281961,13.6408325259493
0.307692308,0.181818182,33.66666667,12/29/2013,20,11,home,18,LAR,158,145,65,63,27,9,Win,111,13,4,2,2,SEA,36,269,158,0,-1.2609442673326612,28.54260931923126,13.6408325259493,14.901776793281961
0.428571429,0.529411765,34.6,12/29/2013,22,19,away,-3,LAC,189,219,5,69,0,3,Loss,143,186,2,3,1,KCC,3,332,405,0,-9.086031315827308,33.910357349594804,12.41216301688375,21.498194332711055
0.529411765,0.428571429,37.13333333,12/29/2013,19,22,home,3,KCC,219,189,22,72,3,0,Win,186,143,3,2,0,LAC,3,405,332,1,9.086031315827308,33.910357349594804,21.498194332711055,12.41216301688375
0.23076923100000002,0.26666666699999997,27.66666667,12/29/2013,19,19,away,3,ARI,292,399,20,59,23,20,Win,83,83,2,1,2,SFO,43,375,482,0,1.5691665548656895,43.851054323939465,22.710110439402577,21.140943884536888
0.26666666699999997,0.23076923100000002,32.33333333,12/29/2013,19,19,home,-3,SFO,399,292,30,72,20,23,Loss,83,83,1,2,0,ARI,43,482,375,2,-1.5691665548656895,43.851054323939465,21.140943884536888,22.710110439402577
0.6,0.384615385,35.48333333,12/29/2013,28,17,away,20,OAK,334,191,56,73,34,14,Win,124,64,3,2,1,DEN,48,458,255,0,-2.9214606233334184,51.18647419448225,24.132506785574417,27.053967408907834
0.384615385,0.6,24.51666667,12/29/2013,17,28,home,-20,DEN,191,334,10,60,14,34,Loss,64,124,2,3,0,OAK,48,255,458,1,2.9214606233334184,51.18647419448225,27.053967408907834,24.132506785574417
0.384615385,0.272727273,29.71666667,12/29/2013,21,21,away,2,DAL,229,358,50,66,24,22,Win,137,56,5,0,3,PHI,46,366,414,1,3.829697496452627,48.83893624608324,26.334316871267934,22.50461937481531
0.272727273,0.384615385,30.28333333,12/29/2013,21,21,home,-2,PHI,358,229,5,64,22,24,Loss,56,137,0,5,1,DAL,46,414,366,3,-3.829697496452627,48.83893624608324,22.50461937481531,26.334316871267934
0.5625,0.5,37.55,1/4/2014,30,28,away,-1,IND,363,436,15,80,44,45,Loss,150,100,2,1,4,KCC,89,513,536,1,1.7255710936398163,67.9139603964378,34.81976574503881,33.09419465139899
0.5,0.5625,22.45,1/4/2014,28,30,home,1,KCC,436,363,19,65,45,44,Win,100,150,1,2,1,IND,89,536,513,4,-1.7255710936398163,67.9139603964378,33.09419465139899,34.81976574503881
0.538461538,0.25,34.88333333,1/4/2014,26,17,away,2,PHI,249,176,85,68,26,24,Win,185,80,2,2,0,NOS,50,434,256,2,3.789538892064122,46.84598388998719,25.317761391025655,21.528222498961533
0.25,0.538461538,25.11666667,1/4/2014,17,26,home,-2,NOS,176,249,38,57,24,26,Loss,80,185,2,2,2,PHI,50,256,434,0,-3.789538892064122,46.84598388998719,21.528222498961533,25.317761391025655
0.333333333,0.25,29.46666667,1/5/2014,16,27,away,17,CIN,122,326,28,57,27,10,Win,196,113,1,3,4,LAC,37,318,439,0,-0.25066681818496583,44.27297580602724,22.011154493921136,22.261821312106104
0.25,0.333333333,30.53333333,1/5/2014,27,16,home,-17,LAC,326,122,38,79,10,27,Loss,113,196,3,1,0,CIN,37,439,318,4,0.25066681818496583,44.27297580602724,22.261821312106104,22.011154493921136
0.5,0.272727273,29.1,1/5/2014,22,18,away,3,GBP,214,157,10,63,23,20,Win,167,124,3,4,0,SFO,43,381,281,1,4.648791958722639,40.77424426938371,22.711518114053174,18.062726155330534
0.272727273,0.5,30.9,1/5/2014,18,22,home,-3,SFO,157,214,20,61,20,23,Loss,124,167,4,3,1,GBP,43,281,381,0,-4.648791958722639,40.77424426938371,18.062726155330534,22.711518114053174
0.25,0.35714285700000004,30.5,1/11/2014,25,13,away,-8,SEA,296,103,69,70,15,23,Loss,108,174,1,3,0,NOS,38,404,277,1,1.2305773516854424,37.87563447474541,19.553105913215425,18.322528561529985
0.35714285700000004,0.25,29.5,1/11/2014,13,25,home,8,NOS,103,296,52,56,23,15,Win,174,108,3,1,1,SEA,38,277,404,0,-1.2305773516854424,37.87563447474541,18.322528561529985,19.553105913215425
0.4,0.611111111,25.0,1/11/2014,16,23,away,-21,NEP,317,185,42,65,22,43,Loss,69,234,3,2,0,IND,65,386,419,4,0.7683034287681387,49.19916037055549,24.983731899661812,24.215428470893677
0.611111111,0.4,35.0,1/11/2014,23,16,home,21,IND,185,317,35,73,43,22,Win,234,69,2,3,4,NEP,65,419,386,0,-0.7683034287681387,49.19916037055549,24.215428470893677,24.983731899661812
0.428571429,0.6,29.91666667,1/12/2014,21,18,away,13,CAR,189,232,40,65,23,10,Win,126,93,1,5,2,SFO,33,315,325,0,-3.589900485677237,45.63763829914101,21.023868906731884,24.613769392409125
0.6,0.428571429,30.08333333,1/12/2014,18,21,home,-13,SFO,232,189,73,54,10,23,Loss,93,126,5,1,0,CAR,33,325,315,2,3.589900485677237,45.63763829914101,24.613769392409125,21.023868906731884
0.333333333,0.692307692,24.55,1/12/2014,13,26,away,-7,DEN,194,230,63,49,17,24,Loss,65,133,4,0,2,LAC,41,259,363,0,0.9172602739846276,44.56090600154324,22.739083137763934,21.821822863779303
0.692307692,0.333333333,35.45,1/12/2014,26,13,home,7,LAC,230,194,50,70,24,17,Win,133,65,0,4,0,DEN,41,363,259,2,-0.9172602739846276,44.56090600154324,21.821822863779303,22.739083137763934
0.5,0.538461538,24.26666667,1/19/2014,19,27,away,-10,DEN,256,400,15,56,16,26,Loss,64,107,2,0,0,NEP,42,320,507,0,11.737091499214209,52.41379917391484,32.07544533656453,20.338353837350315
0.538461538,0.5,35.73333333,1/19/2014,27,19,home,10,NEP,400,256,34,71,26,16,Win,107,64,0,2,0,DEN,42,507,320,0,-11.737091499214209,52.41379917391484,20.33835383735031,32.07544533656453
0.272727273,0.35714285700000004,28.53333333,1/19/2014,16,14,away,-6,SEA,147,193,65,54,17,23,Loss,161,115,2,4,1,SFO,40,308,308,3,5.258233062316798,36.70154779081995,20.979890426568375,15.721657364251577
0.35714285700000004,0.272727273,31.46666667,1/19/2014,14,16,home,6,SFO,193,147,66,58,23,17,Win,115,161,4,2,3,SEA,40,308,308,1,-5.258233062316798,36.70154779081995,15.721657364251577,20.979890426568375
0.583333333,0.46153846200000004,31.88333333,2/2/2014,17,18,away,35,DEN,206,279,104,55,43,8,Win,135,27,0,1,4,SEA,51,341,306,0,1.22052590806301,46.70615978863361,23.96334284834831,22.7428169402853
0.46153846200000004,0.583333333,28.11666667,2/2/2014,18,17,home,-35,SEA,279,206,44,64,8,43,Loss,27,135,1,0,0,DEN,51,306,341,4,-1.22052590806301,46.70615978863361,22.7428169402853,23.96334284834831
0.5,0.363636364,26.66666667,9/4/2014,19,25,away,-20,SEA,175,191,65,57,16,36,Loss,80,207,3,1,1,GBP,52,255,398,1,3.4228900735505636,45.221400525886345,24.322145299718454,20.89925522616789
0.363636364,0.5,33.33333333,9/4/2014,25,19,home,20,GBP,191,175,69,66,36,16,Win,207,80,1,3,1,SEA,52,398,255,1,-3.4228900735505636,45.221400525886345,20.89925522616789,24.322145299718454
0.615384615,0.545454545,30.41666667,9/7/2014,30,28,away,-3,ATL,333,445,27,70,0,3,Loss,139,123,0,1,1,NOS,3,472,568,2,-0.0014869443395895132,65.68899344456469,32.84375325011255,32.84524019445214
0.545454545,0.615384615,31.3,9/7/2014,28,30,home,3,NOS,445,333,96,69,3,0,Win,123,139,1,0,2,ATL,3,568,472,1,0.0014869443395895132,65.68899344456469,32.84524019445214,32.84375325011255
0.25,0.28571428600000004,28.28333333,9/7/2014,18,15,away,28,LAR,170,246,60,57,34,6,Win,185,72,0,5,2,MIN,40,355,318,0,-5.5244273729692175,39.88710157346645,17.18133710024862,22.705764473217833
0.28571428600000004,0.25,31.71666667,9/7/2014,15,18,home,-28,MIN,246,170,121,63,6,34,Loss,72,185,5,0,0,LAR,40,318,355,2,5.5244273729692175,39.88710157346645,22.705764473217833,17.18133710024862
0.181818182,0.333333333,27.55,9/7/2014,23,24,away,-3,PIT,198,376,55,64,27,30,Loss,191,127,3,3,1,CLE,57,389,503,0,0.14805696146287706,47.55191239121896,23.84998467634092,23.701927714878043
0.333333333,0.181818182,32.45,9/7/2014,24,23,home,3,CLE,376,198,96,67,30,27,Win,127,191,3,3,0,PIT,57,503,389,1,-0.14805696146287706,47.55191239121896,23.701927714878043,23.84998467634092
0.14285714300000002,0.42105263200000004,29.23333333,9/7/2014,18,24,away,-17,PHI,242,275,55,70,17,34,Loss,64,145,3,5,3,JAX,51,306,420,1,-12.354416458753075,45.031218642524784,16.338401091885856,28.692817550638928
0.42105263200000004,0.14285714300000002,30.76666667,9/7/2014,24,18,home,17,JAX,275,242,50,82,34,17,Win,145,64,5,3,1,PHI,51,420,306,3,12.354416458753075,45.031218642524784,28.692817550638928,16.338401091885856
0.25,0.41666666700000005,25.16666667,9/7/2014,11,20,away,-5,NYJ,133,190,20,49,14,19,Loss,25,212,2,2,2,OAK,33,158,402,0,-2.3567865604935907,39.846014503956255,18.744613971731333,21.101400532224922
0.41666666700000005,0.25,34.83333333,9/7/2014,20,11,home,5,OAK,190,133,105,65,19,14,Win,212,25,2,2,0,NYJ,33,402,158,2,2.3567865604935907,39.846014503956255,21.101400532224922,18.744613971731333
0.28571428600000004,0.470588235,30.5,9/7/2014,16,26,away,7,BAL,301,329,45,64,23,16,Win,79,94,0,3,2,CIN,39,380,423,0,-4.659931478117542,43.80830480175522,19.57418666181884,24.23411813993638
0.470588235,0.28571428600000004,29.5,9/7/2014,26,16,home,-7,CIN,329,301,29,85,16,23,Loss,94,79,3,0,0,BAL,39,423,380,2,4.659931478117542,43.80830480175522,24.23411813993638,19.57418666181884
0.333333333,0.41666666700000005,30.53333333,9/7/2014,15,29,away,3,CHI,167,341,108,56,3,0,Win,193,86,1,2,3,BUF,3,360,427,1,-1.2588781864626981,49.80375728604124,24.272439549789272,25.531317736251967
0.41666666700000005,0.333333333,34.7,9/7/2014,29,15,home,-3,BUF,341,167,43,69,0,3,Loss,86,193,2,1,1,CHI,3,427,360,3,1.2588781864626981,49.80375728604124,25.531317736251967,24.272439549789272
0.25,0.5,30.9,9/7/2014,20,16,away,-11,HOU,241,206,71,63,6,17,Loss,131,115,3,0,1,WAS,23,372,321,2,-6.67909248191321,43.80836036516358,18.564633941625186,25.243726423538394
0.5,0.25,29.1,9/7/2014,16,20,home,11,WAS,206,241,45,56,17,6,Win,115,131,0,3,2,HOU,23,321,372,1,6.67909248191321,43.80836036516358,25.243726423538394,18.564633941625186
0.4375,0.083333333,37.73333333,9/7/2014,24,15,away,16,KCC,243,178,110,75,26,10,Win,162,67,4,4,3,TEN,36,405,245,0,-5.957748125472275,38.74486030141255,16.39355608797014,22.35130421344241
0.083333333,0.4375,22.26666667,9/7/2014,15,24,home,-16,TEN,178,243,25,56,10,26,Loss,67,162,4,4,0,KCC,36,245,405,3,5.957748125472275,38.74486030141255,22.35130421344241,16.39355608797014
0.294117647,0.538461538,29.55,9/7/2014,20,25,away,-13,MIA,226,169,100,80,20,33,Loss,89,191,4,1,3,NEP,53,315,360,2,-5.578536444005431,42.61380034068965,18.51763194834211,24.09616839234754
0.538461538,0.294117647,30.45,9/7/2014,25,20,home,13,NEP,169,226,26,71,33,20,Win,191,89,1,4,2,MIA,53,360,315,3,5.578536444005431,42.61380034068965,24.09616839234754,18.51763194834211
0.4,0.5,35.2,9/7/2014,19,17,away,6,TBB,221,162,55,68,20,14,Win,113,102,1,3,3,CAR,34,334,264,0,-8.857379883372602,41.83056623304865,16.486593174838024,25.343973058210626
0.5,0.4,24.8,9/7/2014,17,19,home,-6,CAR,162,221,15,55,14,20,Loss,102,113,3,1,0,TBB,34,264,334,3,8.857379883372602,41.83056623304865,25.343973058210626,16.486593174838024
0.583333333,0.5555555560000001,28.6,9/7/2014,19,26,away,11,DAL,192,255,78,54,28,17,Win,127,127,1,3,4,SFO,45,319,382,0,1.2709423714837715,50.75065762810425,26.01079999979401,24.73985762831024
0.5555555560000001,0.583333333,31.4,9/7/2014,26,19,home,-11,SFO,255,192,72,63,17,28,Loss,127,127,3,1,0,DAL,45,382,319,4,-1.2709423714837715,50.75065762810425,24.73985762831024,26.01079999979401
0.307692308,0.5,27.6,9/7/2014,24,24,away,-7,DEN,354,259,45,70,24,31,Loss,54,102,3,1,0,IND,55,408,361,2,-1.8709401492062803,51.45613334144995,24.792596596121832,26.663536745328116
0.5,0.307692308,32.4,9/7/2014,24,24,home,7,IND,259,354,70,69,31,24,Win,102,54,1,3,2,DEN,55,361,408,0,1.8709401492062803,51.45613334144995,26.663536745328116,24.792596596121832
0.23076923100000002,0.666666667,23.93333333,9/8/2014,16,20,away,-21,DET,144,341,25,57,14,35,Loss,53,76,2,1,0,NYG,49,197,417,2,-2.3443506030354797,44.24874602686308,20.9521977119138,23.29654831494928
0.666666667,0.23076923100000002,36.06666667,9/8/2014,20,16,home,21,NYG,341,144,85,63,35,14,Win,76,53,1,2,2,DET,49,417,197,0,2.3443506030354797,44.24874602686308,23.29654831494928,20.9521977119138
0.4,0.46153846200000004,28.18333333,9/8/2014,15,22,away,-1,ARI,238,294,47,60,17,18,Loss,52,109,0,2,2,LAC,35,290,403,1,-1.3226517250699947,42.28756774665882,20.482458010794414,21.80510973586441
0.46153846200000004,0.4,31.81666667,9/8/2014,22,15,home,1,LAC,294,238,23,65,18,17,Win,109,52,2,0,1,ARI,35,403,290,2,1.3226517250699947,42.28756774665882,21.80510973586441,20.482458010794414
0.5,0.41666666700000005,24.86666667,9/11/2014,17,25,away,-20,BAL,202,166,75,57,6,26,Loss,99,157,2,0,0,PIT,32,301,323,3,5.045829104557388,42.44260648617982,23.744217795368606,18.698388690811214
0.41666666700000005,0.5,35.13333333,9/11/2014,25,17,home,20,PIT,166,202,35,65,26,6,Win,157,99,0,2,3,BAL,32,323,301,0,-5.045829104557388,42.44260648617982,18.698388690811214,23.744217795368606
0.3125,0.333333333,31.28333333,9/14/2014,23,13,away,-19,BUF,210,202,20,74,10,29,Loss,80,113,4,0,0,MIA,39,290,315,2,-4.055844415612331,35.972141029558145,15.958148306972909,20.013992722585236
0.333333333,0.3125,28.71666667,9/14/2014,13,23,home,19,MIA,202,210,40,59,29,10,Win,113,80,0,4,2,BUF,39,315,290,0,4.055844415612331,35.972141029558145,20.013992722585236,15.958148306972907
0.23076923100000002,0.428571429,20.98333333,9/14/2014,8,32,away,-31,WAS,123,258,44,48,10,41,Loss,25,191,10,3,0,JAX,51,148,449,1,-9.808861164969652,36.72026297242953,13.45570090372994,23.26456206869959
0.428571429,0.23076923100000002,39.01666667,9/14/2014,32,8,home,31,JAX,258,123,98,81,41,10,Win,191,25,3,10,1,WAS,51,449,148,0,9.808861164969652,36.72026297242953,23.26456206869959,13.455700903729939
0.5625,0.2,41.18333333,9/14/2014,26,13,away,16,TEN,148,232,25,76,26,10,Win,220,82,4,2,2,DAL,36,368,314,1,-2.8217661879068086,41.56757694014452,19.372905376118855,22.194671564025665
0.2,0.5625,18.81666667,9/14/2014,13,26,home,-16,DAL,232,148,30,49,10,26,Loss,82,220,2,4,1,TEN,36,314,368,2,2.8217661879068086,41.56757694014452,22.194671564025665,19.372905376118855
0.384615385,0.5,27.51666667,9/14/2014,21,24,away,11,NYG,142,260,71,61,25,14,Win,124,81,4,2,4,ARI,39,266,341,0,-3.1017309137159916,45.10584560741654,21.002057346850275,24.103788260566265
0.5,0.384615385,32.48333333,9/14/2014,24,21,home,-11,ARI,260,142,70,68,14,25,Loss,81,124,2,4,0,NYG,39,341,266,4,3.1017309137159916,45.10584560741654,24.103788260566265,21.002057346850275
0.35714285700000004,0.363636364,31.56666667,9/14/2014,16,17,away,23,MIN,142,163,163,59,30,7,Win,150,54,1,6,4,NEP,37,292,217,0,2.418973545608157,35.94270477670325,19.180839161155703,16.76186561554755
0.363636364,0.35714285700000004,28.43333333,9/14/2014,17,16,home,-23,NEP,163,142,58,61,7,30,Loss,54,150,6,1,0,MIN,37,217,292,4,-2.418973545608157,35.94270477670325,16.76186561554755,19.180839161155703
0.538461538,0.4375,31.83333333,9/14/2014,26,23,away,-2,CLE,223,202,39,69,24,26,Loss,174,122,2,1,0,NOS,50,397,324,2,-5.181577799520403,44.77446162318324,19.79644191183142,24.978019711351823
0.4375,0.538461538,28.16666667,9/14/2014,23,26,home,2,NOS,202,223,30,72,26,24,Win,122,174,1,2,2,CLE,50,324,397,0,5.181577799520403,44.77446162318324,24.978019711351823,19.79644191183142
0.25,0.428571429,27.01666667,9/14/2014,19,21,away,-14,CIN,212,302,56,65,10,24,Loss,97,170,2,0,0,ATL,34,309,472,3,-2.598157424591932,44.03392086133481,20.71788171837144,23.316039142963373
0.428571429,0.25,32.98333333,9/14/2014,21,19,home,14,ATL,302,212,55,69,24,10,Win,170,97,0,2,3,CIN,34,472,309,0,2.598157424591932,44.03392086133481,23.316039142963373,20.71788171837144
0.4,0.25,30.68333333,9/14/2014,21,20,away,-17,CAR,253,251,33,70,7,24,Loss,70,62,4,4,0,DET,31,323,313,3,-4.279167081851547,44.031895668181775,19.876364293165114,24.15553137501666
0.25,0.4,29.31666667,9/14/2014,20,21,home,17,DET,251,253,45,62,24,7,Win,62,70,4,4,3,CAR,31,313,323,0,4.279167081851547,44.031895668181775,24.15553137501666,19.876364293165114
0.454545455,0.5,32.08333333,9/14/2014,20,18,away,2,TBB,220,175,65,60,19,17,Win,119,157,2,1,1,LAR,36,339,332,1,-1.8893678795253557,45.160109416147975,21.63537076831131,23.524738647836664
0.5,0.454545455,27.91666667,9/14/2014,18,20,home,-2,LAR,175,220,30,52,17,19,Loss,157,119,1,2,1,TBB,36,332,339,1,1.8893678795253557,45.160109416147975,23.524738647836664,21.63537076831131
0.375,0.588235294,17.75,9/14/2014,14,26,away,-9,LAC,180,276,53,40,21,30,Loss,108,101,2,1,0,SEA,51,288,377,1,4.117276349559412,42.97103409473209,23.54415522214575,19.42687887258634
0.588235294,0.375,42.25,9/14/2014,26,14,home,9,SEA,276,180,53,75,30,21,Win,101,108,1,2,1,LAC,51,377,288,0,-4.117276349559412,42.97103409473209,19.42687887258634,23.54415522214575
0.6,0.222222222,38.6,9/14/2014,20,22,away,16,OAK,139,263,85,65,30,14,Win,188,101,0,0,4,HOU,44,327,364,0,-5.746923249630058,51.78639093061077,23.019733840490357,28.766657090120415
0.222222222,0.6,21.4,9/14/2014,22,20,home,-16,HOU,263,139,24,59,14,30,Loss,101,188,0,0,0,OAK,44,364,327,4,5.746923249630058,51.78639093061077,28.766657090120415,23.019733840490357
0.470588235,0.5,30.43333333,9/14/2014,19,25,away,-7,GBP,166,310,82,71,24,31,Loss,147,80,2,4,1,NYJ,55,313,390,1,-7.556261301180921,48.08433929204003,20.26403899542955,27.820300296610476
0.5,0.470588235,29.56666667,9/14/2014,25,19,home,7,NYJ,310,166,34,68,31,24,Win,80,147,4,2,1,GBP,55,390,313,1,7.556261301180921,48.08433929204003,27.820300296610476,20.26403899542955
0.6875,0.375,36.23333333,9/14/2014,28,19,away,-7,DEN,247,237,62,75,17,24,Loss,133,88,2,1,0,KCC,41,380,325,0,2.628780718158493,48.917240223724214,25.773010470941355,23.14422975278286
0.375,0.6875,23.76666667,9/14/2014,19,28,home,7,KCC,237,247,71,46,24,17,Win,88,133,1,2,0,DEN,41,325,380,0,-2.628780718158493,48.917240223724214,23.14422975278286,25.773010470941355
0.333333333,0.538461538,26.15,9/14/2014,19,19,away,8,SFO,170,232,58,52,28,20,Win,46,127,1,4,4,CHI,48,216,359,0,-2.026704984132543,42.35175430825237,20.162524662059912,22.189229646192455
0.538461538,0.333333333,33.85,9/14/2014,19,19,home,-8,CHI,232,170,118,65,20,28,Loss,127,46,4,1,0,SFO,48,359,216,4,2.026704984132543,42.35175430825237,22.189229646192455,20.162524662059912
0.41666666700000005,0.333333333,23.75,9/15/2014,24,25,away,3,IND,331,172,90,64,30,27,Win,127,169,0,0,2,PHI,57,458,341,1,-2.424211350727905,54.511023457758384,26.04340605351524,28.467617404243143
0.333333333,0.41666666700000005,36.25,9/15/2014,25,24,home,-3,PHI,172,331,70,72,27,30,Loss,169,127,0,0,1,IND,57,341,458,2,2.424211350727905,54.511023457758384,28.467617404243143,26.04340605351524
0.23076923100000002,0.727272727,27.35,9/18/2014,10,26,away,-42,ATL,153,344,110,57,14,56,Loss,64,144,3,1,4,TBB,70,217,488,5,-4.504719229347213,50.607335157515415,23.051307964084103,27.556027193431312
0.727272727,0.23076923100000002,32.65,9/18/2014,26,10,home,42,TBB,344,153,50,65,56,14,Win,144,64,1,3,5,ATL,70,488,217,4,4.504719229347213,50.607335157515415,27.556027193431312,23.051307964084103
0.384615385,0.428571429,31.56666667,9/21/2014,20,18,away,12,BUF,250,205,44,63,22,10,Win,83,87,2,3,0,LAC,32,333,292,0,-7.96579122776676,39.04029681411964,15.537252793176442,23.5030440209432
0.428571429,0.384615385,28.43333333,9/21/2014,18,20,home,-12,LAC,205,250,110,65,10,22,Loss,87,83,3,2,0,BUF,32,292,333,0,7.96579122776676,39.04029681411964,23.5030440209432,15.53725279317644
0.5,0.615384615,27.16666667,9/21/2014,19,26,away,3,LAR,217,327,15,52,34,31,Win,123,121,0,0,3,DAL,65,340,448,2,-4.514987323461508,56.00080115751514,25.742906917026815,30.257894240488326
0.615384615,0.5,32.83333333,9/21/2014,26,19,home,-3,DAL,327,217,119,72,31,34,Loss,121,123,0,0,2,LAR,65,448,340,3,4.514987323461508,56.00080115751514,30.257894240488326,25.742906917026815
0.533333333,0.363636364,34.8,9/21/2014,27,22,away,-3,PHI,427,325,131,76,34,37,Loss,84,54,0,0,1,WAS,71,511,379,1,-12.833287150978633,57.53532116981047,22.35101700941592,35.184304160394554
0.363636364,0.533333333,25.2,9/21/2014,22,27,home,3,WAS,325,427,70,66,37,34,Win,54,84,0,0,1,PHI,71,379,511,1,12.833287150978633,57.53532116981047,35.184304160394554,22.35101700941592
0.166666667,0.333333333,27.43333333,9/21/2014,20,26,away,-13,NYG,292,226,40,62,17,30,Loss,119,193,2,1,1,HOU,47,411,419,3,-2.294471906604265,52.10035076152945,24.90293942746259,27.197411334066857
0.333333333,0.166666667,32.56666667,9/21/2014,26,20,home,13,HOU,226,292,31,71,30,17,Win,193,119,1,2,3,NYG,47,419,411,1,2.294471906604265,52.10035076152945,27.197411334066857,24.90293942746259
0.4,0.692307692,26.45,9/21/2014,13,27,away,-11,NOS,188,288,44,54,9,20,Loss,59,108,2,1,0,MIN,29,247,396,0,0.40428545739175803,43.04715582184457,21.725720639618164,21.321435182226406
0.692307692,0.4,33.55,9/21/2014,27,13,home,11,MIN,288,188,30,68,20,9,Win,108,59,1,2,0,NOS,29,396,247,0,-0.40428545739175803,43.04715582184457,21.321435182226406,21.725720639618164
0.166666667,0.333333333,31.26666667,9/21/2014,22,25,away,-26,CIN,177,184,99,64,7,33,Loss,149,116,2,0,1,TEN,40,326,300,2,4.033093057491685,43.869683372924285,23.951388215207984,19.9182951577163
0.333333333,0.166666667,28.73333333,9/21/2014,25,22,home,26,TEN,184,177,50,57,33,7,Win,116,149,0,2,2,CIN,40,300,326,1,-4.033093057491685,43.869683372924285,19.9182951577163,23.951388215207984
0.333333333,0.454545455,30.91666667,9/21/2014,23,19,away,2,CLE,217,290,32,64,23,21,Win,160,85,0,0,0,BAL,44,377,375,1,5.807363887478805,44.047073743610184,24.927218815544496,19.11985492806569
0.454545455,0.333333333,29.08333333,9/21/2014,19,23,home,-2,BAL,290,217,94,55,21,23,Loss,85,160,0,0,1,CLE,44,375,377,0,-5.807363887478805,44.047073743610184,19.11985492806569,24.927218815544496
0.4,0.611111111,21.78333333,9/21/2014,14,21,away,-12,DET,147,238,30,51,7,19,Loss,76,115,2,2,3,GBP,26,223,353,1,-1.3650658132061912,43.76222072650454,21.198577456649172,22.563643269855366
0.611111111,0.4,38.21666667,9/21/2014,21,14,home,12,GBP,238,147,40,74,19,7,Win,115,76,2,2,1,DET,26,353,223,3,1.3650658132061912,43.76222072650454,22.563643269855366,21.198577456649172
0.571428571,0.4,37.05,9/21/2014,27,18,away,27,JAX,385,239,46,74,44,17,Win,144,105,2,4,3,IND,61,529,344,0,0.21815043751238505,56.96440758501228,28.591279011262333,28.37312857374995
0.4,0.571428571,22.95,9/21/2014,18,27,home,-27,IND,239,385,15,55,17,44,Loss,105,144,4,2,0,JAX,61,344,529,3,-0.21815043751238505,56.96440758501228,28.37312857374995,28.591279011262333
0.384615385,0.5,28.41666667,9/21/2014,14,21,away,-7,NEP,174,221,49,56,9,16,Loss,67,76,0,2,0,OAK,25,241,297,1,-1.4065507576923153,38.321765866421416,18.45760755436455,19.864158312056865
0.5,0.384615385,31.58333333,9/21/2014,21,14,home,7,OAK,221,174,59,71,16,9,Win,76,67,2,0,1,NEP,25,297,241,0,1.4065507576923153,38.321765866421416,19.864158312056865,18.45760755436455
0.5,0.615384615,32.33333333,9/21/2014,20,24,away,-9,ARI,236,254,107,61,14,23,Loss,82,84,1,0,1,SFO,37,318,338,0,-1.9343308190933297,44.92472096343458,21.495195072170624,23.429525891263957
0.615384615,0.5,27.66666667,9/21/2014,24,20,home,9,SFO,254,236,36,61,23,14,Win,84,82,0,1,0,ARI,37,338,318,1,1.9343308190933297,44.92472096343458,23.429525891263957,21.495195072170624
0.375,0.41176470600000004,27.7,9/21/2014,20,26,away,-6,SEA,296,255,27,70,0,6,Loss,36,129,1,3,1,DEN,6,332,384,2,-2.1407939551642716,42.34346561774227,20.101335831289,22.24212978645327
0.41176470600000004,0.375,38.06666667,9/21/2014,26,20,home,6,DEN,255,296,34,75,6,0,Win,129,36,3,1,2,SEA,6,384,332,1,2.1407939551642716,42.34346561774227,22.24212978645327,20.101335831289
0.5625,0.26666666699999997,33.7,9/21/2014,23,18,away,19,MIA,168,191,23,71,34,15,Win,174,141,5,4,0,KCC,49,342,332,2,-6.563016164980565,38.27447177741232,15.855727806215878,22.418743971196445
0.26666666699999997,0.5625,26.3,9/21/2014,18,23,home,-19,KCC,191,168,65,67,15,34,Loss,141,174,4,5,2,MIA,49,332,342,0,6.563016164980565,38.27447177741232,22.418743971196445,15.855727806215878
0.272727273,0.333333333,34.65,9/21/2014,24,20,away,18,CAR,190,307,91,65,37,19,Win,264,42,1,3,2,PIT,56,454,349,0,-1.121302065930788,51.50140525036756,25.19005159221839,26.311353658149173
0.333333333,0.272727273,25.35,9/21/2014,20,24,home,-18,PIT,307,190,105,54,19,37,Loss,42,264,3,1,0,CAR,56,349,454,2,1.121302065930788,51.50140525036756,26.311353658149173,25.19005159221839
0.46666666700000003,0.4,28.13333333,9/22/2014,17,21,away,8,NYJ,197,300,95,63,27,19,Win,60,114,4,3,3,CHI,46,257,414,1,-12.06012761863948,45.09095086895513,16.515411625157824,28.57553924379731
0.4,0.46666666700000003,31.86666667,9/22/2014,21,17,home,-8,CHI,300,197,78,72,19,27,Loss,114,60,3,4,1,NYJ,46,414,257,3,12.06012761863948,45.09095086895513,28.57553924379731,16.515411625157824
0.6875,0.125,37.28333333,9/25/2014,31,17,away,31,WAS,295,243,66,78,45,14,Win,154,86,1,2,6,NYG,59,449,329,1,-5.274899322945288,56.866468865122016,25.795784771088364,31.070684094033652
0.125,0.6875,22.71666667,9/25/2014,17,31,home,-31,NYG,243,295,88,52,14,45,Loss,86,154,2,1,1,WAS,59,329,449,6,5.274899322945288,56.866468865122016,31.070684094033652,25.795784771088364
0.5,0.636363636,23.63333333,9/28/2014,21,33,away,21,CHI,302,261,70,47,38,17,Win,56,235,1,1,2,GBP,55,358,496,0,3.1146155392627133,61.416764159780605,32.265689849521664,29.151074310258945
0.636363636,0.5,36.36666667,9/28/2014,33,21,home,-21,GBP,261,302,46,77,17,38,Loss,235,56,1,1,0,CHI,55,496,358,2,-3.1146155392627133,61.416764159780605,29.15107431025895,32.26568984952166
0.3125,0.35714285700000004,29.06666667,9/28/2014,17,19,away,-6,HOU,220,264,40,69,17,23,Loss,96,37,2,3,3,BUF,40,316,301,2,-8.258483049115029,43.13311956234042,17.437318256612695,25.695801305727723
0.35714285700000004,0.3125,30.93333333,9/28/2014,19,17,home,6,BUF,264,220,90,63,23,17,Win,37,96,3,2,2,HOU,40,301,316,3,8.258483049115029,43.13311956234042,25.695801305727723,17.437318256612695
0.111111111,0.5,17.65,9/28/2014,16,31,away,-24,IND,176,393,68,47,17,41,Loss,85,105,3,0,1,TEN,58,261,498,3,-1.3417075304758086,52.13530855732849,25.396800513426342,26.73850804390215
0.5,0.111111111,42.35,9/28/2014,31,16,home,24,TEN,393,176,88,82,41,17,Win,105,85,0,3,3,IND,58,498,261,1,1.3417075304758086,52.13530855732849,26.73850804390215,25.396800513426342
0.666666667,0.7692307690000001,29.6,9/28/2014,20,25,away,-28,BAL,248,327,59,62,10,38,Loss,67,127,2,0,0,CAR,48,315,454,1,-1.6184457274454083,55.54784252829595,26.96469840042527,28.583144127870682
0.7692307690000001,0.666666667,30.4,9/28/2014,25,20,home,28,CAR,327,248,40,61,38,10,Win,127,67,0,2,1,BAL,48,454,315,0,1.6184457274454083,55.54784252829595,28.583144127870682,26.96469840042527
0.4,0.46666666700000003,34.88333333,9/28/2014,17,17,away,7,NYJ,272,204,33,65,24,17,Win,88,132,4,2,2,DET,41,360,336,0,-3.440386606927839,43.197666325694016,19.87863985938309,23.319026466310927
0.46666666700000003,0.4,25.11666667,9/28/2014,17,17,home,-7,DET,204,272,32,62,17,24,Loss,132,88,2,4,0,NYJ,41,336,360,2,3.440386606927839,43.197666325694016,23.319026466310927,19.87863985938309
0.538461538,0.428571429,25.75,9/28/2014,21,27,away,3,PIT,287,305,50,63,27,24,Win,63,85,1,5,1,TBB,51,350,390,1,-10.02374508499318,49.014341784916134,19.495298349961477,29.519043434954657
0.428571429,0.538461538,34.25,9/28/2014,27,21,home,-3,TBB,305,287,125,73,24,27,Loss,85,63,5,1,1,PIT,51,390,350,1,10.02374508499318,49.014341784916134,29.519043434954657,19.495298349961477
0.454545455,0.428571429,30.9,9/28/2014,24,17,away,24,OAK,278,264,35,66,38,14,Win,157,53,0,2,4,MIA,52,435,317,3,-3.474510603511783,55.65320794895995,26.089348672724086,29.563859276235867
0.428571429,0.454545455,29.1,9/28/2014,17,24,home,-24,MIA,264,278,80,64,14,38,Loss,53,157,2,0,3,OAK,52,317,435,4,3.474510603511783,55.65320794895995,29.563859276235867,26.089348672724086
0.642857143,0.5625,30.56666667,9/28/2014,21,19,away,-19,LAC,235,365,32,65,14,33,Loss,85,42,3,2,0,JAX,47,320,407,3,-5.945175833352911,51.04543983390877,22.55013200027793,28.495307833630843
0.5625,0.642857143,29.43333333,9/28/2014,19,21,home,19,JAX,365,235,57,61,33,14,Win,42,85,2,3,3,LAC,47,407,320,0,5.945175833352911,51.04543983390877,28.495307833630843,22.55013200027793
0.384615385,0.42105263200000004,17.71666667,9/28/2014,11,20,away,-5,SFO,191,189,70,56,21,26,Loss,22,218,1,4,1,PHI,47,213,407,4,-7.984678201322279,40.74992929184925,16.382625545263487,24.367303746585762
0.42105263200000004,0.384615385,42.28333333,9/28/2014,20,11,home,5,PHI,189,191,80,76,26,21,Win,218,22,4,1,4,SFO,47,407,213,1,7.984678201322279,40.74992929184925,24.367303746585762,16.382625545263487
0.666666667,0.46153846200000004,27.13333333,9/28/2014,23,26,away,-13,MIN,288,317,50,64,28,41,Loss,123,241,1,0,0,ATL,69,411,558,2,-6.104094092567461,57.58979125189371,25.742848579663125,31.846942672230583
0.46153846200000004,0.666666667,32.86666667,9/28/2014,26,23,home,13,ATL,317,288,40,74,41,28,Win,241,123,0,1,2,MIN,69,558,411,0,6.104094092567461,57.58979125189371,31.846942672230583,25.742848579663125
0.4,0.571428571,25.25,9/28/2014,20,24,away,-21,DAL,334,255,20,59,17,38,Loss,104,190,2,1,0,NOS,55,438,445,3,3.592652041512846,53.97774604936478,28.785199045438816,25.192547003925966
0.571428571,0.4,34.75,9/28/2014,24,20,home,21,NOS,255,334,50,65,38,17,Win,190,104,1,2,3,DAL,55,445,438,0,-3.592652041512846,53.97774604936478,25.192547003925966,28.785199045438816
0.222222222,0.583333333,23.55,9/29/2014,13,26,away,-27,KCC,215,236,30,49,14,41,Loss,75,207,3,2,0,NEP,55,290,443,3,15.32394749924957,44.85752383358674,30.090735666418155,14.766788167168585
0.583333333,0.222222222,36.45,9/29/2014,26,13,home,27,NEP,236,215,35,66,41,14,Win,207,75,2,3,3,KCC,55,443,290,0,-15.32394749924957,44.85752383358674,14.766788167168585,30.090735666418155
0.333333333,0.363636364,32.15,10/2/2014,20,15,away,-32,GBP,188,164,91,75,10,42,Loss,111,156,6,2,1,MIN,52,299,320,3,-1.8527996721629734,41.17501981970974,19.661110073773383,21.513909745936356
0.363636364,0.333333333,27.85,10/2/2014,15,20,home,32,MIN,164,188,30,52,42,10,Win,156,111,2,6,3,GBP,52,320,299,1,1.8527996721629734,41.17501981970974,21.513909745936356,19.661110073773383
0.384615385,0.41666666700000005,32.98333333,10/5/2014,17,22,away,-7,CAR,262,231,79,62,24,31,Loss,85,91,4,2,3,CHI,55,347,322,4,-4.26983778672601,50.4590063543239,23.094584283798945,27.364422070524952
0.41666666700000005,0.384615385,27.01666667,10/5/2014,22,17,home,7,CHI,231,262,30,63,31,24,Win,91,85,2,4,4,CAR,55,322,347,3,4.26983778672601,50.4590063543239,27.364422070524952,23.094584283798945
0.333333333,0.571428571,29.28333333,10/5/2014,27,22,away,1,TEN,284,261,74,74,29,28,Win,176,149,1,3,0,CLE,57,460,410,1,-10.81789285084178,51.01119175895422,20.09664945405622,30.914542304898
0.571428571,0.333333333,30.71666667,10/5/2014,22,27,home,-1,CLE,261,284,68,65,28,29,Loss,149,176,3,1,1,TEN,57,410,460,0,10.81789285084178,51.01119175895422,30.914542304898,20.09664945405622
0.5,0.533333333,33.08333333,10/5/2014,29,22,away,-6,PHI,341,207,82,76,28,34,Loss,125,145,4,0,3,LAR,62,466,352,3,-8.215001060615894,59.558199342315355,25.67159914084973,33.886600201465626
0.533333333,0.5,26.91666667,10/5/2014,22,29,home,6,LAR,207,341,39,70,34,28,Win,145,125,0,4,3,PHI,62,352,466,3,8.215001060615894,59.558199342315355,33.886600201465626,25.67159914084973
0.153846154,0.6,28.31666667,10/5/2014,20,22,away,-10,NYG,307,193,81,67,20,30,Loss,90,124,1,1,2,ATL,50,397,317,1,-4.484904378444008,45.22917286368922,20.372134242622607,24.857038621066614
0.6,0.153846154,31.68333333,10/5/2014,22,20,home,10,ATL,193,307,15,65,30,20,Win,124,90,1,1,1,NYG,50,317,397,2,4.484904378444008,45.22917286368922,24.857038621066614,20.372134242622607
0.333333333,0.46153846200000004,27.06666667,10/5/2014,20,34,away,-6,NOS,248,371,113,54,0,6,Loss,66,140,1,0,3,TBB,6,314,511,1,-6.194622547588309,52.522229522779135,23.163803487595413,29.358426035183722
0.46153846200000004,0.333333333,38.53333333,10/5/2014,34,20,home,6,TBB,371,248,50,86,6,0,Win,140,66,0,1,1,NOS,6,511,314,3,6.194622547588309,52.522229522779135,29.358426035183722,23.163803487595413
0.307692308,0.571428571,31.13333333,10/5/2014,15,24,away,-3,DAL,154,316,35,56,0,3,Loss,176,140,0,1,3,HOU,3,330,456,1,-8.982794559226626,44.27796151772863,17.647583479251,26.630378038477627
0.571428571,0.307692308,36.11666667,10/5/2014,24,15,home,3,HOU,316,154,56,75,3,0,Win,140,176,1,0,1,DAL,3,456,330,3,8.982794559226626,44.27796151772863,26.630378038477627,17.647583479251
0.3125,0.090909091,32.31666667,10/5/2014,19,13,away,3,DET,294,204,74,67,17,14,Win,49,69,2,6,2,BUF,31,343,273,1,-0.40673780659589376,38.13665799450274,18.864960093953425,19.271697900549317
0.090909091,0.3125,27.68333333,10/5/2014,13,19,home,-3,BUF,204,294,62,57,14,17,Loss,69,49,6,2,1,DET,31,273,343,2,0.40673780659589376,38.13665799450274,19.271697900549317,18.864960093953425
0.090909091,0.46666666700000003,21.28333333,10/5/2014,15,26,away,-7,IND,197,305,36,57,13,20,Loss,90,127,4,1,4,BAL,33,287,432,3,2.103351404211521,46.54470869740363,24.324030050807576,22.220678646596053
0.46666666700000003,0.090909091,38.71666667,10/5/2014,26,15,home,7,BAL,305,197,83,80,20,13,Win,127,90,1,4,3,IND,33,432,287,4,-2.103351404211521,46.54470869740363,22.220678646596053,24.324030050807576
0.5,0.25,35.28333333,10/5/2014,20,12,away,8,JAX,261,187,50,68,17,9,Win,111,56,4,1,2,PIT,26,372,243,1,-1.9377106794076848,39.438873761020055,18.750581540806184,20.68829222021387
0.25,0.5,24.71666667,10/5/2014,12,20,home,-8,PIT,187,261,34,52,9,17,Loss,56,111,1,4,1,JAX,26,243,372,2,1.9377106794076848,39.438873761020055,20.68829222021387,18.750581540806184
0.1875,0.4375,24.71666667,10/5/2014,9,24,away,-21,DEN,178,476,15,56,20,41,Loss,37,92,3,1,2,ARI,61,215,568,0,-1.890146110265304,42.51530608176482,20.312579985749757,22.202726096015063
0.4375,0.1875,35.28333333,10/5/2014,24,9,home,21,ARI,476,178,67,76,41,20,Win,92,37,1,3,0,DEN,61,568,215,2,1.890146110265304,42.51530608176482,22.202726096015063,20.312579985749757
0.545454545,0.375,23.93333333,10/5/2014,14,22,away,-5,SFO,158,186,29,50,17,22,Loss,107,171,0,3,0,KCC,39,265,357,1,0.5885827334241474,36.79695592764032,18.692769330532233,18.104186597108086
0.375,0.545454545,36.06666667,10/5/2014,22,14,home,5,KCC,186,158,10,70,22,17,Win,171,107,3,0,1,SFO,39,357,265,0,-0.5885827334241474,36.79695592764032,18.104186597108086,18.692769330532233
0.083333333,0.666666667,21.1,10/5/2014,11,21,away,-31,LAC,60,277,94,54,0,31,Loss,91,162,2,3,1,NYJ,31,151,439,2,-9.188685040529219,37.41802291110269,14.114668935286737,23.303353975815952
0.666666667,0.083333333,38.9,10/5/2014,21,11,home,31,NYJ,277,60,76,71,31,0,Win,162,91,3,2,2,LAC,31,439,151,1,9.188685040529219,37.41802291110269,23.303353975815952,14.114668935286735
0.0,0.375,21.06666667,10/5/2014,17,30,away,-26,NEP,241,285,37,48,17,43,Loss,79,220,1,1,0,CIN,60,320,505,3,11.808255967979697,47.91224997166909,29.860252969824394,18.051997001844697
0.375,0.0,38.93333333,10/5/2014,30,17,home,26,CIN,285,241,114,82,43,17,Win,220,79,1,1,3,NEP,60,505,320,0,-11.808255967979697,47.91224997166909,18.051997001844697,29.860252969824394
0.35714285700000004,0.25,34.93333333,10/6/2014,20,14,away,10,WAS,178,275,90,63,27,17,Win,225,32,3,1,0,SEA,44,403,307,0,-1.4236672707110332,37.06675139082843,17.821542060058697,19.245209330769733
0.25,0.35714285700000004,25.06666667,10/6/2014,14,20,home,-10,SEA,275,178,30,54,17,27,Loss,32,225,1,3,0,WAS,44,307,403,0,1.4236672707110332,37.06675139082843,19.245209330769733,17.821542060058697
0.5,0.125,36.81666667,10/9/2014,27,18,away,5,HOU,363,196,51,82,33,28,Win,93,136,3,5,2,IND,61,456,332,2,-2.482895798593855,50.88539805655243,24.201251128979287,26.684146927573146
0.125,0.5,23.18333333,10/9/2014,18,27,home,-5,IND,196,363,66,52,28,33,Loss,136,93,5,3,2,HOU,61,332,456,2,2.482895798593855,50.88539805655243,26.684146927573146,24.201251128979287
0.533333333,0.272727273,31.11666667,10/12/2014,27,14,away,-2,TEN,297,220,35,75,14,16,Loss,82,70,6,3,0,JAX,30,379,290,2,-6.446831861966029,44.45472813461137,19.00394813632267,25.450779998288702
0.272727273,0.533333333,28.88333333,10/12/2014,14,27,home,2,JAX,220,297,48,55,16,14,Win,70,82,3,6,2,TEN,30,290,379,0,6.446831861966029,44.45472813461137,25.450779998288702,19.00394813632267
0.538461538,0.166666667,32.23333333,10/12/2014,23,22,away,31,TBB,306,277,70,63,48,17,Win,169,87,0,5,1,BAL,65,475,364,1,0.7974093690926338,48.35853275668688,24.577971062889755,23.78056169379712
0.166666667,0.538461538,27.76666667,10/12/2014,22,23,home,-31,BAL,277,306,43,67,17,48,Loss,87,169,5,0,1,TBB,65,364,475,1,-0.7974093690926338,48.35853275668688,23.78056169379712,24.577971062889755
0.4375,0.35714285700000004,33.56666667,10/12/2014,21,15,away,14,NYJ,221,173,101,68,31,17,Win,138,31,2,4,2,DEN,48,359,204,0,-4.330741540357133,38.62085362504472,17.145056042343793,21.475797582700924
0.35714285700000004,0.4375,26.43333333,10/12/2014,15,21,home,-14,DEN,173,221,9,62,17,31,Loss,31,138,4,2,0,NYJ,48,204,359,2,4.330741540357133,38.62085362504472,21.475797582700924,17.145056042343793
0.076923077,0.214285714,32.35,10/12/2014,18,15,away,14,MIN,155,143,40,65,17,3,Win,100,69,4,8,3,DET,20,255,212,0,-0.6878553767392219,28.358485659085893,13.835315141173336,14.523170517912558
0.214285714,0.076923077,27.65,10/12/2014,15,18,home,-14,DET,143,155,60,63,3,17,Loss,69,100,8,4,0,MIN,20,212,255,3,0.6878553767392219,28.358485659085893,14.523170517912558,13.835315141173336
0.46666666700000003,0.533333333,30.33333333,10/12/2014,22,19,away,15,BUF,346,268,60,66,37,22,Win,50,68,2,5,3,NEP,59,396,336,0,1.6244819373707777,49.444505308886356,25.53449362312857,23.910011685757787
0.533333333,0.46666666700000003,29.66666667,10/12/2014,19,22,home,-15,NEP,268,346,107,66,22,37,Loss,68,50,5,2,0,BUF,59,336,396,3,-1.6244819373707777,49.444505308886356,23.910011685757787,25.53449362312857
0.470588235,0.625,39.5,10/12/2014,29,29,away,0,CIN,284,320,60,80,3,3,Tie,147,193,0,1,2,CAR,6,431,513,1,-16.062722754807098,55.26510584948907,19.60119154734098,35.663914302148086
0.625,0.470588235,35.5,10/12/2014,29,29,home,0,CAR,320,284,119,75,3,3,Tie,193,147,1,0,1,CIN,6,513,431,2,16.062722754807098,55.26510584948907,35.663914302148086,19.601191547340985
0.375,0.363636364,33.08333333,10/12/2014,22,19,away,-21,CLE,221,210,42,76,10,31,Loss,138,158,2,1,1,PIT,41,359,368,1,-4.421075240028813,40.8151569700909,18.197040865031042,22.618116105059855
0.363636364,0.375,26.91666667,10/12/2014,19,22,home,21,PIT,210,221,60,56,31,10,Win,158,138,1,2,1,CLE,41,368,359,1,4.421075240028813,40.8151569700909,22.618116105059855,18.197040865031042
0.470588235,0.4,37.2,10/12/2014,27,19,away,3,MIA,248,237,44,79,27,24,Win,121,112,3,1,3,GBP,51,369,349,0,0.6570278415104749,48.43660010077961,24.546813971145042,23.889786129634565
0.4,0.470588235,22.8,10/12/2014,19,27,home,-3,GBP,237,248,25,55,24,27,Loss,112,121,1,3,0,MIA,51,349,369,3,-0.6570278415104749,48.43660010077961,23.889786129634565,24.546813971145042
0.571428571,0.615384615,37.03333333,10/12/2014,24,17,away,3,OAK,307,282,60,69,31,28,Win,116,114,1,0,1,LAC,59,423,396,0,-7.5925192511989374,56.04310852788039,24.225294638340728,31.817813889539664
0.615384615,0.571428571,22.96666667,10/12/2014,17,24,home,-3,LAC,282,307,78,54,28,31,Loss,114,116,0,1,0,OAK,59,396,423,1,7.5925192511989374,56.04310852788039,31.817813889539664,24.225294638340728
0.46666666700000003,0.307692308,36.25,10/12/2014,23,12,away,14,ATL,375,245,47,69,27,13,Win,103,42,2,4,1,CHI,40,478,287,0,-2.2724927340828884,42.40379600987327,20.06565163789519,22.33814437197808
0.307692308,0.46666666700000003,23.75,10/12/2014,12,23,home,-14,CHI,245,375,52,54,13,27,Loss,42,103,4,2,0,ATL,40,287,478,1,2.2724927340828884,42.40379600987327,22.33814437197808,20.06565163789519
0.588235294,0.384615385,37.65,10/12/2014,23,9,away,7,SEA,239,126,46,69,30,23,Win,162,80,1,2,1,DAL,53,401,206,2,-1.052769143166147,37.94143638145735,18.444333619145603,19.497102762311748
0.384615385,0.588235294,22.35,10/12/2014,9,23,home,-7,DAL,126,239,58,48,23,30,Loss,80,162,2,1,2,SEA,53,206,401,1,1.052769143166147,37.94143638145735,19.497102762311748,18.444333619145603
0.2,0.41176470600000004,25.68333333,10/12/2014,21,19,away,-10,ARI,335,243,62,57,20,30,Loss,72,74,2,1,0,WAS,50,407,317,4,-4.580752007150126,44.57706332582039,19.998155659335133,24.578907666485257
0.41176470600000004,0.2,34.31666667,10/12/2014,19,21,home,10,WAS,243,335,108,68,30,20,Win,74,72,1,2,4,ARI,50,317,407,0,4.580752007150126,44.57706332582039,24.578907666485257,19.998155659335133
0.14285714300000002,0.307692308,27.56666667,10/12/2014,12,24,away,-27,PHI,168,245,75,60,0,27,Loss,86,203,8,1,2,NYG,27,254,448,1,-1.011732498442239,42.3761841901683,20.68222584586303,21.693958344305273
0.307692308,0.14285714300000002,32.43333333,10/12/2014,24,12,home,27,NYG,245,168,25,71,27,0,Win,203,86,1,8,1,PHI,27,448,254,2,1.011732498442239,42.3761841901683,21.693958344305273,20.68222584586303
0.428571429,0.35714285700000004,28.63333333,10/13/2014,17,19,away,14,LAR,343,216,23,65,31,17,Win,89,93,0,5,1,SFO,48,432,309,1,-8.812448257028201,41.931898885627,16.5597253142994,25.3721735713276
0.35714285700000004,0.428571429,31.36666667,10/13/2014,19,17,home,-14,SFO,216,343,38,71,17,31,Loss,93,89,5,0,1,LAR,48,309,432,1,8.812448257028201,41.931898885627,25.3721735713276,16.5597253142994
0.5625,0.46153846200000004,40.9,10/16/2014,28,16,away,-2,NEP,205,260,70,80,25,27,Loss,218,63,3,1,0,NYJ,52,423,323,0,-0.39497137278341254,46.283172403030704,22.944100515123647,23.339071887907057
0.46153846200000004,0.5625,19.1,10/16/2014,16,28,home,2,NYJ,260,205,64,53,27,25,Win,63,218,1,3,0,NEP,52,323,423,0,0.39497137278341254,46.283172403030704,23.339071887907057,22.944100515123647
0.26666666699999997,0.363636364,26.78333333,10/19/2014,16,23,away,-22,BAL,186,248,76,65,7,29,Loss,68,123,5,1,3,ATL,36,254,371,1,2.842069571368649,38.393618592110585,20.617844081739616,17.77577451037097
0.363636364,0.26666666699999997,33.21666667,10/19/2014,23,16,home,22,ATL,248,186,72,62,29,7,Win,123,68,1,5,1,BAL,36,371,254,3,-2.842069571368649,38.393618592110585,17.77577451037097,20.617844081739616
0.272727273,0.272727273,30.93333333,10/19/2014,14,16,away,-2,WAS,160,251,96,49,17,19,Loss,76,100,1,3,2,TEN,36,236,351,2,-0.7411823726866196,38.72627395400677,18.992545790660074,19.733728163346697
0.272727273,0.272727273,29.06666667,10/19/2014,16,14,home,2,TEN,251,160,50,57,19,17,Win,100,76,3,1,2,WAS,36,351,236,2,0.7411823726866196,38.72627395400677,19.733728163346697,18.992545790660074
0.5,0.444444444,32.4,10/19/2014,25,18,away,-2,LAR,292,173,86,68,26,28,Loss,171,102,3,0,0,SEA,54,463,275,0,3.273406559387409,46.72840889398704,25.000907726687224,21.727501167299813
0.444444444,0.5,27.6,10/19/2014,18,25,home,2,SEA,173,292,20,48,28,26,Win,102,171,0,3,0,LAR,54,275,463,0,-3.273406559387409,46.72840889398704,21.727501167299813,25.000907726687224
0.235294118,0.3125,28.45,10/19/2014,13,20,away,-18,JAX,197,151,50,74,6,24,Loss,69,185,3,2,3,CLE,30,266,336,3,-13.078882824957283,34.907688094240584,10.91440263464165,23.993285459598933
0.3125,0.235294118,31.55,10/19/2014,20,13,home,18,CLE,151,197,25,68,24,6,Win,185,69,2,3,3,JAX,30,336,266,3,13.078882824957283,34.907688094240584,23.993285459598933,10.91440263464165
0.076923077,0.384615385,20.28333333,10/19/2014,8,27,away,-27,IND,103,335,20,54,0,27,Loss,32,171,4,2,2,CIN,27,135,506,0,0.06843487713902263,35.80352737689255,17.935981127015786,17.867546249876767
0.384615385,0.076923077,39.71666667,10/19/2014,27,8,home,27,CIN,335,103,57,78,27,0,Win,171,32,2,4,0,IND,27,506,135,2,-0.06843487713902263,35.80352737689255,17.867546249876767,17.935981127015786
0.3125,0.333333333,32.38333333,10/19/2014,16,22,away,-1,BUF,118,255,50,60,16,17,Loss,158,118,5,6,4,MIN,33,276,373,2,1.1015211751443772,43.9906219818779,22.54607157851114,21.44455040336676
0.333333333,0.3125,27.61666667,10/19/2014,22,16,home,1,MIN,255,118,48,68,17,16,Win,118,158,6,5,2,BUF,33,373,276,4,-1.1015211751443772,43.9906219818779,21.44455040336676,22.54607157851114
0.363636364,0.41666666700000005,37.36666667,10/19/2014,24,14,away,13,CHI,256,172,84,69,27,14,Win,137,52,4,3,3,MIA,41,393,224,0,1.3244460408864018,40.65057797989448,20.98751201039044,19.66306596950404
0.41666666700000005,0.363636364,22.63333333,10/19/2014,14,24,home,-13,MIA,172,256,15,51,14,27,Loss,52,137,3,4,0,CHI,41,224,393,3,-1.3244460408864018,40.65057797989448,19.66306596950404,20.98751201039044
0.25,0.46666666700000003,27.7,10/19/2014,25,21,away,-1,DET,335,285,134,67,23,24,Loss,73,59,1,3,2,NOS,47,408,344,2,-3.272405244179909,51.83267540846909,24.280135082144593,27.5525403263245
0.46666666700000003,0.25,32.3,10/19/2014,21,25,home,1,NOS,285,335,71,67,24,23,Win,59,73,3,1,2,DET,47,344,408,2,3.272405244179909,51.83267540846909,27.5525403263245,24.280135082144593
0.333333333,0.363636364,30.18333333,10/19/2014,23,22,away,-21,GBP,223,241,70,67,17,38,Loss,108,122,3,2,0,CAR,55,331,363,1,1.1850444278757024,48.38906709563129,24.787055761753496,23.602011333877794
0.363636364,0.333333333,29.81666667,10/19/2014,22,23,home,21,CAR,241,223,29,56,38,17,Win,122,108,2,3,1,GBP,55,363,331,0,-1.1850444278757024,48.38906709563129,23.602011333877794,24.787055761753496
0.5,0.3,39.0,10/19/2014,22,19,away,3,LAC,211,182,73,70,23,20,Win,154,69,3,2,1,KCC,43,365,251,0,0.5190046538128295,39.1448466999033,19.831925676858063,19.312921023045234
0.3,0.5,21.0,10/19/2014,19,22,home,-3,KCC,182,211,49,49,20,23,Loss,69,154,2,3,0,LAC,43,251,365,1,-0.5190046538128295,39.1448466999033,19.312921023045234,19.831925676858063
0.6,0.333333333,36.95,10/19/2014,25,13,away,11,OAK,242,164,43,69,24,13,Win,123,56,1,1,0,ARI,37,365,220,1,-2.030308445310535,42.6813083259823,20.32549994033588,22.35580838564642
0.333333333,0.6,23.05,10/19/2014,13,25,home,-11,ARI,164,242,74,48,13,24,Loss,56,123,1,1,1,OAK,37,220,365,0,2.030308445310535,42.6813083259823,22.35580838564642,20.32549994033588
0.384615385,0.642857143,26.18333333,10/19/2014,20,20,away,-10,DAL,248,267,40,59,21,31,Loss,104,156,0,2,1,NYG,52,352,423,2,-0.6664856393954839,51.338338533391685,25.3359264469981,26.002412086393583
0.642857143,0.384615385,33.81666667,10/19/2014,20,20,home,10,NYG,267,248,46,60,31,21,Win,156,104,2,0,2,DAL,52,423,352,1,0.6664856393954839,51.338338533391685,26.002412086393583,25.3359264469981
0.23076923100000002,0.5555555560000001,32.01666667,10/19/2014,22,23,away,-25,DEN,248,304,62,70,17,42,Loss,62,115,6,2,0,SFO,59,310,419,1,3.2114711716603885,47.22227065039035,25.216870911025367,22.005399739364982
0.5555555560000001,0.23076923100000002,27.98333333,10/19/2014,23,22,home,25,SFO,304,248,75,56,42,17,Win,115,62,2,6,1,DEN,59,419,310,0,-3.2114711716603885,47.22227065039035,22.005399739364982,25.216870911025367
0.333333333,0.35714285700000004,27.9,10/20/2014,20,18,away,-7,PIT,261,252,20,63,23,30,Loss,132,76,1,3,1,HOU,53,393,328,3,0.07074440992855946,45.43076585649415,22.750755133211353,22.680010723282795
0.35714285700000004,0.333333333,32.1,10/20/2014,18,20,home,7,HOU,252,261,38,62,30,23,Win,76,132,3,1,3,PIT,53,328,393,1,-0.07074440992855946,45.43076585649415,22.680010723282795,22.750755133211353
0.4,0.615384615,29.23333333,10/23/2014,22,27,away,-14,DEN,245,286,77,58,21,35,Loss,61,139,2,0,0,LAC,56,306,425,2,2.1305989392395333,53.24853778327445,27.689568361256992,25.55896942201746
0.615384615,0.4,30.76666667,10/23/2014,27,22,home,14,LAC,286,245,71,65,35,21,Win,139,61,0,2,2,DEN,56,425,306,0,-2.1305989392395333,53.24853778327445,25.55896942201746,27.689568361256992
0.533333333,0.5,30.91666667,10/26/2014,22,22,away,1,ATL,325,213,85,70,22,21,Win,60,78,0,2,1,DET,43,385,291,1,-1.4274119721716734,47.34292304538365,22.957755536605987,24.385167508777663
0.5,0.533333333,29.08333333,10/26/2014,22,22,home,-1,DET,213,325,39,55,21,22,Loss,78,60,2,0,1,ATL,43,291,385,1,1.4274119721716734,47.34292304538365,24.385167508777663,22.957755536605987
0.272727273,0.5,24.36666667,10/26/2014,13,23,away,-27,KCC,116,215,68,51,7,34,Loss,84,140,7,2,1,LAR,41,200,355,1,0.6577340639029821,36.90080552199892,18.77926979295095,18.12153572904797
0.5,0.272727273,35.63333333,10/26/2014,23,13,home,27,LAR,215,116,51,64,34,7,Win,140,84,2,7,1,KCC,41,355,200,1,-0.6577340639029821,36.90080552199892,18.12153572904797,18.77926979295095
0.4375,0.166666667,35.36666667,10/26/2014,24,13,away,14,TEN,193,290,35,80,30,16,Win,212,36,5,2,2,HOU,46,405,326,0,-12.274470282771784,41.84260035910088,14.784065038164549,27.05853532093633
0.166666667,0.4375,24.63333333,10/26/2014,13,24,home,-14,HOU,290,193,61,56,16,30,Loss,36,212,2,5,0,TEN,46,326,405,2,12.274470282771784,41.84260035910088,27.05853532093633,14.784065038164547
0.4,0.083333333,30.56666667,10/26/2014,22,15,away,6,TBB,235,159,59,65,6,0,Win,97,66,1,5,2,MIN,6,332,225,0,-1.8039454744030294,34.5008993356422,16.348476930619587,18.152422405022616
0.083333333,0.4,29.71666667,10/26/2014,15,22,home,-6,MIN,159,235,52,56,0,6,Loss,66,97,5,1,0,TBB,6,225,332,2,1.8039454744030294,34.5008993356422,18.152422405022616,16.348476930619587
0.363636364,0.2,29.0,10/26/2014,19,17,away,4,CAR,191,152,41,59,13,9,Win,119,114,1,3,2,SEA,22,310,266,2,5.436893236327663,39.39414432548556,22.415518780906613,16.97862554457895
0.2,0.363636364,31.0,10/26/2014,17,19,home,-4,SEA,152,191,20,56,9,13,Loss,114,119,3,1,2,CAR,22,266,310,2,-5.436893236327663,39.39414432548556,16.97862554457895,22.415518780906613
0.384615385,0.571428571,29.26666667,10/26/2014,18,19,away,-3,CIN,187,239,51,61,24,27,Loss,107,111,1,2,2,BAL,51,294,350,2,4.672405456387509,42.583623165213076,23.628014310800292,18.955608854412784
0.571428571,0.384615385,30.73333333,10/26/2014,19,18,home,3,BAL,239,187,40,64,27,24,Win,111,107,2,1,2,CIN,51,350,294,2,-4.672405456387509,42.583623165213076,18.955608854412784,23.628014310800292
0.41666666700000005,0.4,27.61666667,10/26/2014,17,19,away,14,JAX,178,201,52,56,27,13,Win,148,176,3,4,3,MIA,40,326,377,1,-2.45772594624321,44.281277754936504,20.911775904346648,23.369501850589856
0.4,0.41666666700000005,32.38333333,10/26/2014,19,17,home,-14,MIA,201,178,37,68,13,27,Loss,176,148,4,3,1,JAX,40,377,326,3,2.45772594624321,44.281277754936504,23.369501850589856,20.911775904346648
0.363636364,0.636363636,27.28333333,10/26/2014,27,32,away,-28,NEP,231,365,41,64,23,51,Loss,153,122,3,1,0,CHI,74,384,487,2,8.87935258166464,58.00793356376953,33.44364307271708,24.564290491052443
0.636363636,0.363636364,32.71666667,10/26/2014,32,27,home,28,CHI,365,231,38,71,51,23,Win,122,153,1,3,2,NEP,74,487,384,0,-8.87935258166464,58.00793356376953,24.564290491052446,33.44364307271708
0.25,0.473684211,27.71666667,10/26/2014,12,22,away,20,NYJ,213,137,49,53,43,23,Win,67,175,4,4,6,BUF,66,280,312,0,-8.301718787581052,41.34383077233871,16.52105599237883,24.822774779959882
0.473684211,0.25,32.28333333,10/26/2014,22,12,home,-20,BUF,137,213,90,81,23,43,Loss,175,67,4,4,0,NYJ,66,312,280,6,8.301718787581052,41.34383077233871,24.822774779959882,16.52105599237883
0.45,0.41176470600000004,31.16666667,10/26/2014,27,17,away,-4,ARI,411,329,103,87,20,24,Loss,110,71,0,0,1,PHI,44,521,400,3,-15.16006829679786,55.97488098868756,20.40740634594485,35.56747464274271
0.41176470600000004,0.45,28.83333333,10/26/2014,17,27,home,4,PHI,329,411,95,65,24,20,Win,71,110,0,0,3,ARI,44,400,521,1,15.16006829679786,55.97488098868756,35.56747464274271,20.40740634594485
0.31578947399999996,0.166666667,34.86666667,10/26/2014,19,15,away,-10,CLE,311,267,54,81,13,23,Loss,76,39,4,1,0,OAK,36,387,306,3,-7.444219018956147,40.322551861934215,16.439166421489034,23.88338544044518
0.166666667,0.31578947399999996,25.13333333,10/26/2014,15,19,home,10,OAK,267,311,30,54,23,13,Win,39,76,1,4,3,CLE,36,306,387,0,7.444219018956147,40.322551861934215,23.88338544044518,16.439166421489034
0.5,0.615384615,20.28333333,10/26/2014,26,34,away,-17,PIT,385,522,43,57,34,51,Loss,63,117,2,0,2,IND,85,448,639,2,4.089902682209334,72.91420014450372,38.502051413356526,34.4121487311472
0.615384615,0.5,39.71666667,10/26/2014,34,26,home,17,IND,522,385,59,81,51,34,Win,117,63,0,2,2,PIT,85,639,448,2,-4.089902682209334,72.91420014450372,34.4121487311472,38.502051413356526
0.14285714300000002,0.6,28.35,10/26/2014,23,28,away,-21,NOS,402,302,84,63,23,44,Loss,89,193,4,2,1,GBP,67,491,495,3,9.505304875390507,63.56198134939933,36.53364311239492,27.028338237004412
0.6,0.14285714300000002,31.65,10/26/2014,28,23,home,21,GBP,302,402,35,65,44,23,Win,193,89,2,4,3,NOS,67,495,491,1,-9.505304875390507,63.56198134939933,27.028338237004412,36.53364311239492
0.428571429,0.41666666700000005,38.2,10/27/2014,19,20,away,3,DAL,286,224,45,64,3,0,Win,123,171,3,5,2,WAS,3,409,395,1,-5.837667516210134,41.83035159107168,17.996342037430775,23.834009553640907
0.41666666700000005,0.428571429,28.61666667,10/27/2014,20,19,home,-3,WAS,224,286,35,64,0,3,Loss,171,123,5,3,1,DAL,3,395,409,2,5.837667516210134,41.83035159107168,23.834009553640907,17.996342037430775
0.538461538,0.428571429,35.3,10/30/2014,27,15,away,18,CAR,270,122,36,75,28,10,Win,105,109,4,4,2,NOS,38,375,231,2,-4.211462883187914,46.00847740485193,20.89850726083201,25.109970144019922
0.428571429,0.538461538,24.7,10/30/2014,15,27,home,-18,NOS,122,270,67,54,10,28,Loss,109,105,4,4,2,CAR,38,231,375,2,4.211462883187914,46.00847740485193,25.109970144019922,20.89850726083201
0.333333333,0.35714285700000004,30.53333333,11/2/2014,20,19,away,-5,CLE,252,274,33,61,17,22,Loss,113,56,2,4,2,TBB,39,365,330,2,-1.9049572379916557,41.90327861715848,19.999160689583412,21.904117927575065
0.35714285700000004,0.333333333,29.46666667,11/2/2014,19,20,home,5,TBB,274,252,44,65,22,17,Win,56,113,4,2,2,CLE,39,330,365,2,1.9049572379916557,41.90327861715848,21.904117927575065,19.999160689583412
0.6,0.272727273,31.46666667,11/2/2014,22,18,away,11,DAL,237,174,62,65,28,17,Win,102,92,2,1,2,ARI,45,339,266,1,-1.5627004804516798,39.15364435159768,18.795471935572998,20.35817241602468
0.272727273,0.6,28.53333333,11/2/2014,18,22,home,-11,ARI,174,237,33,59,17,28,Loss,92,102,1,2,1,DAL,45,266,339,2,1.5627004804516798,39.15364435159768,20.35817241602468,18.795471935572998
0.5625,0.384615385,32.21666667,11/2/2014,30,15,away,10,HOU,293,182,55,79,31,21,Win,190,118,4,4,1,PHI,52,483,300,4,-5.604334373211401,54.45476955198153,24.425217589385063,30.029551962596464
0.384615385,0.5625,27.78333333,11/2/2014,15,30,home,-10,PHI,182,293,54,59,21,31,Loss,118,190,4,4,4,HOU,52,300,483,1,5.604334373211401,54.45476955198153,30.029551962596464,24.425217589385063
0.333333333,0.615384615,31.58333333,11/2/2014,22,23,away,-14,KCC,225,196,40,69,10,24,Loss,139,113,3,1,0,NYJ,34,364,309,0,0.610528083473918,43.32750833756121,21.969018210517564,21.35849012704365
0.615384615,0.333333333,28.41666667,11/2/2014,23,22,home,14,NYJ,196,225,20,56,24,10,Win,113,139,1,3,0,KCC,34,309,364,0,-0.610528083473918,43.32750833756121,21.35849012704365,21.969018210517564
0.333333333,0.46153846200000004,27.26666667,11/2/2014,19,23,away,-10,CIN,233,232,35,60,23,33,Loss,132,191,2,2,2,JAX,56,365,423,1,0.6338065204827799,49.34405071586031,24.988928618171546,24.355122097688767
0.46153846200000004,0.333333333,32.73333333,11/2/2014,23,19,home,10,JAX,232,233,40,67,33,23,Win,191,132,2,2,1,CIN,56,423,365,2,-0.6338065204827799,49.34405071586031,24.355122097688767,24.988928618171546
0.272727273,0.571428571,23.88333333,11/2/2014,10,28,away,-37,MIA,128,309,57,49,0,37,Loss,50,132,4,0,0,LAC,37,178,441,4,0.5406496934344602,41.44327194867919,20.991960821056825,20.451311127622365
0.571428571,0.272727273,36.11666667,11/2/2014,28,10,home,37,LAC,309,128,25,74,37,0,Win,132,50,0,4,4,MIA,37,441,178,0,-0.5406496934344602,41.44327194867919,20.451311127622365,20.991960821056825
0.46153846200000004,0.533333333,29.56666667,11/2/2014,21,24,away,-3,MIN,225,252,55,62,26,29,Loss,122,100,5,2,0,WAS,55,347,352,1,-9.553545375114574,44.69405970681109,17.570257165848258,27.12380254096283
0.533333333,0.46153846200000004,30.43333333,11/2/2014,24,21,home,3,WAS,252,225,60,71,29,26,Win,100,122,2,5,1,MIN,55,352,347,0,9.553545375114574,44.69405970681109,27.12380254096283,17.570257165848258
0.333333333,0.25,27.56666667,11/2/2014,13,20,away,3,SFO,102,183,83,52,13,10,Win,91,80,1,8,2,LAR,23,193,263,2,1.7222983997697028,32.939263232499556,17.330780816134627,15.608482416364927
0.25,0.333333333,32.43333333,11/2/2014,20,13,home,-3,LAR,183,102,44,62,10,13,Loss,80,91,8,1,2,SFO,23,263,193,2,-1.7222983997697028,32.939263232499556,15.608482416364925,17.33078081613463
0.272727273,0.375,30.55,11/2/2014,26,29,away,-22,NEP,429,332,72,75,21,43,Loss,43,66,1,1,1,DEN,64,472,398,2,0.7239198088939212,55.05537909975706,27.889649454325493,27.16572964543157
0.375,0.272727273,29.45,11/2/2014,29,26,home,22,DEN,332,429,71,79,43,21,Win,66,43,1,1,2,NEP,64,398,472,1,-0.7239198088939212,55.05537909975706,27.16572964543157,27.889649454325493
0.333333333,0.38888888899999996,24.9,11/2/2014,17,21,away,-6,SEA,189,177,69,60,24,30,Loss,37,149,1,1,0,OAK,54,226,326,3,-9.179472233749438,39.317707224307014,15.069117495278789,24.248589729028225
0.38888888899999996,0.333333333,35.1,11/2/2014,21,17,home,6,OAK,177,189,65,74,30,24,Win,149,37,1,1,3,SEA,54,326,226,0,9.179472233749438,39.317707224307014,24.248589729028225,15.069117495278789
0.23076923100000002,0.428571429,28.56666667,11/2/2014,22,22,away,-20,PIT,269,321,108,67,23,43,Loss,63,55,4,3,1,BAL,66,332,376,2,2.1594540328416585,44.44506056086125,23.302257296851455,21.142803264009796
0.428571429,0.23076923100000002,31.43333333,11/2/2014,22,22,home,20,BAL,321,269,67,65,43,23,Win,55,63,3,4,2,PIT,66,376,332,1,-2.1594540328416585,44.44506056086125,21.142803264009796,23.302257296851455
0.333333333,0.25,33.05,11/3/2014,22,22,away,16,NYG,345,349,30,71,40,24,Win,98,89,1,3,1,IND,64,443,438,0,-7.3596170754873524,49.61048276753963,21.12543284602614,28.48504992151349
0.25,0.333333333,26.95,11/3/2014,22,22,home,-16,IND,349,345,30,75,24,40,Loss,89,98,3,1,0,NYG,64,438,443,1,7.3596170754873524,49.61048276753963,28.48504992151349,21.12543284602614
0.4375,0.176470588,35.81666667,11/6/2014,21,11,away,21,CIN,198,79,62,75,24,3,Win,170,86,0,2,4,CLE,27,368,165,1,-10.157264127843376,30.938829266107682,10.390782569132153,20.54804669697553
0.176470588,0.4375,24.18333333,11/6/2014,11,21,home,-21,CLE,79,198,55,63,3,24,Loss,86,170,2,0,1,CIN,27,165,368,4,10.157264127843376,30.938829266107682,20.54804669697553,10.390782569132153
0.23076923100000002,0.4375,29.3,11/9/2014,16,21,away,4,BUF,151,253,19,59,17,13,Win,127,111,6,1,3,KCC,30,278,364,1,-0.9309573176910622,39.8332367484406,19.45113971537477,20.38209703306583
0.4375,0.23076923100000002,30.7,11/9/2014,21,16,home,-4,KCC,253,151,44,71,13,17,Loss,111,127,1,6,1,BUF,30,364,278,3,0.9309573176910622,39.8332367484406,20.38209703306583,19.45113971537477
0.35714285700000004,0.25,28.43333333,11/9/2014,20,19,away,-4,DET,178,288,44,60,16,20,Loss,50,63,3,3,1,MIA,36,228,351,2,0.9202947617903376,39.63238094266701,20.276337852228675,19.356043090438337
0.25,0.35714285700000004,31.56666667,11/9/2014,19,20,home,4,MIA,288,178,98,64,20,16,Win,63,50,3,3,2,DET,36,351,228,1,-0.9202947617903376,39.63238094266701,19.356043090438337,20.276337852228675
0.307692308,0.28571428600000004,31.53333333,11/9/2014,16,20,away,14,JAX,248,262,65,59,31,17,Win,151,71,1,4,3,DAL,48,399,333,1,-2.167999870173393,43.802749165537676,20.817374647682144,22.985374517855533
0.28571428600000004,0.307692308,28.46666667,11/9/2014,20,16,home,-14,DAL,262,248,19,65,17,31,Loss,71,151,4,1,1,JAX,48,333,399,3,2.167999870173393,43.802749165537676,22.985374517855533,20.817374647682144
0.4,0.444444444,33.76666667,11/9/2014,21,23,away,3,NOS,186,287,15,68,3,0,Win,144,136,4,2,3,SFO,3,330,423,1,-7.102000880102592,39.659713949996856,16.27885653494713,23.380857415049725
0.444444444,0.4,36.0,11/9/2014,23,21,home,-3,SFO,287,186,43,80,0,3,Loss,136,144,2,4,1,NOS,3,423,330,3,7.102000880102592,39.659713949996856,23.380857415049725,16.27885653494713
0.333333333,0.307692308,29.21666667,11/9/2014,14,18,away,-14,BAL,143,161,67,54,7,21,Loss,67,151,5,1,0,TEN,28,210,312,2,2.6841736409465256,32.56649617502147,17.625334907983998,14.941161267037472
0.307692308,0.333333333,30.78333333,11/9/2014,18,14,home,14,TEN,161,143,40,62,21,7,Win,151,67,1,5,2,BAL,28,312,210,0,-2.6841736409465256,32.56649617502147,14.941161267037472,17.625334907983998
0.545454545,0.4,29.45,11/9/2014,22,15,away,-7,NYJ,326,125,20,62,13,20,Loss,36,150,2,4,0,PIT,33,362,275,4,1.706188012521812,44.933281063987344,23.31973453825458,21.613546525732765
0.4,0.545454545,30.55,11/9/2014,15,22,home,7,PIT,125,326,75,58,20,13,Win,150,36,4,2,4,NYJ,33,275,362,0,-1.706188012521812,44.933281063987344,21.613546525732765,23.31973453825458
0.5,0.705882353,29.8,11/9/2014,19,23,away,10,TBB,212,281,30,60,27,17,Win,110,92,1,4,3,ATL,44,322,373,0,-9.047242467002478,46.455479116947934,18.70411832497273,27.751360791975205
0.705882353,0.5,30.2,11/9/2014,23,19,home,-10,ATL,281,212,79,70,17,27,Loss,92,110,4,1,0,TBB,44,373,322,3,9.047242467002478,46.455479116947934,27.751360791975205,18.70411832497273
0.46666666700000003,0.27777777800000003,32.36666667,11/9/2014,25,10,away,24,OAK,353,192,95,76,41,17,Win,118,30,0,0,3,DEN,58,471,222,2,-11.183649208788239,49.046341924578364,18.931346357895062,30.1149955666833
0.27777777800000003,0.46666666700000003,27.63333333,11/9/2014,10,25,home,-24,DEN,192,353,37,62,17,41,Loss,30,118,0,0,2,OAK,58,222,471,3,11.183649208788239,49.046341924578364,30.1149955666833,18.931346357895062
0.1,0.4,26.66666667,11/9/2014,16,21,away,-17,ARI,174,307,80,58,14,31,Loss,70,28,6,3,1,LAR,45,244,335,3,0.7725209044845229,37.25137513029412,19.011948017389322,18.2394271129048
0.4,0.1,33.33333333,11/9/2014,21,16,home,17,LAR,307,174,35,66,31,14,Win,28,70,3,6,3,ARI,45,335,244,1,-0.7725209044845229,37.25137513029412,18.2394271129048,19.011948017389322
0.5,0.583333333,26.8,11/9/2014,20,27,away,-21,SEA,270,160,35,63,17,38,Loss,54,350,2,2,3,NYG,55,324,510,2,2.0601868483523713,57.02060900269146,29.540397925521916,27.480211077169542
0.583333333,0.5,33.2,11/9/2014,27,20,home,21,NYG,160,270,50,64,38,17,Win,350,54,2,2,2,SEA,55,510,324,3,-2.0601868483523713,57.02060900269146,27.480211077169542,29.540397925521916
0.25,0.46153846200000004,30.31666667,11/9/2014,21,21,away,-41,GBP,256,319,163,68,14,55,Loss,55,132,4,0,1,CHI,69,311,451,3,-7.094333001470154,51.32206137676778,22.11386418764881,29.208197189118966
0.46153846200000004,0.25,29.68333333,11/9/2014,21,21,home,41,CHI,319,256,50,64,55,14,Win,132,55,0,4,3,GBP,69,451,311,1,7.094333001470154,51.32206137676778,29.208197189118966,22.11386418764881
0.5,0.333333333,38.08333333,11/10/2014,21,17,away,-24,PHI,215,328,30,81,21,45,Loss,102,37,9,1,0,CAR,66,317,365,5,-9.646611817041652,47.66267035792503,19.00802927044169,28.65464108748334
0.333333333,0.5,21.91666667,11/10/2014,17,21,home,24,CAR,328,215,50,62,45,21,Win,37,102,1,9,5,PHI,66,365,317,0,9.646611817041652,47.66267035792503,28.65464108748334,19.00802927044169
0.4,0.444444444,27.63333333,11/13/2014,13,24,away,-13,MIA,183,205,70,60,9,22,Loss,54,125,2,5,2,BUF,31,237,330,0,-0.17581023005467689,38.48601399592653,19.155101882935924,19.330912112990603
0.444444444,0.4,32.36666667,11/13/2014,24,13,home,13,BUF,205,183,30,63,22,9,Win,125,54,5,2,0,MIA,31,330,237,2,0.17581023005467689,38.48601399592653,19.330912112990603,19.155101882935924
0.181818182,0.588235294,21.36666667,11/16/2014,10,24,away,-8,CHI,147,330,18,46,13,21,Loss,96,138,2,0,2,MIN,34,243,468,1,-1.562387568242638,43.68592413530085,21.061768283529105,22.624155851771746
0.588235294,0.181818182,38.63333333,11/16/2014,24,10,home,8,MIN,330,147,60,74,21,13,Win,138,96,0,2,1,CHI,34,468,243,2,1.562387568242638,43.68592413530085,22.624155851771746,21.061768283529105
0.38888888899999996,0.2,33.88333333,11/16/2014,29,24,away,16,CLE,211,310,55,84,23,7,Win,213,65,0,3,2,HOU,30,424,375,1,-17.926596095857704,46.159287648948236,14.116345776545266,32.04294187240297
0.2,0.38888888899999996,26.11666667,11/16/2014,24,29,home,-16,HOU,310,211,67,76,7,23,Loss,65,213,3,0,1,CLE,30,375,424,2,17.926596095857704,46.159287648948236,32.04294187240297,14.116345776545266
0.41666666700000005,0.333333333,36.2,11/16/2014,25,20,away,-4,KCC,168,108,50,71,20,24,Loss,204,190,2,0,2,SEA,44,372,298,0,9.197181396768814,41.57960853312307,25.38839496494594,16.19121356817713
0.333333333,0.41666666700000005,23.8,11/16/2014,20,25,home,4,SEA,108,168,6,46,24,20,Win,190,204,0,2,0,KCC,44,298,372,2,-9.197181396768814,41.57960853312307,16.19121356817713,25.38839496494594
0.333333333,0.23076923100000002,31.96666667,11/16/2014,22,22,away,2,CAR,260,285,58,74,19,17,Win,86,106,2,2,2,ATL,36,346,391,1,-6.24630342991899,44.7588895231778,19.256293046629406,25.502596476548394
0.23076923100000002,0.333333333,28.03333333,11/16/2014,22,22,home,-2,ATL,285,260,15,64,17,19,Loss,106,86,2,2,1,CAR,36,391,346,2,6.24630342991899,44.7588895231778,25.502596476548394,19.256293046629406
0.692307692,0.615384615,29.23333333,11/16/2014,22,24,away,17,NOS,219,255,33,59,27,10,Win,186,75,1,0,1,CIN,37,405,330,0,2.284619152259081,50.721531542541506,26.503075347400294,24.21845619514121
0.615384615,0.692307692,30.76666667,11/16/2014,24,22,home,-17,CIN,255,219,34,67,10,27,Loss,75,186,0,1,0,NOS,37,330,405,1,-2.284619152259081,50.721531542541506,24.21845619514121,26.503075347400294
0.3,0.307692308,25.81666667,11/16/2014,12,20,away,20,WAS,281,167,101,46,27,7,Win,48,155,2,6,3,TBB,34,329,322,1,-6.255970062890147,39.70429964762079,16.724164792365322,22.98013485525547
0.307692308,0.3,34.18333333,11/16/2014,20,12,home,-20,TBB,167,281,67,69,7,27,Loss,155,48,6,2,1,WAS,34,322,329,3,6.255970062890147,39.70429964762079,22.98013485525547,16.724164792365322
0.333333333,0.352941176,24.16666667,11/16/2014,21,16,away,-15,LAR,369,206,62,66,7,22,Loss,28,131,2,3,0,DEN,29,397,337,2,-3.412233518923448,44.83102660816815,20.70939654462235,24.1216300635458
0.352941176,0.333333333,35.83333333,11/16/2014,16,21,home,15,DEN,206,369,25,65,22,7,Win,131,28,3,2,2,LAR,29,337,397,0,3.412233518923448,44.83102660816815,24.1216300635458,20.70939654462235
0.428571429,0.4,34.98333333,11/16/2014,20,17,away,6,NYG,185,265,35,68,16,10,Win,148,65,1,2,5,SFO,26,333,330,1,-8.261893245640225,45.04026777404327,18.389187264201524,26.651080509841748
0.4,0.428571429,25.01666667,11/16/2014,17,20,home,-6,SFO,265,185,54,68,10,16,Loss,65,148,2,1,1,NYG,26,330,333,5,8.261893245640225,45.04026777404327,26.651080509841748,18.389187264201524
0.2,0.26666666699999997,25.23333333,11/16/2014,9,18,away,-7,LAC,162,180,41,55,6,13,Loss,71,120,2,2,0,OAK,19,233,300,1,-7.331120059144805,30.907212280399033,11.788046110627114,19.11916616977192
0.26666666699999997,0.2,34.76666667,11/16/2014,18,9,home,7,OAK,180,162,40,68,13,6,Win,120,71,2,2,1,LAC,19,300,233,0,7.331120059144805,30.907212280399033,19.11916616977192,11.788046110627114
0.333333333,0.571428571,27.3,11/16/2014,22,25,away,-33,GBP,320,365,53,78,20,53,Loss,109,110,3,1,0,PHI,73,429,475,4,-1.7835821504417524,60.36724354111871,29.29183069533848,31.07541284578023
0.571428571,0.333333333,32.7,11/16/2014,25,22,home,33,PHI,365,320,52,64,53,20,Win,110,109,1,3,4,GBP,73,475,429,0,1.7835821504417524,60.36724354111871,31.07541284578023,29.29183069533848
0.333333333,0.571428571,29.28333333,11/16/2014,11,18,away,-8,ARI,164,306,80,53,6,14,Loss,98,46,4,0,2,DET,20,262,352,1,2.150798005271275,40.425021345031325,21.2879096751513,19.137111669880024
0.571428571,0.333333333,30.71666667,11/16/2014,18,11,home,8,DET,306,164,35,58,14,6,Win,46,98,0,4,1,ARI,20,352,262,2,-2.150798005271275,40.425021345031325,19.137111669880024,21.2879096751513
0.818181818,0.384615385,34.35,11/16/2014,33,17,away,22,IND,257,303,53,74,42,20,Win,246,19,0,1,1,NEP,62,503,322,2,8.223845349884087,57.33914701856827,32.78149618422618,24.55765083434209
0.384615385,0.818181818,25.65,11/16/2014,17,33,home,-22,NEP,303,257,27,56,20,42,Loss,19,246,1,0,2,IND,62,322,503,1,-8.223845349884087,57.33914701856827,24.55765083434209,32.78149618422618
0.538461538,0.375,39.81666667,11/17/2014,29,14,away,3,TEN,180,263,39,73,27,24,Win,206,49,5,0,1,PIT,51,386,312,1,7.948265306288002,47.62460141208755,27.786433359187775,19.838168052899775
0.375,0.538461538,20.18333333,11/17/2014,14,29,home,-3,PIT,263,180,10,39,24,27,Loss,49,206,0,5,1,TEN,51,312,386,1,-7.948265306288002,47.62460141208755,19.838168052899775,27.786433359187775
0.14285714300000002,0.5,29.93333333,11/20/2014,16,18,away,-4,OAK,217,172,59,62,20,24,Loss,96,179,2,1,1,KCC,44,313,351,0,-8.920030329943874,39.51103717001495,15.295503420035537,24.215533749979414
0.5,0.14285714300000002,30.06666667,11/20/2014,18,16,home,4,KCC,172,217,60,66,24,20,Win,179,96,1,2,0,OAK,44,351,313,1,8.920030329943874,39.51103717001495,24.215533749979414,15.295503420035539
0.4,0.5625,30.61666667,11/23/2014,29,21,away,2,ATL,313,252,30,71,26,24,Win,162,63,1,3,2,CLE,50,475,315,3,-2.602961874116332,50.2999545777341,23.848496351808883,26.451458225925215
0.5625,0.4,29.38333333,11/23/2014,21,29,home,-2,CLE,252,313,40,69,24,26,Loss,63,162,3,1,3,ATL,50,315,475,2,2.602961874116332,50.2999545777341,26.451458225925215,23.848496351808883
0.166666667,0.526315789,26.8,11/23/2014,16,26,away,-19,PHI,299,298,56,63,24,43,Loss,52,164,5,2,2,TEN,67,351,462,3,-9.87435399258587,51.70456986079372,20.915107934103922,30.789461926689796
0.526315789,0.166666667,33.2,11/23/2014,26,16,home,19,TEN,298,299,69,83,43,24,Win,164,52,2,5,3,PHI,67,462,351,2,9.87435399258587,51.70456986079372,30.789461926689796,20.915107934103922
0.294117647,0.428571429,30.18333333,11/23/2014,21,29,away,-25,NEP,244,349,54,73,9,34,Loss,91,90,2,0,1,DET,43,335,439,1,-1.5108186708492966,48.64965525926211,23.569418294206407,25.080236965055704
0.428571429,0.294117647,29.81666667,11/23/2014,29,21,home,25,DET,349,244,89,73,34,9,Win,90,91,0,2,1,NEP,43,439,335,1,1.5108186708492966,48.64965525926211,25.080236965055704,23.569418294206407
0.545454545,0.384615385,31.75,11/23/2014,24,20,away,3,MIN,207,196,75,62,24,21,Win,155,112,1,2,1,GBP,45,362,308,0,-2.7208126705423332,46.898286917993794,22.08873712372573,24.809549794268065
0.384615385,0.545454545,28.25,11/23/2014,20,24,home,-3,GBP,196,207,77,64,21,24,Loss,112,155,2,1,0,MIN,45,308,362,1,2.7208126705423332,46.898286917993794,24.809549794268065,22.08873712372573
0.25,0.529411765,25.91666667,11/23/2014,11,24,away,-20,IND,114,214,43,54,3,23,Loss,80,175,4,5,3,JAX,26,194,389,2,-3.529460528035946,41.40769548747602,18.939117479720036,22.468578007755983
0.529411765,0.25,34.08333333,11/23/2014,24,11,home,20,JAX,214,114,54,72,23,3,Win,175,80,5,4,2,IND,26,389,194,3,3.529460528035946,41.40769548747602,22.468578007755983,18.939117479720036
0.55,0.28571428600000004,39.16666667,11/23/2014,24,18,away,9,HOU,233,184,60,78,22,13,Win,139,64,0,1,1,CIN,35,372,248,1,-11.674630505169038,39.89741666037984,14.111393077605399,25.78602358277444
0.28571428600000004,0.55,20.83333333,11/23/2014,18,24,home,-9,CIN,184,233,15,65,13,22,Loss,64,139,1,0,1,HOU,35,248,372,1,11.674630505169038,39.89741666037984,25.78602358277444,14.1113930776054
0.41176470600000004,0.25,30.16666667,11/23/2014,17,12,away,-8,CHI,301,112,87,75,13,21,Loss,66,92,5,3,1,TBB,34,367,204,4,-13.856707892017374,34.9261935352425,10.53474282161256,24.391450713629936
0.25,0.41176470600000004,29.83333333,11/23/2014,12,17,home,8,TBB,112,301,45,56,21,13,Win,92,66,3,5,4,CHI,34,204,367,1,13.856707892017374,34.9261935352425,24.391450713629936,10.53474282161256
0.25,0.384615385,24.55,11/23/2014,12,16,away,-16,SEA,140,169,25,49,3,19,Loss,64,124,3,7,0,ARI,22,204,293,1,8.474589432427312,27.64274074784318,18.058665090135246,9.584075657707935
0.384615385,0.25,35.45,11/23/2014,16,12,home,16,ARI,169,140,74,58,19,3,Win,124,64,7,3,1,SEA,22,293,204,0,-8.474589432427312,27.64274074784318,9.584075657707935,18.058665090135246
0.428571429,0.333333333,28.85,11/23/2014,16,19,away,-3,LAC,210,282,90,61,24,27,Loss,107,128,1,3,3,LAR,51,317,410,3,-5.0731342185612185,48.5869070159819,21.756886398710343,26.830020617271558
0.333333333,0.428571429,31.15,11/23/2014,19,16,home,3,LAR,282,210,85,60,27,24,Win,128,107,3,1,3,LAC,51,410,317,3,5.0731342185612185,48.5869070159819,26.830020617271558,21.756886398710343
0.5,0.692307692,25.71666667,11/23/2014,25,29,away,-3,DEN,216,249,50,58,36,39,Loss,97,201,1,1,1,MIA,75,313,450,1,0.8084992047094826,56.39506040289914,28.601779803804313,27.793280599094828
0.692307692,0.5,34.28333333,11/23/2014,29,25,home,3,MIA,249,216,98,71,39,36,Win,201,97,1,1,1,DEN,75,450,313,1,-0.8084992047094826,56.39506040289914,27.793280599094828,28.601779803804313
0.153846154,0.384615385,29.91666667,11/23/2014,12,16,away,-4,SFO,77,246,53,52,13,17,Loss,136,66,5,2,3,WAS,30,213,312,1,-0.012768106164068538,31.607618641656927,15.79742526774643,15.810193373910497
0.384615385,0.153846154,30.08333333,11/23/2014,16,12,home,4,WAS,246,77,47,60,17,13,Win,66,136,2,5,1,SFO,30,312,213,3,0.012768106164068538,31.607618641656927,15.810193373910497,15.79742526774643
0.4,0.6875,24.88333333,11/23/2014,18,27,away,3,NYG,266,328,63,53,31,28,Win,119,89,2,2,1,DAL,59,385,417,1,-3.2514028291746566,53.10844114601668,24.92851915842101,28.17992198759567
0.6875,0.4,35.11666667,11/23/2014,27,18,home,-3,DAL,328,266,30,74,28,31,Loss,89,119,2,2,1,NYG,59,417,385,1,3.2514028291746566,53.10844114601668,28.17992198759567,24.92851915842101
0.2,0.538461538,29.1,11/24/2014,11,21,away,-35,BUF,126,220,60,57,3,38,Loss,92,116,7,1,0,NYJ,41,218,336,1,-0.3282395417237076,35.64217014622484,17.65696530225057,17.985204843974273
0.538461538,0.2,30.9,11/24/2014,21,11,home,35,NYJ,220,126,24,62,38,3,Win,116,92,1,7,1,BUF,41,336,218,0,0.3282395417237076,35.64217014622484,17.985204843974273,17.65696530225057
0.692307692,0.41666666700000005,30.25,11/24/2014,23,26,away,7,NOS,234,399,42,57,34,27,Win,215,126,1,4,1,BAL,61,449,525,1,8.523499830205846,59.48262107416829,34.00306045218707,25.47956062198122
0.41666666700000005,0.692307692,29.75,11/24/2014,26,23,home,-7,BAL,399,234,50,70,27,34,Loss,126,215,4,1,1,NOS,61,525,449,1,-8.523499830205846,59.48262107416829,25.47956062198122,34.00306045218707
0.41666666700000005,0.41666666700000005,26.58333333,11/27/2014,18,28,away,-17,DET,256,383,41,59,17,34,Loss,13,91,3,2,1,CHI,51,269,474,2,0.6729847483131053,50.964189171794175,25.81858696005364,25.145602211740535
0.41666666700000005,0.41666666700000005,33.41666667,11/27/2014,28,18,home,17,CHI,383,256,38,70,34,17,Win,91,13,2,3,2,DET,51,474,269,1,-0.6729847483131053,50.964189171794175,25.145602211740535,25.81858696005364
0.533333333,0.333333333,30.41666667,11/27/2014,26,16,away,23,DAL,208,174,20,75,33,10,Win,256,93,1,4,3,PHI,43,464,267,1,-1.6904098783636385,46.848245841102084,22.578917981369223,24.26932785973286
0.333333333,0.533333333,29.58333333,11/27/2014,16,26,home,-23,PHI,174,208,42,58,10,33,Loss,93,256,4,1,1,DAL,43,267,464,3,1.6904098783636385,46.848245841102084,24.26932785973286,22.578917981369223
0.35714285700000004,0.363636364,35.31666667,11/27/2014,16,16,away,16,SFO,222,100,105,60,19,3,Win,157,64,4,4,3,SEA,22,379,164,0,6.292050544689831,34.554000137987444,20.423025341338636,14.130974796648808
0.363636364,0.35714285700000004,24.68333333,11/27/2014,16,16,home,-16,SEA,100,222,20,51,3,19,Loss,64,157,4,4,0,SFO,22,164,379,3,-6.292050544689831,34.554000137987444,14.130974796648808,20.423025341338636
0.333333333,0.625,36.08333333,11/30/2014,24,19,away,-22,IND,341,361,78,74,27,49,Loss,84,126,6,1,3,WAS,76,425,487,1,-2.2174101088282985,58.97375477392009,28.378172332545898,30.595582441374194
0.625,0.333333333,23.91666667,11/30/2014,19,24,home,22,WAS,361,341,94,49,49,27,Win,126,84,1,6,1,IND,76,487,425,3,2.2174101088282985,58.97375477392009,30.595582441374194,28.378172332545898
0.333333333,0.647058824,26.73333333,11/30/2014,19,24,away,-24,HOU,237,358,66,56,21,45,Loss,83,99,3,0,1,TEN,66,320,457,4,-4.6097538058278715,55.829051784201184,25.609648989186656,30.219402795014528
0.647058824,0.333333333,33.26666667,11/30/2014,24,19,home,24,TEN,358,237,40,69,45,21,Win,99,83,0,3,4,HOU,66,457,320,1,4.6097538058278715,55.829051784201184,30.219402795014528,25.609648989186656
0.25,0.133333333,29.08333333,11/30/2014,19,15,away,-16,BUF,241,181,76,66,10,26,Loss,74,106,2,1,2,CLE,36,315,287,3,-2.381349388722266,36.34306549623818,16.98085805375796,19.362207442480223
0.133333333,0.25,30.91666667,11/30/2014,15,19,home,16,CLE,181,241,45,62,26,10,Win,106,74,1,2,3,BUF,36,287,315,2,2.381349388722266,36.34306549623818,19.362207442480223,16.98085805375796
0.818181818,0.583333333,29.81666667,11/30/2014,31,24,away,1,BAL,376,225,91,65,34,33,Win,64,125,2,0,0,LAC,67,440,350,2,-0.03809300524280301,58.69857060915993,29.330238801958565,29.368331807201365
0.583333333,0.818181818,30.18333333,11/30/2014,24,31,home,-1,LAC,225,376,98,63,33,34,Loss,125,64,0,2,2,BAL,67,350,440,0,0.03809300524280301,58.69857060915993,29.368331807201365,29.330238801958565
0.46666666700000003,0.25,34.65,11/30/2014,22,18,away,-1,JAX,213,140,40,73,24,25,Loss,116,118,4,7,0,NYG,49,329,258,3,-9.551893814893031,39.837541622645446,15.142823903876206,24.69471771876924
0.25,0.46666666700000003,25.35,11/30/2014,18,22,home,1,NYG,140,213,49,64,25,24,Win,118,116,7,4,3,JAX,49,258,329,0,9.551893814893031,39.837541622645446,24.69471771876924,15.142823903876208
0.454545455,0.181818182,30.61666667,11/30/2014,19,14,away,1,TBB,176,188,73,58,14,13,Win,112,75,2,1,1,CIN,27,288,263,3,0.13296321527996757,37.80241044646636,18.967686830873163,18.834723615593198
0.181818182,0.454545455,29.38333333,11/30/2014,14,19,home,-1,CIN,188,176,94,55,13,14,Loss,75,112,1,2,3,TBB,27,263,288,1,-0.13296321527996757,37.80241044646636,18.834723615593198,18.967686830873163
0.222222222,0.125,36.93333333,11/30/2014,17,17,away,-52,LAR,183,176,73,75,0,52,Loss,61,172,6,1,0,OAK,52,244,348,5,-4.233094766930343,40.85636741737677,18.311636325223212,22.544731092153555
0.125,0.222222222,23.06666667,11/30/2014,17,17,home,52,OAK,176,183,60,49,52,0,Win,172,61,1,6,5,LAR,52,348,244,0,4.233094766930343,40.85636741737677,22.544731092153555,18.311636325223212
0.4,0.428571429,26.01666667,11/30/2014,20,36,away,3,PIT,250,435,77,54,35,32,Win,143,103,1,1,2,NOS,67,393,538,0,3.581666443933838,58.55988228196312,31.07077436294848,27.48910791901464
0.428571429,0.4,33.98333333,11/30/2014,36,20,home,-3,NOS,435,250,28,82,32,35,Loss,103,143,1,1,0,PIT,67,538,393,2,-3.581666443933838,58.55988228196312,27.48910791901464,31.07077436294848
0.4375,0.363636364,35.8,11/30/2014,23,12,away,-18,MIN,170,118,35,72,13,31,Loss,178,92,4,3,0,CAR,44,348,210,1,-3.585845121158763,37.11049624838041,16.762325563610823,20.348170684769585
0.363636364,0.4375,24.2,11/30/2014,12,23,home,18,CAR,118,170,25,48,31,13,Win,92,178,3,4,1,MIN,44,210,348,0,3.585845121158763,37.11049624838041,20.348170684769585,16.762325563610823
0.14285714300000002,0.4375,22.95,11/30/2014,18,22,away,-11,ATL,294,358,34,50,18,29,Loss,35,142,0,1,1,ARI,47,329,500,3,2.439448804798868,47.050396722424466,24.74492276361167,22.305473958812797
0.4375,0.14285714300000002,37.05,11/30/2014,22,18,home,11,ARI,358,294,76,76,29,18,Win,142,35,1,0,3,ATL,47,500,329,1,-2.439448804798868,47.050396722424466,22.305473958812797,24.74492276361167
0.4,0.588235294,23.41666667,11/30/2014,20,24,away,-5,GBP,236,348,25,54,21,26,Loss,84,130,1,3,0,NEP,47,320,478,0,12.44316378996387,50.22458725448945,31.33387552222666,18.89071173226279
0.588235294,0.4,36.58333333,11/30/2014,24,20,home,5,NEP,348,236,22,70,26,21,Win,130,84,3,1,0,GBP,47,478,320,0,-12.44316378996387,50.22458725448945,18.89071173226279,31.33387552222666
0.428571429,0.111111111,38.78333333,11/30/2014,21,11,away,13,KCC,174,110,32,80,29,16,Win,214,41,1,6,3,DEN,45,388,151,1,2.2445260261568905,33.322287101463466,17.78340656381018,15.538880537653288
0.111111111,0.428571429,21.21666667,11/30/2014,11,21,home,-13,DEN,110,174,35,44,16,29,Loss,41,214,6,1,1,KCC,45,151,388,3,-2.2445260261568905,33.322287101463466,15.538880537653288,17.78340656381018
0.384615385,0.46666666700000003,27.41666667,12/1/2014,16,18,away,3,NYJ,217,49,20,55,16,13,Win,74,277,2,2,1,MIA,29,291,326,1,-0.5471075298773673,38.30396889559817,18.8784306828604,19.425538212737766
0.46666666700000003,0.384615385,32.58333333,12/1/2014,18,16,home,-3,MIA,49,217,57,64,13,16,Loss,277,74,2,2,1,NYJ,29,326,291,1,0.5471075298773673,38.30396889559817,19.425538212737766,18.8784306828604
0.5,0.2,32.46666667,12/4/2014,21,23,away,13,CHI,203,341,97,62,41,28,Win,194,35,1,0,2,DAL,69,397,376,0,-2.8545297156734986,47.56594387714162,22.35570708073406,25.21023679640756
0.2,0.5,27.53333333,12/4/2014,23,21,home,-13,DAL,341,203,54,61,28,41,Loss,35,194,0,1,0,CHI,69,376,397,2,2.8545297156734986,47.56594387714162,25.21023679640756,22.35570708073406
0.5,0.272727273,32.75,12/7/2014,25,16,away,21,CIN,350,322,20,70,42,21,Win,193,86,0,3,2,PIT,63,543,408,0,3.3986626025279776,52.85386466040851,28.126263631468245,24.727601028940267
0.272727273,0.5,27.25,12/7/2014,16,25,home,-21,PIT,322,350,54,59,21,42,Loss,86,193,3,0,0,CIN,63,408,543,2,-3.3986626025279776,52.85386466040851,24.727601028940267,28.126263631468245
0.5,0.25,32.81666667,12/7/2014,19,13,away,24,WAS,198,179,98,56,24,0,Win,131,27,4,7,2,LAR,24,329,206,0,-3.464722184356237,35.70814581496083,16.121711815302298,19.58643399965853
0.25,0.5,27.18333333,12/7/2014,13,19,home,-24,LAR,179,198,51,55,0,24,Loss,27,131,7,4,0,WAS,24,206,329,2,3.464722184356237,35.70814581496083,19.58643399965853,16.121711815302298
0.444444444,0.153846154,34.71666667,12/7/2014,19,12,away,29,TEN,260,146,70,73,36,7,Win,142,61,0,8,3,NYG,43,402,207,1,-9.710473362768994,38.38010230502573,14.334814471128368,24.045287833897362
0.153846154,0.444444444,25.28333333,12/7/2014,12,19,home,-29,NYG,146,260,39,57,7,36,Loss,61,142,8,0,1,TEN,43,207,402,3,9.710473362768994,38.38010230502573,24.045287833897362,14.334814471128368
0.46666666700000003,0.35714285700000004,36.0,12/7/2014,24,18,away,31,NOS,226,218,55,73,41,10,Win,271,92,0,2,2,CAR,51,497,310,0,-11.967573982859598,48.17383705264248,18.103131534891443,30.07070551775104
0.35714285700000004,0.46666666700000003,24.0,12/7/2014,18,24,home,-31,CAR,218,226,30,68,10,41,Loss,92,271,2,0,0,NOS,51,310,497,2,11.967573982859598,48.17383705264248,30.07070551775104,18.103131534891443
0.470588235,0.5,35.86666667,12/7/2014,19,19,away,-6,MIN,242,297,40,74,0,6,Loss,168,114,3,3,2,NYJ,6,410,411,2,-5.857264762326133,49.17950883647858,21.661122037076225,27.518386799402357
0.5,0.470588235,28.78333333,12/7/2014,19,19,home,6,NYJ,297,242,70,58,6,0,Win,114,168,3,3,2,MIN,6,411,410,2,5.857264762326133,49.17950883647858,27.518386799402357,21.661122037076225
0.41666666700000005,0.333333333,30.3,12/7/2014,26,16,away,15,MIA,264,186,36,65,28,13,Win,183,63,1,6,0,BAL,41,447,249,1,10.870666220908072,41.15778144710701,26.01422383400754,15.143557613099471
0.333333333,0.41666666700000005,29.7,12/7/2014,16,26,home,-15,BAL,186,264,30,55,13,28,Loss,63,183,6,1,1,MIA,41,249,447,0,-10.870666220908072,41.15778144710701,15.143557613099471,26.01422383400754
0.3125,0.26666666699999997,28.06666667,12/7/2014,23,14,away,1,CLE,269,133,40,76,25,24,Win,93,115,3,1,2,IND,49,362,248,4,-8.075547825854851,38.447279777201864,15.185865975673508,23.261413801528356
0.26666666699999997,0.3125,31.93333333,12/7/2014,14,23,home,-1,IND,133,269,85,63,24,25,Loss,115,93,1,3,4,CLE,49,248,362,2,8.075547825854851,38.447279777201864,23.261413801528356,15.185865975673506
0.28571428600000004,0.46666666700000003,23.41666667,12/7/2014,15,22,away,-17,DET,207,294,50,59,17,34,Loss,26,113,6,4,1,TBB,51,233,407,3,-7.719441514937557,43.04634411512361,17.663451300093026,25.382892815030583
0.46666666700000003,0.28571428600000004,36.58333333,12/7/2014,22,15,home,17,TBB,294,207,122,69,34,17,Win,113,26,4,6,3,DET,51,407,233,1,7.719441514937557,43.04634411512361,25.382892815030583,17.663451300093026
0.214285714,0.333333333,32.48333333,12/7/2014,19,17,away,14,JAX,135,188,64,63,27,13,Win,169,74,1,4,1,HOU,40,304,262,0,-10.639428209426896,34.732822856040144,12.046697323306624,22.68612553273352
0.333333333,0.214285714,27.51666667,12/7/2014,17,19,home,-14,HOU,188,135,40,66,13,27,Loss,74,169,4,1,0,JAX,40,262,304,1,10.639428209426896,34.732822856040144,22.68612553273352,12.046697323306624
0.5625,0.4,33.48333333,12/7/2014,24,15,away,-7,DEN,341,173,98,77,17,24,Loss,74,133,4,0,3,BUF,41,415,306,3,-0.15553377524072864,53.637067982202,26.740767103480636,26.896300878721362
0.4,0.5625,26.51666667,12/7/2014,15,24,home,7,BUF,173,341,45,49,24,17,Win,133,74,0,4,3,DEN,41,306,415,3,0.15553377524072864,53.637067982202,26.896300878721362,26.740767103480636
0.428571429,0.4,29.98333333,12/7/2014,19,18,away,-3,ARI,264,225,75,61,14,17,Loss,126,141,5,2,0,KCC,31,390,366,2,-2.11587240488198,42.07145188874472,19.977789741931367,22.09366214681335
0.4,0.428571429,30.01666667,12/7/2014,18,19,home,3,KCC,225,264,40,65,17,14,Win,141,126,2,5,2,ARI,31,366,390,0,2.11587240488198,42.07145188874472,22.09366214681335,19.977789741931367
0.4375,0.181818182,41.93333333,12/7/2014,28,9,away,10,PHI,252,82,67,85,24,14,Win,188,57,2,3,2,SEA,38,440,139,2,-0.5125062350681606,38.505941095933665,18.996717430432753,19.50922366550091
0.181818182,0.4375,18.06666667,12/7/2014,9,28,home,-10,SEA,82,252,69,45,14,24,Loss,57,188,3,2,2,PHI,38,139,440,2,0.5125062350681606,38.505941095933665,19.50922366550091,18.996717430432753
0.272727273,0.46153846200000004,27.08333333,12/7/2014,18,19,away,-11,OAK,151,245,50,56,13,24,Loss,97,85,5,1,0,SFO,37,248,330,2,0.07351039263587822,42.01657863653169,21.045044514583786,20.971534121947904
0.46153846200000004,0.272727273,32.91666667,12/7/2014,19,18,home,11,SFO,245,151,84,60,24,13,Win,85,97,1,5,2,OAK,37,330,248,0,-0.07351039263587822,42.01657863653169,20.971534121947904,21.045044514583786
0.4375,0.307692308,34.55,12/7/2014,24,13,away,9,LAC,310,163,70,73,23,14,Win,87,53,1,4,1,NEP,37,397,216,2,3.442784213185358,38.871811754630016,21.157297983907686,17.71451377072233
0.307692308,0.4375,25.45,12/7/2014,13,24,home,-9,NEP,163,310,61,54,14,23,Loss,53,87,4,1,2,LAC,37,216,397,1,-3.442784213185358,38.871811754630016,17.71451377072233,21.157297983907686
0.454545455,0.583333333,26.98333333,12/8/2014,26,28,away,-6,GBP,374,323,11,64,37,43,Loss,91,179,1,1,0,ATL,80,465,502,1,5.495249210072412,60.85691711140179,33.1760831607371,27.68083395066469
0.583333333,0.454545455,33.01666667,12/8/2014,28,26,home,6,ATL,323,374,40,67,43,37,Win,179,91,1,1,1,GBP,80,502,465,0,-5.495249210072412,60.85691711140179,27.68083395066469,33.1760831607371
0.294117647,0.26666666699999997,34.4,12/11/2014,13,13,away,6,LAR,131,211,59,64,12,6,Win,143,69,1,2,2,ARI,18,274,280,0,-10.24581825869815,29.384555745433005,9.569368743367427,19.815187002065578
0.26666666699999997,0.294117647,25.6,12/11/2014,13,13,home,-6,ARI,211,131,69,61,6,12,Loss,69,143,2,1,0,LAR,18,280,274,2,10.24581825869815,29.384555745433005,19.815187002065578,9.569368743367427
0.545454545,0.545454545,30.71666667,12/14/2014,22,20,away,7,ATL,353,310,34,58,27,20,Win,45,97,1,0,1,PIT,47,398,407,0,7.058843382684572,50.68496565694191,28.871904519813242,21.81306113712867
0.545454545,0.545454545,29.28333333,12/14/2014,20,22,home,-7,PIT,310,353,25,57,20,27,Loss,97,45,0,1,0,ATL,47,407,398,1,-7.058843382684572,50.68496565694191,21.81306113712867,28.871904519813242
0.28571428600000004,0.307692308,32.51666667,12/14/2014,21,17,away,-11,NYG,228,238,135,68,13,24,Loss,144,49,7,1,1,WAS,37,372,287,1,-9.115288513376218,41.35605349807957,16.120382492351673,25.235671005727895
0.307692308,0.28571428600000004,27.48333333,12/14/2014,17,21,home,11,WAS,238,228,60,57,24,13,Win,49,144,1,7,1,NYG,37,287,372,1,9.115288513376218,41.35605349807957,25.235671005727895,16.120382492351673
0.1875,0.615384615,33.76666667,12/14/2014,23,23,away,-28,NEP,308,287,35,74,13,41,Loss,76,108,4,0,1,MIA,54,384,395,2,5.307771702122832,47.60643195968049,26.457101830901664,21.14933012877883
0.615384615,0.1875,26.23333333,12/14/2014,23,23,home,28,MIA,287,308,51,64,41,13,Win,108,76,0,4,2,NEP,54,395,384,1,-5.307771702122832,47.60643195968049,21.14933012877883,26.457101830901664
0.27777777800000003,0.23076923100000002,30.0,12/14/2014,17,16,away,-18,KCC,202,295,75,77,13,31,Loss,78,93,4,1,1,OAK,44,280,388,1,-13.12940251397614,39.037447367972774,12.954022426998318,26.083424940974457
0.23076923100000002,0.27777777800000003,30.0,12/14/2014,16,17,home,18,OAK,295,202,84,59,31,13,Win,93,78,1,4,1,KCC,44,388,280,1,13.12940251397614,39.037447367972774,26.083424940974457,12.954022426998318
0.3125,0.166666667,31.08333333,12/14/2014,14,20,away,-7,IND,152,168,66,67,10,17,Loss,137,110,1,2,2,HOU,27,289,278,2,-8.020145866013143,36.18888563401734,14.084369884002097,22.104515750015242
0.166666667,0.3125,28.91666667,12/14/2014,20,14,home,7,HOU,168,152,45,64,17,10,Win,110,137,2,1,2,IND,27,278,289,2,8.020145866013143,36.18888563401734,22.104515750015242,14.084369884002097
0.27777777800000003,0.333333333,31.7,12/14/2014,13,17,away,-8,BAL,166,221,60,69,12,20,Loss,82,93,8,0,1,JAX,32,248,314,1,-3.2150884981603642,32.67365481971666,14.729283160778149,17.94437165893851
0.333333333,0.27777777800000003,28.3,12/14/2014,17,13,home,8,JAX,221,166,70,56,20,12,Win,93,82,0,8,1,BAL,32,314,248,1,3.2150884981603642,32.67365481971666,17.94437165893851,14.729283160778149
0.28571428600000004,0.25,27.03333333,12/14/2014,21,13,away,-8,BUF,175,140,70,67,13,21,Loss,158,113,1,3,1,GBP,34,333,253,2,-5.67934978920621,37.886865364926535,16.10375778786016,21.783107577066374
0.25,0.28571428600000004,32.96666667,12/14/2014,13,21,home,8,GBP,140,175,75,63,21,13,Win,113,158,3,1,2,BUF,34,253,333,1,5.67934978920621,37.886865364926535,21.783107577066374,16.10375778786016
0.41666666700000005,0.384615385,22.61666667,12/14/2014,15,28,away,-2,CAR,136,269,29,54,17,19,Loss,151,123,3,3,1,TBB,36,287,392,3,-6.304910704579161,46.61881715202991,20.156953223725374,26.46186392830454
0.384615385,0.41666666700000005,37.38333333,12/14/2014,28,15,home,2,TBB,269,136,25,75,19,17,Win,123,151,3,3,3,CAR,36,392,287,1,6.304910704579161,46.61881715202991,26.46186392830454,20.156953223725374
0.5,0.1,38.86666667,12/14/2014,24,5,away,30,CLE,103,54,41,71,30,0,Win,244,53,2,3,2,CIN,30,347,107,1,5.49819384186106,27.978747815956876,16.738470828908966,11.240276987047908
0.1,0.5,21.13333333,12/14/2014,5,24,home,-30,CIN,54,103,68,38,0,30,Loss,53,244,3,2,1,CLE,30,107,347,2,-5.49819384186106,27.978747815956876,11.24027698704791,16.738470828908966
0.153846154,0.375,30.05,12/14/2014,17,17,away,5,TEN,163,253,46,60,16,11,Win,114,89,3,1,1,NYJ,27,277,342,0,-6.202658345807347,36.89541735416517,15.346379504178913,21.549037849986256
0.375,0.153846154,29.95,12/14/2014,17,17,home,-5,NYJ,253,163,76,64,11,16,Loss,89,114,1,3,0,TEN,27,342,277,1,6.202658345807347,36.89541735416517,21.549037849986256,15.34637950417891
0.25,0.46153846200000004,32.73333333,12/14/2014,18,20,away,12,LAC,226,232,71,61,22,10,Win,111,56,1,0,2,DEN,32,337,288,0,-0.5835987888532266,41.75217806588143,20.5842896385141,21.16788842736733
0.46153846200000004,0.25,27.26666667,12/14/2014,20,18,home,-12,DEN,232,226,65,61,10,22,Loss,56,111,0,1,0,LAC,32,288,337,2,0.5835987888532266,41.75217806588143,21.16788842736733,20.5842896385141
0.363636364,0.181818182,34.71666667,12/14/2014,21,11,away,-2,DET,284,153,25,66,14,16,Loss,76,80,4,0,0,MIN,30,360,233,2,4.393916993025107,36.80217106658384,20.598044029804473,16.204127036779365
0.181818182,0.363636364,25.28333333,12/14/2014,11,21,home,2,MIN,153,284,35,50,16,14,Win,80,76,0,4,2,DET,30,233,360,0,-4.393916993025107,36.80217106658384,16.204127036779365,20.598044029804473
0.4,0.571428571,31.03333333,12/14/2014,14,18,away,-10,SEA,105,138,78,57,7,17,Loss,140,152,6,5,1,SFO,24,245,290,0,-0.9993834714964738,32.279642596478375,15.640129562490952,16.639513033987424
0.571428571,0.4,28.96666667,12/14/2014,18,14,home,10,SFO,138,105,50,61,17,7,Win,152,140,5,6,0,SEA,24,290,245,1,0.9993834714964738,32.279642596478375,16.639513033987424,15.640129562490952
0.384615385,0.454545455,41.91666667,12/14/2014,26,19,away,11,PHI,249,219,79,76,38,27,Win,115,75,3,4,3,DAL,65,364,294,1,-1.4618685099447086,47.87459810749209,23.20636479877369,24.6682333087184
0.454545455,0.384615385,18.08333333,12/14/2014,19,26,home,-11,DAL,219,249,95,53,27,38,Loss,75,115,4,3,1,PHI,65,294,364,3,1.4618685099447086,47.87459810749209,24.6682333087184,23.20636479877369
0.363636364,0.166666667,33.51666667,12/15/2014,25,16,away,16,CHI,360,153,25,64,31,15,Win,83,125,2,7,3,NOS,46,443,278,1,6.4251424404767015,45.241559000860846,25.833350720668776,19.40820828019207
0.166666667,0.363636364,26.48333333,12/15/2014,16,25,home,-16,NOS,153,360,74,58,15,31,Loss,125,83,7,2,1,CHI,46,278,443,3,-6.4251424404767015,45.241559000860846,19.40820828019207,25.833350720668776
0.46666666700000003,0.384615385,34.86666667,12/18/2014,19,17,away,-8,JAX,262,111,47,67,13,21,Loss,95,177,4,4,0,TEN,34,357,288,0,-6.9783103844284256,39.575175527819894,16.298432571695734,23.27674295612416
0.384615385,0.46666666700000003,25.13333333,12/18/2014,17,19,home,8,TEN,111,262,25,56,21,13,Win,177,95,4,4,0,JAX,34,288,357,0,6.9783103844284256,39.575175527819894,23.27674295612416,16.298432571695734
0.5625,0.222222222,32.06666667,12/20/2014,30,21,away,-3,WAS,361,205,102,84,24,27,Loss,134,100,3,2,2,PHI,51,495,305,2,-3.6553992146015277,54.167358648666216,25.255979717032343,28.911378931633873
0.222222222,0.5625,27.93333333,12/20/2014,21,30,home,3,PHI,205,361,15,54,27,24,Win,100,134,2,3,2,WAS,51,305,495,2,3.6553992146015277,54.167358648666216,28.911378931633873,25.255979717032343
0.5,0.454545455,34.31666667,12/20/2014,28,21,away,3,SFO,348,92,38,80,3,0,Win,98,355,2,2,3,LAC,3,446,447,3,-10.581843442761643,52.706789430608495,21.062472993923425,31.64431643668507
0.454545455,0.5,30.58333333,12/20/2014,21,28,home,-3,LAC,92,348,92,66,0,3,Loss,355,98,2,2,3,SFO,3,447,446,3,10.581843442761643,52.706789430608495,31.64431643668507,21.062472993923425
0.583333333,0.692307692,26.9,12/21/2014,20,36,away,-2,MIA,238,383,74,58,35,37,Loss,119,110,4,1,2,MIN,72,357,493,1,-1.386270314298704,60.66944245197003,29.64158606883566,31.027856383134367
0.692307692,0.583333333,33.1,12/21/2014,36,20,home,2,MIN,383,238,54,77,37,35,Win,110,119,1,4,1,MIA,72,493,357,2,1.386270314298704,60.66944245197003,31.027856383134367,29.64158606883566
0.26666666699999997,0.333333333,25.03333333,12/21/2014,15,18,away,-12,HOU,178,190,56,68,13,25,Loss,33,123,2,0,1,BAL,38,211,313,3,-17.335202620347857,30.890378448531393,6.777587914091768,24.112790534439625
0.333333333,0.26666666699999997,34.96666667,12/21/2014,18,15,home,12,BAL,190,178,69,81,25,13,Win,123,33,0,2,3,HOU,38,313,211,1,17.335202620347857,30.890378448531393,24.112790534439625,6.777587914091768
0.384615385,0.333333333,31.93333333,12/21/2014,22,17,away,6,CHI,229,170,60,69,20,14,Win,138,64,4,2,1,DET,34,367,234,3,-7.9689938657951,41.32136977488217,16.676187954543536,24.645181820338635
0.333333333,0.384615385,28.06666667,12/21/2014,17,22,home,-6,DET,170,229,86,63,14,20,Loss,64,138,2,4,3,CHI,34,234,367,1,7.9689938657951,41.32136977488217,24.645181820338635,16.676187954543536
0.25,0.5625,21.95,12/21/2014,8,27,away,-4,CAR,144,195,49,46,13,17,Loss,84,209,3,1,2,CLE,30,228,404,1,-6.745186649789998,40.26924499826293,16.762029174236464,23.507215824026463
0.5625,0.25,38.05,12/21/2014,27,8,home,4,CLE,195,144,49,77,17,13,Win,209,84,1,3,1,CAR,30,404,228,2,6.745186649789998,40.26924499826293,23.507215824026463,16.762029174236464
0.46666666700000003,0.5,32.15,12/21/2014,18,22,away,16,NOS,322,271,64,62,30,14,Win,81,57,0,5,4,ATL,44,403,328,0,-1.3707078471723975,46.65537114787523,22.642331650351416,24.013039497523813
0.5,0.46666666700000003,27.85,12/21/2014,22,18,home,-16,ATL,271,322,25,70,14,30,Loss,57,81,5,0,0,NOS,44,328,403,4,1.3707078471723975,46.65537114787523,24.013039497523813,22.642331650351416
0.46153846200000004,0.28571428600000004,38.63333333,12/21/2014,23,6,away,17,TBB,310,93,40,72,20,3,Win,121,16,1,7,1,GBP,23,431,109,1,-2.227985767681915,34.53351039949143,16.15276231590476,18.380748083586674
0.28571428600000004,0.46153846200000004,21.36666667,12/21/2014,6,23,home,-17,GBP,93,310,30,47,3,20,Loss,16,121,7,1,1,TBB,23,109,431,1,2.227985767681915,34.53351039949143,18.380748083586674,16.15276231590476
0.428571429,0.5,31.11666667,12/21/2014,22,19,away,-8,PIT,288,214,39,66,12,20,Loss,39,68,6,1,0,KCC,32,327,282,1,5.252027728719092,40.593916557078025,22.92297214289856,17.670944414179466
0.5,0.428571429,28.88333333,12/21/2014,19,22,home,8,KCC,214,288,40,52,20,12,Win,68,39,1,6,1,PIT,32,282,327,0,-5.252027728719092,40.593916557078025,17.670944414179466,22.92297214289856
0.46153846200000004,0.384615385,27.65,12/21/2014,19,16,away,1,NYJ,146,191,38,63,17,16,Win,85,116,4,2,1,NEP,33,231,307,1,6.507390101667666,35.27277585479535,20.890082978231508,14.38269287656384
0.384615385,0.46153846200000004,32.35,12/21/2014,16,19,home,-1,NEP,191,146,14,61,16,17,Loss,116,85,2,4,1,NYJ,33,307,231,1,-6.507390101667666,35.27277585479535,14.38269287656384,20.890082978231508
0.470588235,0.166666667,34.78333333,12/21/2014,19,23,away,10,LAR,386,281,149,67,37,27,Win,128,106,1,2,3,NYG,64,514,387,0,-3.763992111322617,57.607437253285866,26.921722570981625,30.68571468230424
0.166666667,0.470588235,25.21666667,12/21/2014,23,19,home,-10,NYG,281,386,76,54,27,37,Loss,106,128,2,1,0,LAR,64,387,514,3,3.763992111322617,57.607437253285866,30.68571468230424,26.921722570981625
0.26666666699999997,0.3125,26.21666667,12/21/2014,15,18,away,-2,OAK,308,207,55,64,24,26,Loss,13,140,2,1,0,BUF,50,321,347,2,-10.163127883639177,41.793106957638805,15.814989536999814,25.97811742063899
0.3125,0.26666666699999997,33.78333333,12/21/2014,18,15,home,2,BUF,207,308,35,71,26,24,Win,140,13,1,2,2,OAK,50,347,321,0,10.163127883639177,41.793106957638805,25.97811742063899,15.814989536999814
0.384615385,0.5,24.51666667,12/21/2014,17,25,away,-35,DAL,228,250,55,56,7,42,Loss,1,127,2,1,1,IND,49,229,377,3,3.1527683142997702,45.6588363291398,24.405802321719786,21.253034007420016
0.5,0.384615385,35.48333333,12/21/2014,25,17,home,35,IND,250,228,67,62,42,7,Win,127,1,1,2,3,DAL,49,377,229,1,-3.1527683142997702,45.6588363291398,21.253034007420016,24.405802321719786
0.41666666700000005,0.2,33.05,12/21/2014,23,17,away,29,ARI,329,187,97,67,35,6,Win,267,29,1,4,1,SEA,41,596,216,0,-0.10978623131725485,41.62578977261633,20.758001770649535,20.867788001966794
0.2,0.41666666700000005,26.95,12/21/2014,17,23,home,-29,SEA,187,329,5,64,6,35,Loss,29,267,4,1,0,ARI,41,216,596,1,0.10978623131725485,41.62578977261633,20.867788001966794,20.758001770649535
0.41666666700000005,0.181818182,28.36666667,12/22/2014,22,20,away,-9,CIN,300,146,72,65,28,37,Loss,85,207,2,0,2,DEN,65,385,353,4,6.130046499245434,49.913254788851404,28.02165064404842,21.891604144802983
0.181818182,0.41666666700000005,31.63333333,12/22/2014,20,22,home,9,DEN,146,300,45,62,37,28,Win,207,85,0,2,4,CIN,65,353,385,2,-6.130046499245434,49.913254788851404,21.891604144802983,28.02165064404842
0.23076923100000002,0.307692308,30.71666667,12/28/2014,16,22,away,-10,BAL,150,290,58,61,10,20,Loss,109,129,4,1,0,CLE,30,259,419,2,3.516930455185591,36.40550788826235,19.961219171723968,16.44428871653838
0.307692308,0.23076923100000002,29.28333333,12/28/2014,22,16,home,10,CLE,290,150,55,65,20,10,Win,129,109,1,4,2,BAL,30,419,259,0,-3.516930455185591,36.40550788826235,16.44428871653838,19.961219171723968
0.333333333,0.333333333,30.4,12/28/2014,20,20,away,27,WAS,299,309,48,61,44,17,Win,174,104,0,3,4,DAL,61,473,413,1,-7.66824654283166,51.16070062833833,21.746227042753336,29.414473585584997
0.333333333,0.333333333,29.6,12/28/2014,20,20,home,-27,DAL,309,299,101,68,17,44,Loss,104,174,3,0,1,WAS,61,413,473,4,7.66824654283166,51.16070062833833,29.414473585584997,21.746227042753336
0.3125,0.25,33.43333333,12/28/2014,16,9,away,17,TEN,314,50,20,66,27,10,Win,64,142,1,4,1,IND,37,378,192,0,-6.632741676430728,30.07593330194434,11.721595812756807,18.354337489187532
0.25,0.3125,26.56666667,12/28/2014,9,16,home,-17,IND,50,314,20,59,10,27,Loss,142,64,4,1,0,TEN,37,192,378,1,6.632741676430728,30.07593330194434,18.354337489187532,11.721595812756807
0.0,0.5555555560000001,20.2,12/28/2014,13,24,away,-6,HOU,112,235,25,53,17,23,Loss,121,123,5,3,2,JAX,40,233,358,0,-8.120573034002765,36.6922355314115,14.285831248704365,22.406404282707133
0.5555555560000001,0.0,39.8,12/28/2014,24,13,home,6,JAX,235,112,55,77,23,17,Win,123,121,3,5,0,HOU,40,358,233,2,8.120573034002765,36.6922355314115,22.406404282707133,14.285831248704365
0.181818182,0.166666667,31.35,12/28/2014,21,15,away,-12,KCC,249,140,67,66,7,19,Loss,112,111,7,4,0,LAC,26,361,251,3,2.346609208510456,33.73724309084012,18.041926149675287,15.69531694116483
0.166666667,0.181818182,28.65,12/28/2014,15,21,home,12,LAC,140,249,46,57,19,7,Win,111,112,4,7,3,KCC,26,251,361,0,-2.346609208510456,33.73724309084012,15.69531694116483,18.041926149675287
0.428571429,0.307692308,31.26666667,12/28/2014,18,23,away,13,MIA,390,208,40,62,37,24,Win,104,179,1,7,1,NYJ,61,494,387,1,2.023245235477834,50.322524850543054,26.172885043010446,24.14963980753261
0.307692308,0.428571429,28.73333333,12/28/2014,23,18,home,-13,NYJ,208,390,40,66,24,37,Loss,179,104,7,1,1,MIA,61,387,494,1,-2.023245235477834,50.322524850543054,24.14963980753261,26.172885043010446
0.26666666699999997,0.533333333,31.55,12/28/2014,12,15,away,-4,MIN,165,190,50,59,9,13,Loss,99,121,2,3,1,CHI,22,264,311,0,-6.320631403822835,32.823816604576365,13.251592600376764,19.5722240041996
0.533333333,0.26666666699999997,28.45,12/28/2014,15,12,home,4,CHI,190,165,25,61,13,9,Win,121,99,3,2,0,MIN,22,311,264,1,6.320631403822835,32.823816604576365,19.5722240041996,13.251592600376764
0.454545455,0.333333333,29.05,12/28/2014,16,14,away,8,NEP,164,144,44,58,17,9,Win,104,116,2,4,0,BUF,26,268,260,1,4.549425780045013,32.37227073033438,18.460848255189696,13.911422475144683
0.333333333,0.454545455,30.95,12/28/2014,14,16,home,-8,BUF,144,164,55,62,9,17,Loss,116,104,4,2,1,NEP,26,260,268,0,-4.549425780045013,32.37227073033438,13.911422475144683,18.460848255189696
0.4375,0.38888888899999996,25.38333333,12/28/2014,23,22,away,8,NYG,262,429,35,72,34,26,Win,164,76,4,0,1,PHI,60,426,505,1,-12.817530978340496,56.46247841852577,21.82247372009264,34.64000469843313
0.38888888899999996,0.4375,34.61666667,12/28/2014,22,23,home,-8,PHI,429,262,106,78,26,34,Loss,76,164,0,4,1,NYG,60,505,426,1,12.817530978340496,56.46247841852577,34.64000469843313,21.82247372009264
0.5,0.529411765,27.21666667,12/28/2014,20,18,away,3,TBB,268,97,15,63,23,20,Win,70,183,2,3,1,NOS,43,338,280,3,-3.97737839983081,41.80025070008535,18.91143615012727,22.88881454995808
0.529411765,0.5,32.78333333,12/28/2014,18,20,home,-3,NOS,97,268,23,65,20,23,Loss,183,70,3,2,3,TBB,43,280,338,1,3.97737839983081,41.80025070008535,22.88881454995808,18.91143615012727
0.4,0.4375,31.21666667,12/28/2014,17,16,away,31,ATL,112,225,36,52,34,3,Win,194,63,1,6,3,CAR,37,306,288,0,-4.149412925062897,38.37168392194977,17.111135498443435,21.260548423506332
0.4375,0.4,28.78333333,12/28/2014,16,17,home,-31,CAR,225,112,36,69,3,34,Loss,63,194,6,1,0,ATL,37,288,306,3,4.149412925062897,38.37168392194977,21.260548423506332,17.111135498443435
0.363636364,0.615384615,25.7,12/28/2014,23,24,away,-10,GBP,202,225,53,66,20,30,Loss,111,152,2,1,2,DET,50,313,377,1,1.3869510403815521,51.54536865060117,26.46615984549136,25.079208805109808
0.615384615,0.363636364,34.3,12/28/2014,24,23,home,10,DET,225,202,40,62,30,20,Win,152,111,1,2,1,GBP,50,377,313,2,-1.3869510403815521,51.54536865060117,25.079208805109808,26.46615984549136
0.333333333,0.46666666700000003,26.98333333,12/28/2014,10,25,away,-33,DEN,132,309,86,57,14,47,Loss,67,142,3,1,1,OAK,61,199,451,2,-6.710748897151625,45.435842694629606,19.36254689873899,26.073295795890616
0.46666666700000003,0.333333333,33.01666667,12/28/2014,25,10,home,33,OAK,309,132,16,74,47,14,Win,142,67,1,3,2,DEN,61,451,199,1,6.710748897151625,45.435842694629606,26.073295795890616,19.36254689873899
0.4,0.41666666700000005,30.6,12/28/2014,26,18,away,-3,SFO,299,189,21,67,17,20,Loss,98,206,2,1,0,ARI,37,397,395,3,1.0300703652390073,47.56107727271042,24.295573818974713,23.265503453735707
0.41666666700000005,0.4,29.4,12/28/2014,18,26,home,3,ARI,189,299,78,60,20,17,Win,206,98,1,2,3,SFO,37,395,397,0,-1.0300703652390073,47.56107727271042,23.265503453735707,24.295573818974713
0.25,0.46666666700000003,28.81666667,12/28/2014,15,16,away,-14,SEA,203,222,45,60,6,20,Loss,42,132,4,3,2,LAR,26,245,354,3,0.8800446387798253,38.25283850255404,19.56644157066693,18.68639693188711
0.46666666700000003,0.25,31.18333333,12/28/2014,16,15,home,14,LAR,222,203,20,62,20,6,Win,132,42,3,4,3,SEA,26,354,245,2,-0.8800446387798253,38.25283850255404,18.68639693188711,19.56644157066693
0.428571429,0.272727273,34.96666667,12/28/2014,19,18,away,-10,PIT,221,317,45,70,17,27,Loss,116,29,3,0,3,CIN,44,337,346,3,5.1185169217663375,44.759583503754655,24.939050212760495,19.82053329099416
0.272727273,0.428571429,25.03333333,12/28/2014,18,19,home,10,CIN,317,221,10,57,27,17,Win,29,116,0,3,3,PIT,44,346,337,3,-5.1185169217663375,44.759583503754655,19.82053329099416,24.939050212760495
0.25,0.333333333,22.9,1/3/2015,8,25,away,-11,CAR,51,198,38,47,16,27,Loss,27,188,4,1,3,ARI,43,78,386,3,-3.6563348321858697,35.075266411545485,15.709465789679808,19.365800621865677
0.333333333,0.25,37.1,1/3/2015,25,8,home,11,ARI,198,51,80,74,27,16,Win,188,27,1,4,3,CAR,43,386,78,3,3.6563348321858697,35.075266411545485,19.365800621865677,15.709465789679808
0.363636364,0.3125,24.71666667,1/3/2015,19,22,away,13,PIT,246,319,14,55,30,17,Win,53,68,1,5,3,BAL,47,299,387,1,5.85554407048949,43.832138201240234,24.843841135864864,18.98829706537537
0.3125,0.363636364,35.28333333,1/3/2015,22,19,home,-13,BAL,319,246,114,72,17,30,Loss,68,53,5,1,1,PIT,47,387,299,3,-5.85554407048949,43.832138201240234,18.98829706537537,24.843841135864864
0.4,0.428571429,25.83333333,1/4/2015,14,22,away,-16,IND,144,368,45,59,10,26,Loss,110,114,3,1,1,CIN,36,254,482,1,-2.0186943889876936,44.42537616869118,21.203340889851745,23.222035278839435
0.428571429,0.4,34.16666667,1/4/2015,22,14,home,16,CIN,368,144,66,70,26,10,Win,114,110,1,3,1,IND,36,482,254,1,2.0186943889876936,44.42537616869118,23.222035278839435,21.203340889851745
0.363636364,0.428571429,29.55,1/4/2015,19,18,away,-4,DAL,307,242,44,67,20,24,Loss,90,73,3,6,1,DET,44,397,315,3,0.15571075982226645,45.050440721455296,22.60307574063878,22.447364980816516
0.428571429,0.363636364,30.45,1/4/2015,18,19,home,4,DET,242,307,46,58,24,20,Win,73,90,6,3,3,DAL,44,315,397,1,-0.15571075982226645,45.050440721455296,22.447364980816516,22.60307574063878
0.111111111,0.545454545,32.65,1/10/2015,28,29,away,-4,NEP,292,408,65,73,31,35,Loss,136,14,0,2,1,BAL,66,428,422,2,13.53369915526778,54.194013375713205,33.86385626549049,20.330157110222714
0.545454545,0.111111111,27.35,1/10/2015,29,28,home,4,BAL,408,292,60,66,35,31,Win,14,136,2,0,2,NEP,66,422,428,1,-13.53369915526778,54.194013375713205,20.330157110222714,33.86385626549049
0.5625,0.538461538,34.05,1/10/2015,21,16,away,-14,SEA,230,248,35,68,17,31,Loss,132,100,2,2,0,CAR,48,362,348,3,-2.3746162355813354,48.82976790094039,23.227575832679527,25.602192068260862
0.538461538,0.5625,25.95,1/10/2015,16,21,home,14,CAR,248,230,60,52,31,17,Win,100,132,2,2,3,SEA,48,348,362,0,2.3746162355813354,48.82976790094039,25.602192068260862,23.227575832679527
0.5,0.642857143,30.65,1/11/2015,21,23,away,-5,GBP,170,297,35,51,21,26,Loss,145,119,4,2,1,DAL,47,315,416,1,3.213625846997591,51.66803435957833,27.44083010328796,24.227204256290367
0.642857143,0.5,29.35,1/11/2015,23,21,home,5,DAL,297,170,87,66,26,21,Win,119,145,2,4,1,GBP,47,416,315,1,-3.213625846997591,51.66803435957833,24.227204256290367,27.44083010328796
0.384615385,0.25,34.01666667,1/11/2015,23,19,away,11,DEN,265,200,67,71,24,13,Win,99,88,0,2,1,IND,37,364,288,2,-2.859338923643916,42.926109759834375,20.03338541809523,22.892724341739147
0.25,0.384615385,25.98333333,1/11/2015,19,23,home,-11,IND,200,265,8,68,13,24,Loss,88,99,2,0,2,DEN,37,288,364,1,2.859338923643916,42.926109759834375,22.892724341739147,20.03338541809523
0.214285714,0.5,32.25,1/18/2015,19,20,away,-6,SEA,171,203,45,65,0,6,Loss,135,194,1,5,5,GBP,6,306,397,2,0.5427407320900972,44.582989120105594,22.562864926097845,22.02012419400775
0.5,0.214285714,31.06666667,1/18/2015,20,19,home,6,GBP,203,171,40,70,6,0,Win,194,135,5,1,2,SEA,6,397,306,5,-0.5427407320900972,44.582989120105594,22.02012419400775,22.562864926097845
0.272727273,0.666666667,22.18333333,1/18/2015,17,28,away,-38,NEP,126,220,23,52,7,45,Loss,83,177,0,1,1,IND,52,209,397,3,8.386461866946306,44.849327318987044,26.617894592966675,18.23143272602037
0.666666667,0.272727273,37.81666667,1/18/2015,28,17,home,38,IND,220,126,45,76,45,7,Win,177,83,1,0,3,NEP,52,397,209,1,-8.386461866946306,44.849327318987044,18.23143272602037,26.617894592966675
0.571428571,0.3,33.76666667,2/1/2015,25,20,away,4,SEA,320,234,36,72,28,24,Win,57,162,1,3,1,NEP,52,377,396,2,12.470056157263784,49.094728535286905,30.782392346275344,18.31233618901156
0.3,0.571428571,26.23333333,2/1/2015,20,25,home,-4,NEP,234,320,70,53,24,28,Loss,162,57,3,1,2,SEA,52,396,377,1,-12.470056157263784,49.094728535286905,18.31233618901156,30.782392346275344
0.46666666700000003,0.636363636,32.08333333,9/10/2015,23,26,away,-7,NEP,330,281,77,66,21,28,Loss,134,80,3,2,0,PIT,49,464,361,1,9.637502263362357,54.02922833332358,31.83336529834297,22.19586303498061
0.636363636,0.46666666700000003,27.91666667,9/10/2015,26,23,home,7,PIT,281,330,64,58,28,21,Win,80,134,2,3,1,NEP,49,361,464,0,-9.637502263362357,54.02922833332358,22.19586303498061,31.83336529834297
0.6,0.647058824,28.13333333,9/13/2015,21,25,away,8,CHI,189,213,74,53,31,23,Win,133,189,0,2,1,GBP,54,322,402,0,-4.573303336029706,52.35295273944622,23.889824701708257,28.463128037737967
0.647058824,0.6,31.86666667,9/13/2015,25,21,home,-8,GBP,213,189,64,71,23,31,Loss,189,133,2,0,0,CHI,54,402,322,1,4.573303336029706,52.35295273944622,28.463128037737967,23.889824701708257
0.23076923100000002,0.214285714,35.31666667,9/13/2015,19,24,away,7,HOU,233,298,25,67,27,20,Win,97,98,2,5,2,KCC,47,330,396,0,-5.692511359580708,40.29139982994821,17.299444235183753,22.99195559476446
0.214285714,0.23076923100000002,24.68333333,9/13/2015,24,19,home,-7,KCC,298,233,39,73,20,27,Loss,98,97,5,2,0,HOU,47,396,330,2,5.692511359580708,40.29139982994821,22.99195559476446,17.299444235183753
0.5,0.538461538,31.66666667,9/13/2015,15,18,away,-21,NYJ,217,179,109,63,10,31,Loss,104,154,3,0,1,CLE,41,321,333,5,-5.99071192237664,45.182341225871255,19.595814651747308,25.586526574123948
0.538461538,0.5,28.33333333,9/13/2015,18,15,home,21,CLE,179,217,30,60,31,10,Win,154,104,0,3,5,NYJ,41,333,321,1,5.99071192237664,45.182341225871255,25.586526574123948,19.595814651747308
0.533333333,0.384615385,29.06666667,9/13/2015,23,15,away,-13,BUF,240,195,49,68,14,27,Loss,64,147,2,0,0,IND,41,304,342,3,-3.584633862283944,46.59226182816764,21.50381398294185,25.088447845225794
0.384615385,0.533333333,30.93333333,9/13/2015,15,23,home,13,IND,195,240,113,55,27,14,Win,147,64,0,2,3,BUF,41,342,304,0,3.584633862283944,46.59226182816764,25.088447845225794,21.50381398294185
0.41666666700000005,0.428571429,22.1,9/13/2015,19,20,away,7,WAS,182,188,39,55,17,10,Win,74,161,3,1,2,MIA,27,256,349,1,-6.037559896271064,39.73475554252448,16.84859782312671,22.886157719397772
0.428571429,0.41666666700000005,37.9,9/13/2015,20,19,home,-7,MIA,188,182,88,69,10,17,Loss,161,74,1,3,1,WAS,27,349,256,2,6.037559896271064,39.73475554252448,22.886157719397772,16.84859782312671
0.470588235,0.25,34.1,9/13/2015,17,18,away,11,JAX,158,169,22,68,20,9,Win,105,96,2,5,3,CAR,29,263,265,1,-11.624679281552359,37.6039251350585,12.989622926753071,24.614302208305432
0.25,0.470588235,25.9,9/13/2015,18,17,home,-11,CAR,169,158,25,66,9,20,Loss,96,105,5,2,1,JAX,29,265,263,3,11.624679281552359,37.6039251350585,24.614302208305432,12.989622926753071
0.42105263200000004,0.545454545,37.46666667,9/13/2015,21,19,away,-3,LAR,219,276,46,79,0,3,Loss,124,76,6,2,3,SEA,3,343,352,1,-3.916167949205949,41.96168685817899,19.022759454486522,22.93892740369247
0.545454545,0.42105263200000004,28.53333333,9/13/2015,19,21,home,3,SEA,276,219,30,55,3,0,Win,76,124,2,6,1,LAR,3,352,343,3,3.916167949205949,41.96168685817899,22.93892740369247,19.022759454486522
0.38888888899999996,0.5,33.4,9/13/2015,18,25,away,-12,ARI,354,307,73,70,19,31,Loss,54,120,2,0,1,NOS,50,408,427,1,2.112903540730761,50.56712328358009,26.340013412155425,24.227109871424663
0.5,0.38888888899999996,26.6,9/13/2015,25,18,home,12,NOS,307,354,30,57,31,19,Win,120,54,0,2,1,ARI,50,427,408,1,-2.112903540730761,50.56712328358009,24.227109871424663,26.340013412155425
0.3,0.545454545,21.8,9/13/2015,16,28,away,-5,LAC,233,387,29,47,28,33,Loss,69,96,1,2,3,DET,61,302,483,2,6.362926649324802,54.43289989808236,30.39791327370358,24.03498662437878
0.545454545,0.3,38.2,9/13/2015,28,16,home,5,DET,387,233,40,74,33,28,Win,96,69,2,1,2,LAC,61,483,302,3,-6.362926649324802,54.43289989808236,24.03498662437878,30.39791327370358
0.444444444,0.214285714,31.51666667,9/13/2015,20,16,away,28,TBB,185,181,55,49,42,14,Win,124,92,2,4,2,TEN,56,309,273,1,-2.514726976362944,39.92098269256988,18.703127858103468,21.21785483446641
0.214285714,0.444444444,28.48333333,9/13/2015,16,20,home,-28,TEN,181,185,97,63,14,42,Loss,92,124,4,2,1,TBB,56,273,309,2,2.514726976362944,39.92098269256988,21.21785483446641,18.703127858103468
0.307692308,0.25,32.53333333,9/13/2015,22,16,away,20,OAK,269,183,50,65,33,13,Win,127,63,0,2,2,CIN,46,396,246,0,0.04091687844283953,42.30821755283491,21.174567215638874,21.133650337196038
0.25,0.307692308,27.46666667,9/13/2015,16,22,home,-20,CIN,183,269,32,61,13,33,Loss,63,127,2,0,0,OAK,46,246,396,2,-0.04091687844283953,42.30821755283491,21.133650337196038,21.174567215638874
0.153846154,0.444444444,22.71666667,9/13/2015,11,16,away,-6,DEN,100,150,15,57,13,19,Loss,73,69,2,4,1,BAL,32,173,219,2,1.879824697339373,24.908671915387814,13.394248306363593,11.51442360902422
0.444444444,0.153846154,37.28333333,9/13/2015,16,11,home,6,BAL,150,100,45,69,19,13,Win,69,73,4,2,2,DEN,32,219,173,1,-1.879824697339373,24.908671915387814,11.51442360902422,13.394248306363593
0.428571429,0.545454545,22.83333333,9/13/2015,18,27,away,-1,DAL,186,356,44,61,26,27,Loss,99,80,1,0,3,NYG,53,285,436,0,-3.7009589190864713,49.76509485980818,23.032067970360853,26.733026889447327
0.545454545,0.428571429,37.16666667,9/13/2015,27,18,home,1,NYG,356,186,35,68,27,26,Win,80,99,0,1,0,DAL,53,436,285,3,3.7009589190864713,49.76509485980818,26.733026889447327,23.032067970360853
0.25,0.28571428600000004,24.55,9/14/2015,23,21,away,-2,ATL,336,290,88,68,24,26,Loss,63,105,0,1,2,PHI,50,399,395,2,-2.508384144153273,49.15937639748655,23.325496126666636,25.83388027081991
0.28571428600000004,0.25,35.45,9/14/2015,21,23,home,2,PHI,290,336,57,70,26,24,Win,105,63,1,0,2,ATL,50,395,399,2,2.508384144153273,49.15937639748655,25.83388027081991,23.325496126666636
0.111111111,0.41666666700000005,26.96666667,9/14/2015,17,25,away,-17,SFO,177,165,25,54,3,20,Loss,71,230,5,1,1,MIN,23,248,395,1,5.807704152824019,39.23515068230855,22.521427417566287,16.713723264742264
0.41666666700000005,0.111111111,33.03333333,9/14/2015,25,17,home,17,MIN,165,177,57,66,20,3,Win,230,71,1,5,1,SFO,23,395,248,1,-5.807704152824019,39.23515068230855,16.713723264742264,22.521427417566287
0.375,0.0,31.01666667,9/17/2015,21,20,away,7,KCC,238,167,85,70,31,24,Win,61,147,3,5,5,DEN,55,299,314,1,4.2351989769839395,41.55281631890845,22.894007647946193,18.658808670962255
0.0,0.375,28.98333333,9/17/2015,20,21,home,-7,DEN,167,238,60,58,24,31,Loss,147,61,5,3,1,KCC,55,314,299,5,-4.2351989769839395,41.55281631890845,18.658808670962255,22.894007647946193
0.263157895,0.307692308,27.71666667,9/20/2015,21,25,away,-7,CAR,239,178,70,82,17,24,Loss,61,172,1,2,1,HOU,41,300,350,1,-24.484060083314308,41.771259348659754,8.643599632672725,33.12765971598703
0.307692308,0.263157895,32.28333333,9/20/2015,25,21,home,7,HOU,178,239,92,72,24,17,Win,172,61,2,1,1,CAR,41,350,300,1,24.484060083314308,41.771259348659754,33.12765971598703,8.643599632672723
0.41176470600000004,0.6,36.98333333,9/20/2015,27,21,away,-25,PIT,298,369,46,82,18,43,Loss,111,84,5,0,0,SFO,61,409,453,1,-2.0533713289132223,52.50111028977656,25.22386948043167,27.277240809344892
0.6,0.41176470600000004,23.01666667,9/20/2015,21,27,home,25,SFO,369,298,58,52,43,18,Win,84,111,0,5,1,PIT,61,453,409,0,2.0533713289132223,52.50111028977656,27.277240809344892,25.22386948043167
0.35714285700000004,0.5,28.53333333,9/20/2015,18,21,away,7,NOS,194,219,90,59,26,19,Win,139,104,3,4,3,TBB,45,333,323,2,-8.35932939809425,45.17629556853581,18.40848308522078,26.767812483315026
0.5,0.35714285700000004,31.46666667,9/20/2015,21,18,home,-7,TBB,219,194,115,69,19,26,Loss,104,139,4,3,2,NOS,45,323,333,3,8.35932939809425,45.17629556853581,26.767812483315026,18.40848308522078
0.46153846200000004,0.5,28.9,9/20/2015,25,20,away,-10,MIN,285,151,39,70,16,26,Loss,38,199,1,1,1,DET,42,323,350,3,-4.786162944020679,49.515886960358834,22.364862008169077,27.151024952189758
0.5,0.46153846200000004,31.1,9/20/2015,20,25,home,10,DET,151,285,97,61,26,16,Win,199,38,1,1,3,MIN,42,350,323,1,4.786162944020679,49.515886960358834,27.151024952189758,22.364862008169077
0.5555555560000001,0.166666667,30.06666667,9/20/2015,21,18,away,25,CHI,185,226,58,52,48,23,Win,115,109,0,2,2,ARI,71,300,335,2,-1.2929627736023317,44.11095184401347,21.40899453520557,22.701957308807902
0.166666667,0.5555555560000001,29.93333333,9/20/2015,18,21,home,-25,ARI,226,185,170,62,23,48,Loss,109,115,2,0,2,CHI,71,335,300,2,1.2929627736023317,44.11095184401347,22.701957308807902,21.40899453520557
0.3,0.307692308,29.95,9/20/2015,27,23,away,8,BUF,451,189,119,76,40,32,Win,56,160,2,8,3,NEP,72,507,349,2,1.4813467904007958,55.67013979910473,28.575743294752762,27.09439650435197
0.307692308,0.3,30.05,9/20/2015,23,27,home,-8,NEP,189,451,140,65,32,40,Loss,160,56,8,2,2,BUF,72,349,507,3,-1.4813467904007958,55.67013979910473,27.09439650435197,28.575743294752762
0.363636364,0.4,30.15,9/20/2015,19,20,away,-5,CIN,223,214,64,56,19,24,Loss,131,175,4,0,2,LAC,43,354,389,3,4.509812736664728,48.45907081900467,26.4844417778347,21.974629041169973
0.4,0.363636364,29.85,9/20/2015,20,19,home,5,LAC,214,223,75,62,24,19,Win,175,131,0,4,3,CIN,43,389,354,2,-4.509812736664728,48.45907081900467,21.974629041169973,26.4844417778347
0.4375,0.363636364,35.18333333,9/20/2015,21,13,away,-14,CLE,219,158,85,74,14,28,Loss,166,116,7,2,0,TEN,42,385,274,3,-4.380619794567785,39.602020167723865,17.61070018657804,21.991319981145825
0.363636364,0.4375,24.81666667,9/20/2015,13,21,home,14,TEN,158,219,40,47,28,14,Win,116,166,2,7,3,CLE,42,274,385,0,4.380619794567785,39.602020167723865,21.991319981145825,17.61070018657804
0.647058824,0.588235294,31.58333333,9/20/2015,25,19,away,4,NYG,346,291,65,70,24,20,Win,56,97,2,2,1,ATL,44,402,388,0,-8.698272084833594,51.35724287188698,21.329485393526696,30.027757478360286
0.588235294,0.647058824,28.41666667,9/20/2015,19,25,home,-4,ATL,291,346,35,65,20,24,Loss,97,56,2,2,0,NYG,44,388,402,1,8.698272084833594,51.35724287188698,30.027757478360286,21.329485393526696
0.166666667,0.5,22.26666667,9/20/2015,11,19,away,-14,WAS,146,191,80,46,10,24,Loss,67,182,1,2,1,LAR,34,213,373,0,-6.808382220851957,34.749424711927915,13.97052124553798,20.778903466389934
0.5,0.166666667,37.73333333,9/20/2015,19,11,home,14,LAR,191,146,53,66,24,10,Win,182,67,2,1,0,WAS,34,373,213,1,6.808382220851957,34.749424711927915,20.778903466389934,13.970521245537979
0.333333333,0.35714285700000004,29.86666667,9/20/2015,17,19,away,-3,JAX,344,273,112,62,20,23,Loss,42,123,2,0,0,MIA,43,386,396,0,-10.901378760766299,44.60413142144208,16.85137633033789,27.752755091104188
0.35714285700000004,0.333333333,30.13333333,9/20/2015,19,17,home,3,MIA,273,344,93,66,23,20,Win,123,42,0,2,0,JAX,43,396,386,0,10.901378760766299,44.60413142144208,27.752755091104188,16.85137633033789
0.363636364,0.642857143,30.43333333,9/20/2015,29,27,away,-4,OAK,384,351,109,70,33,37,Loss,109,97,0,1,1,BAL,70,493,448,2,-2.4400714958004013,66.51656494067097,32.03824672243529,34.478318218235685
0.642857143,0.363636364,29.56666667,9/20/2015,27,29,home,4,BAL,351,384,106,66,37,33,Win,97,109,1,0,2,OAK,70,448,493,1,2.4400714958004013,66.51656494067097,34.478318218235685,32.03824672243529
0.333333333,0.181818182,40.41666667,9/20/2015,21,17,away,10,PHI,250,219,142,70,20,10,Win,109,7,3,1,3,DAL,30,359,226,2,-1.4894123528594632,41.861182949080415,20.185885298110477,21.675297650969938
0.181818182,0.333333333,19.58333333,9/20/2015,17,21,home,-10,DAL,219,250,60,55,10,20,Loss,7,109,1,3,2,PHI,30,226,359,3,1.4894123528594632,41.861182949080415,21.675297650969938,20.185885298110477
0.333333333,0.363636364,26.7,9/20/2015,21,21,away,-10,GBP,205,234,92,57,17,27,Loss,119,127,2,2,1,SEA,44,324,361,2,6.457088944743445,45.95009281963329,26.20359088218837,19.746501937444922
0.363636364,0.333333333,33.3,9/20/2015,21,21,home,10,SEA,234,205,35,64,27,17,Win,127,119,2,2,2,GBP,44,361,324,1,-6.457088944743445,45.95009281963329,19.746501937444922,26.20359088218837
0.333333333,0.428571429,31.8,9/21/2015,20,17,away,13,IND,243,250,90,62,20,7,Win,101,93,1,0,5,NYJ,27,344,343,1,-2.1149136692128074,49.92758458802231,23.90633545940475,26.021249128617562
0.428571429,0.333333333,28.2,9/21/2015,17,20,home,-13,NYJ,250,243,84,61,7,20,Loss,93,101,0,1,1,IND,27,343,344,5,2.1149136692128074,49.92758458802231,26.021249128617562,23.90633545940475
0.4,0.333333333,28.5,9/24/2015,22,19,away,-11,NYG,305,279,58,70,21,32,Loss,88,84,1,0,0,WAS,53,393,363,3,-10.916119072502482,47.82614364818963,18.455012287843573,29.371131360346055
0.333333333,0.4,31.5,9/24/2015,19,22,home,11,WAS,279,305,67,63,32,21,Win,84,88,0,1,3,NYG,53,363,393,0,10.916119072502482,47.82614364818963,29.371131360346055,18.455012287843573
0.642857143,0.166666667,34.21666667,9/27/2015,26,23,away,11,DAL,280,220,70,69,39,28,Win,158,127,1,2,1,ATL,67,438,347,0,6.115216754506607,47.94345632980226,27.029336542154432,20.914119787647827
0.166666667,0.642857143,25.78333333,9/27/2015,23,26,home,-11,ATL,220,280,31,49,28,39,Loss,127,158,2,1,0,DAL,67,347,438,1,-6.115216754506607,47.94345632980226,20.914119787647827,27.029336542154432
0.363636364,0.307692308,25.01666667,9/27/2015,20,28,away,2,TEN,245,345,71,56,35,33,Win,133,88,3,3,2,IND,68,378,433,2,0.48596969502638865,54.288555324258645,27.387262509642518,26.901292814616127
0.307692308,0.363636364,34.98333333,9/27/2015,28,20,home,-2,IND,345,245,55,74,33,35,Loss,88,133,3,3,2,TEN,68,433,378,2,-0.48596969502638865,54.288555324258645,26.901292814616127,27.387262509642518
0.428571429,0.5,32.48333333,9/27/2015,19,21,away,7,CLE,314,316,85,62,27,20,Win,155,39,0,5,2,OAK,47,469,355,1,-6.869528814821647,53.138030091248766,23.134250638213558,30.003779453035207
0.5,0.428571429,27.51666667,9/27/2015,21,19,home,-7,OAK,316,314,50,68,20,27,Loss,39,155,5,0,1,CLE,47,355,469,2,6.869528814821647,53.138030091248766,30.003779453035207,23.134250638213558
0.533333333,0.4375,30.13333333,9/27/2015,23,19,away,4,BAL,372,362,67,65,28,24,Win,86,36,2,0,1,CIN,52,458,398,2,0.17397896016935221,53.59918076895342,26.886579864561384,26.712600904392033
0.4375,0.533333333,29.86666667,9/27/2015,19,23,home,-4,CIN,362,372,116,67,24,28,Loss,36,86,0,2,2,BAL,52,398,458,1,-0.17397896016935221,53.59918076895342,26.712600904392033,26.886579864561384
0.5,0.7857142859999999,25.33333333,9/27/2015,15,35,away,-34,NEP,236,346,114,55,17,51,Loss,57,125,2,2,0,JAX,68,293,471,1,0.3444100324118864,54.613717807493856,27.47906391995287,27.134653887540985
0.7857142859999999,0.5,34.66666667,9/27/2015,35,15,home,34,JAX,346,236,30,76,51,17,Win,125,57,2,2,1,NEP,68,471,293,0,-0.3444100324118864,54.613717807493856,27.134653887540985,27.47906391995287
0.583333333,0.454545455,32.73333333,9/27/2015,27,24,away,-5,CAR,310,312,55,63,22,27,Loss,70,119,1,1,0,NOS,49,380,431,2,-0.6237099170161224,58.83981392553561,29.108052004259743,29.731761921275865
0.454545455,0.583333333,27.26666667,9/27/2015,24,27,home,5,NOS,312,310,88,62,27,22,Win,119,70,1,1,2,CAR,49,431,380,0,0.6237099170161224,58.83981392553561,29.731761921275865,29.108052004259743
0.28571428600000004,0.41176470600000004,28.18333333,9/27/2015,18,19,away,7,NYJ,108,276,21,67,24,17,Win,123,47,1,1,4,PHI,41,231,323,1,-8.16319702377426,39.73037660908468,15.78358979265521,23.94678681642947
0.41176470600000004,0.28571428600000004,31.81666667,9/27/2015,19,18,home,-7,PHI,276,108,53,75,17,24,Loss,47,123,1,1,1,NYJ,41,323,231,4,8.16319702377426,39.73037660908468,23.94678681642947,15.78358979265521
0.083333333,0.444444444,23.71666667,9/27/2015,14,30,away,-10,HOU,261,227,84,56,9,19,Loss,57,186,0,1,1,TBB,28,318,413,1,-16.649039787434333,42.86426367808064,13.107611945323153,29.756651732757486
0.444444444,0.083333333,36.28333333,9/27/2015,30,14,home,10,TBB,227,261,58,86,19,9,Win,186,57,1,0,1,HOU,28,413,318,1,16.649039787434333,42.86426367808064,29.756651732757486,13.107611945323153
0.470588235,0.333333333,33.48333333,9/27/2015,21,18,away,-17,MIN,279,121,74,72,14,31,Loss,90,163,4,0,1,LAC,45,369,284,2,-4.356160763601705,41.937958257873156,18.790898747135724,23.14705951073743
0.333333333,0.470588235,26.51666667,9/27/2015,18,21,home,17,LAC,121,279,39,55,31,14,Win,163,90,0,4,2,MIN,45,284,369,1,4.356160763601705,41.937958257873156,23.14705951073743,18.790898747135724
0.5,0.2,32.31666667,9/27/2015,17,12,away,6,LAR,197,187,63,57,12,6,Win,62,71,5,2,1,PIT,18,259,258,1,4.19543090475444,34.55731366986731,19.376372287310875,15.180941382556437
0.2,0.5,27.68333333,9/27/2015,12,17,home,-6,PIT,187,197,47,49,6,12,Loss,71,62,2,5,1,LAR,18,258,259,1,-4.19543090475444,34.55731366986731,15.180941382556437,19.376372287310875
0.333333333,0.46153846200000004,23.46666667,9/27/2015,10,28,away,-40,ARI,53,307,45,50,7,47,Loss,103,139,2,1,1,SFO,54,156,446,4,3.9565640293869038,40.25800623271155,22.107285131049228,18.150721101662324
0.46153846200000004,0.333333333,36.53333333,9/27/2015,28,10,home,40,SFO,307,53,24,70,47,7,Win,139,103,1,2,4,ARI,54,446,156,1,-3.9565640293869038,40.25800623271155,18.150721101662324,22.107285131049228
0.538461538,0.307692308,31.88333333,9/27/2015,21,21,away,27,MIA,277,289,40,63,41,14,Win,151,102,0,2,3,BUF,55,428,391,0,-2.7978826012193956,50.19914416492813,23.700630781854365,26.498513383073764
0.307692308,0.538461538,28.11666667,9/27/2015,21,21,home,-27,BUF,289,277,36,71,14,41,Loss,102,151,2,0,0,MIA,55,391,428,3,2.7978826012193956,50.19914416492813,26.498513383073764,23.700630781854365
0.23076923100000002,0.3125,27.4,9/27/2015,7,17,away,-26,SEA,48,212,40,46,0,26,Loss,98,159,2,4,0,CHI,26,146,371,0,2.1159426136373973,25.646196215932548,13.881069414784973,11.765126801147575
0.3125,0.23076923100000002,32.6,9/27/2015,17,7,home,26,CHI,212,48,41,63,26,0,Win,159,98,4,2,0,SEA,26,371,146,0,-2.1159426136373973,25.646196215932548,11.765126801147575,13.881069414784973
0.333333333,0.333333333,28.86666667,9/27/2015,19,22,away,12,DET,313,262,94,62,24,12,Win,41,28,1,4,3,DEN,36,354,290,2,-0.3529152348234881,48.05853524851821,23.852810006847363,24.205725241670848
0.333333333,0.333333333,31.13333333,9/27/2015,22,19,home,-12,DEN,262,313,75,68,12,24,Loss,28,41,4,1,2,DET,36,290,354,3,0.3529152348234881,48.05853524851821,24.205725241670848,23.852810006847363
0.2,0.363636364,26.5,9/28/2015,23,26,away,-10,GBP,251,325,38,65,28,38,Loss,75,123,7,1,0,KCC,66,326,448,1,2.543772866562108,47.51781498609063,25.030793926326368,22.48702105976426
0.363636364,0.2,33.5,9/28/2015,26,23,home,10,KCC,325,251,89,68,38,28,Win,123,75,1,7,1,GBP,66,448,326,0,-2.543772866562108,47.51781498609063,22.48702105976426,25.030793926326368
0.352941176,0.153846154,37.71666667,10/1/2015,21,17,away,3,PIT,165,96,30,78,3,0,Win,191,167,5,4,0,BAL,3,356,263,2,-1.464661803670869,25.254199302027565,11.894768749178349,13.359430552849217
0.153846154,0.352941176,32.15,10/1/2015,17,21,home,-3,BAL,96,165,20,63,0,3,Loss,167,191,4,5,2,PIT,3,263,356,0,1.464661803670869,25.254199302027565,13.359430552849217,11.894768749178349
0.375,0.0,37.38333333,10/4/2015,23,17,away,13,MIA,218,167,163,72,27,14,Win,207,59,0,3,2,NYJ,41,425,226,1,-7.0824370105661885,40.020467512084245,16.46901525075903,23.551452261325217
0.0,0.375,22.61666667,10/4/2015,17,23,home,-13,NYJ,167,218,80,58,14,27,Loss,59,207,3,0,1,MIA,41,226,425,2,7.0824370105661885,40.020467512084245,23.551452261325217,16.46901525075903
0.38888888899999996,0.46666666700000003,36.16666667,10/4/2015,21,22,away,-3,IND,289,266,92,79,0,3,Loss,142,60,1,3,2,JAX,3,431,326,0,-19.26542067339029,41.02630802729194,10.880443676950826,30.145864350341114
0.46666666700000003,0.38888888899999996,34.23333333,10/4/2015,22,21,home,3,JAX,266,289,45,74,3,0,Win,60,142,3,1,0,IND,3,326,431,2,19.26542067339029,41.02630802729194,30.145864350341114,10.880443676950824
0.2,0.1875,30.55,10/4/2015,19,14,away,14,BUF,211,258,85,64,24,10,Win,92,55,1,2,2,NYG,34,303,313,1,-11.781508625736652,38.86766313175718,13.543077253010267,25.324585878746916
0.1875,0.2,29.45,10/4/2015,14,19,home,-14,NYG,258,211,135,68,10,24,Loss,55,92,2,1,1,BUF,34,313,303,2,11.781508625736652,38.86766313175718,25.324585878746916,13.543077253010265
0.272727273,0.5,27.86666667,10/4/2015,17,25,away,14,TBB,111,270,45,57,37,23,Win,133,141,2,2,5,CAR,60,244,411,1,-9.926147177315102,47.231265949396025,18.652559386040462,28.578706563355563
0.5,0.272727273,32.13333333,10/4/2015,25,17,home,-14,CAR,270,111,48,75,23,37,Loss,141,133,2,2,1,TBB,60,411,244,5,9.926147177315102,47.231265949396025,28.578706563355563,18.652559386040462
0.333333333,0.529411765,18.86666667,10/4/2015,14,25,away,-3,WAS,233,290,72,51,20,23,Loss,87,127,5,1,1,PHI,43,320,417,2,-8.842589719953382,48.116207496837205,19.636808888441912,28.479398608395293
0.529411765,0.333333333,41.13333333,10/4/2015,25,14,home,3,PHI,290,233,110,79,23,20,Win,127,87,1,5,2,WAS,43,417,320,1,8.842589719953382,48.116207496837205,28.479398608395293,19.636808888441912
0.46153846200000004,0.588235294,26.63333333,10/4/2015,16,23,away,-2,CHI,173,273,47,57,20,22,Loss,70,98,2,3,3,OAK,42,243,371,2,-9.984795605052122,48.47112743419986,19.24316591457387,29.22796151962599
0.588235294,0.46153846200000004,33.36666667,10/4/2015,23,16,home,2,OAK,273,173,48,75,22,20,Win,98,70,3,2,2,CHI,42,371,243,3,9.984795605052122,48.47112743419986,29.22796151962599,19.24316591457387
0.46666666700000003,0.5625,24.13333333,10/4/2015,24,22,away,-27,ATL,374,243,35,75,21,48,Loss,54,135,1,2,0,HOU,69,428,378,4,-9.748959821619598,52.90565638591851,21.578348282149456,31.327308103769056
0.5625,0.46666666700000003,35.86666667,10/4/2015,22,24,home,27,HOU,243,374,80,64,48,21,Win,135,54,2,1,4,ATL,69,378,428,0,9.748959821619598,52.90565638591851,31.327308103769056,21.578348282149456
0.4375,0.6,36.88333333,10/4/2015,24,18,away,-15,CIN,348,321,46,73,21,36,Loss,113,124,5,0,0,KCC,57,461,445,1,2.3309242321497408,53.865206998768485,28.098065615459113,25.767141383309372
0.6,0.4375,23.11666667,10/4/2015,18,24,home,15,KCC,321,348,84,50,36,21,Win,124,113,0,5,1,CIN,57,445,461,0,-2.3309242321497408,53.865206998768485,25.767141383309372,28.098065615459113
0.307692308,0.272727273,34.31666667,10/4/2015,20,23,away,-3,LAC,332,347,91,66,27,30,Loss,100,91,4,2,0,CLE,57,432,438,1,0.6752831919548878,46.8733679640189,23.774325577986893,23.099042386032004
0.272727273,0.307692308,25.68333333,10/4/2015,23,20,home,3,CLE,347,332,31,61,30,27,Win,91,100,2,4,1,LAC,57,438,432,0,-0.6752831919548878,46.8733679640189,23.099042386032004,23.774325577986893
0.333333333,0.307692308,36.56666667,10/4/2015,18,8,away,14,SFO,200,119,65,68,17,3,Win,162,77,3,6,1,GBP,20,362,196,0,-0.35060140268160644,31.213990933544448,15.43169476543142,15.782296168113028
0.307692308,0.333333333,23.43333333,10/4/2015,8,18,home,-14,GBP,119,200,30,50,3,17,Loss,77,162,6,3,0,SFO,20,196,362,1,0.35060140268160644,31.213990933544448,15.782296168113028,15.43169476543142
0.384615385,0.181818182,26.78333333,10/4/2015,13,26,away,2,ARI,164,334,66,51,24,22,Win,164,113,1,4,3,LAR,46,328,447,0,2.2877136464641463,44.739592974214034,23.51365331033909,21.225939663874943
0.181818182,0.384615385,33.21666667,10/4/2015,26,13,home,-2,LAR,334,164,20,71,22,24,Loss,113,164,4,1,0,ARI,46,447,328,3,-2.2877136464641463,44.739592974214034,21.225939663874943,23.51365331033909
0.375,0.222222222,33.9,10/4/2015,19,18,away,-3,DEN,212,200,63,69,20,23,Loss,113,144,7,2,2,MIN,43,325,344,1,4.704694532159781,42.34608995692483,23.525392244542303,18.820697712382525
0.222222222,0.375,26.1,10/4/2015,18,19,home,3,MIN,200,212,40,53,23,20,Win,144,113,2,7,1,DEN,43,344,325,2,-4.704694532159781,42.34608995692483,18.820697712382525,23.525392244542303
0.25,0.46153846200000004,29.33333333,10/4/2015,21,27,away,-6,NOS,220,335,30,57,0,6,Loss,115,103,3,3,0,DAL,6,335,438,0,4.227754862768036,45.589348378021654,24.908551620394846,20.68079675762681
0.46153846200000004,0.25,30.88333333,10/4/2015,27,21,home,6,DAL,335,220,64,69,6,0,Win,103,115,3,3,0,NOS,6,438,335,0,-4.227754862768036,45.589348378021654,20.68079675762681,24.908551620394846
0.23076923100000002,0.46153846200000004,27.93333333,10/5/2015,12,18,away,-3,SEA,203,235,37,53,10,13,Loss,53,110,0,6,3,DET,23,256,345,1,6.007775877062038,38.17341244875556,22.0905941629088,16.082818285846763
0.46153846200000004,0.23076923100000002,32.06666667,10/5/2015,18,12,home,3,DET,235,203,30,63,13,10,Win,110,53,6,0,1,SEA,23,345,256,3,-6.007775877062038,38.17341244875556,16.082818285846763,22.0905941629088
0.272727273,0.5,27.55,10/8/2015,22,24,away,7,HOU,213,362,65,59,27,20,Win,110,82,0,1,2,IND,47,323,444,0,-6.410854284844763,52.098703949678395,22.843924832416818,29.254779117261577
0.5,0.272727273,32.45,10/8/2015,24,22,home,-7,IND,362,213,125,70,20,27,Loss,82,110,1,0,0,HOU,47,444,323,2,6.410854284844763,52.098703949678395,29.254779117261577,22.843924832416818
0.428571429,0.35714285700000004,33.61666667,10/11/2015,21,16,away,1,KCC,241,170,49,73,18,17,Win,87,117,2,3,0,CHI,35,328,287,1,-8.481199414021182,35.838444716495836,13.678622651237326,22.15982206525851
0.35714285700000004,0.428571429,26.38333333,10/11/2015,16,21,home,-1,CHI,170,241,49,58,17,18,Loss,117,87,3,2,1,KCC,35,287,328,0,8.481199414021182,35.838444716495836,22.15982206525851,13.678622651237326
0.384615385,0.4,30.58333333,10/11/2015,16,27,away,-3,CIN,197,310,112,57,0,3,Loss,200,109,4,4,2,SEA,3,397,419,1,-1.243047517715313,41.58486432193437,20.17090840210953,21.41395591982484
0.4,0.384615385,40.81666667,10/11/2015,27,16,home,3,SEA,310,197,50,79,3,0,Win,109,200,4,4,1,CIN,3,419,397,2,1.243047517715313,41.58486432193437,21.41395591982484,20.17090840210953
0.333333333,0.4,27.81666667,10/11/2015,18,29,away,-6,ATL,219,242,51,57,0,6,Loss,51,176,1,3,3,WAS,6,270,418,2,-5.338411924899416,43.647156921732225,19.154372498416404,24.492784423315822
0.4,0.333333333,34.93333333,10/11/2015,29,18,home,6,WAS,242,219,62,77,6,0,Win,176,51,3,1,2,ATL,6,418,270,3,5.338411924899416,43.647156921732225,24.492784423315822,19.154372498416404
0.25,0.454545455,25.31666667,10/11/2015,21,20,away,-7,TBB,270,186,12,56,31,38,Loss,55,183,6,2,0,JAX,69,325,369,2,0.6255655896606918,44.70859501190664,22.667080300783667,22.04151471112297
0.454545455,0.25,34.68333333,10/11/2015,20,21,home,7,JAX,186,270,72,61,38,31,Win,183,55,2,6,2,TBB,69,369,325,0,-0.6255655896606918,44.70859501190664,22.04151471112297,22.667080300783667
0.5,0.363636364,25.96666667,10/11/2015,19,34,away,-22,PHI,292,333,78,69,17,39,Loss,96,186,5,0,2,NOS,56,388,519,4,-1.5017870056758333,61.318320890953565,29.908266942638868,31.410053948314697
0.363636364,0.5,34.03333333,10/11/2015,34,19,home,22,NOS,333,292,35,79,39,17,Win,186,96,0,5,4,PHI,56,519,388,2,1.5017870056758333,61.318320890953565,31.410053948314697,29.908266942638868
0.6315789470000001,0.35714285700000004,39.26666667,10/11/2015,25,22,away,3,BAL,422,196,74,80,3,0,Win,83,181,4,1,0,CLE,3,505,377,0,-10.41891062605437,43.366122769564285,16.473606071754958,26.892516697809327
0.35714285700000004,0.6315789470000001,29.01666667,10/11/2015,22,25,home,-3,CLE,196,422,98,67,0,3,Loss,181,83,1,4,0,BAL,3,377,505,0,10.41891062605437,43.366122769564285,26.892516697809327,16.473606071754958
0.27777777800000003,0.307692308,33.71666667,10/11/2015,17,14,away,-14,GBP,143,236,40,70,10,24,Loss,191,86,3,2,3,LAR,34,334,322,4,-4.823663404103999,43.490121061296996,19.3332288285965,24.156892232700496
0.307692308,0.27777777800000003,26.28333333,10/11/2015,14,17,home,14,LAR,236,143,67,59,24,10,Win,86,191,2,3,4,GBP,34,322,334,3,4.823663404103999,43.490121061296996,24.156892232700496,19.3332288285965
0.333333333,0.384615385,24.48333333,10/11/2015,13,17,away,1,TEN,82,179,62,50,14,13,Win,127,97,4,2,1,BUF,27,209,276,1,-2.5812234929874793,34.27721904813691,15.847997777574715,18.42922127056219
0.384615385,0.333333333,35.51666667,10/11/2015,17,13,home,-1,BUF,179,82,74,62,13,14,Loss,97,127,2,4,1,TEN,27,276,209,1,2.5812234929874793,34.27721904813691,18.429221270562195,15.847997777574713
0.125,0.470588235,23.46666667,10/11/2015,15,29,away,25,DET,158,379,70,45,42,17,Win,187,56,2,1,6,ARI,59,345,435,0,-2.1880311939159327,50.30829082043657,24.060129813260318,26.24816100717625
0.470588235,0.125,36.53333333,10/11/2015,29,15,home,-25,ARI,379,158,85,89,17,42,Loss,56,187,1,2,0,DET,59,435,345,6,2.1880311939159327,50.30829082043657,26.24816100717625,24.060129813260318
0.3,0.28571428600000004,26.8,10/11/2015,20,18,away,24,DAL,247,163,64,55,30,6,Win,109,102,5,3,2,NEP,36,356,265,0,9.124356513704097,36.19890779352288,22.66163215361349,13.53727563990939
0.28571428600000004,0.3,33.2,10/11/2015,18,20,home,-24,NEP,163,247,50,66,6,30,Loss,102,109,3,5,0,DAL,36,265,356,2,-9.124356513704097,36.19890779352288,13.537275639909389,22.66163215361349
0.153846154,0.4375,25.85,10/11/2015,15,20,away,6,OAK,254,223,103,55,16,10,Win,43,65,2,4,3,DEN,26,297,288,2,-0.15342470100757355,45.46547481459683,22.65602505679463,22.809449757802202
0.4375,0.153846154,34.15,10/11/2015,20,15,home,-6,DEN,223,254,41,68,10,16,Loss,65,43,4,2,2,OAK,26,288,297,3,0.15342470100757355,45.46547481459683,22.809449757802202,22.65602505679463
0.571428571,0.642857143,28.03333333,10/11/2015,22,30,away,-3,NYG,256,441,28,64,27,30,Loss,124,84,2,0,1,SFO,57,380,525,0,-6.894556471464499,59.37291441330102,26.23917897091826,33.13373544238276
0.642857143,0.571428571,31.96666667,10/11/2015,30,22,home,3,SFO,441,256,65,75,30,27,Win,84,124,0,2,0,NYG,57,525,380,1,6.894556471464499,59.37291441330102,33.13373544238276,26.23917897091826
0.35714285700000004,0.28571428600000004,26.28333333,10/12/2015,14,24,away,4,LAC,194,354,86,56,24,20,Win,155,52,3,2,2,PIT,44,349,406,1,-1.2979116498866619,44.520747053991755,21.611417702052545,22.90932935193921
0.28571428600000004,0.35714285700000004,33.71666667,10/12/2015,24,14,home,-4,PIT,354,194,54,69,20,24,Loss,52,155,2,3,1,LAC,44,406,349,2,1.2979116498866619,44.520747053991755,22.90932935193921,21.611417702052545
0.25,0.5,27.5,10/15/2015,23,25,away,-10,NOS,263,304,41,70,21,31,Loss,150,81,5,1,0,ATL,52,413,385,3,-0.82706264539922,46.96784321665151,23.070390285626146,23.897452931025363
0.5,0.25,32.5,10/15/2015,25,23,home,10,ATL,304,263,15,72,31,21,Win,81,150,1,5,3,NOS,52,385,413,0,0.82706264539922,46.96784321665151,23.897452931025363,23.070390285626146
0.333333333,0.5,27.35,10/18/2015,14,22,away,-14,NYJ,191,253,15,62,20,34,Loss,34,221,1,0,3,WAS,54,225,474,2,-5.8459488803923065,44.38634719010725,19.270199154857472,25.11614803524978
0.5,0.333333333,32.65,10/18/2015,22,14,home,14,WAS,253,191,5,67,34,20,Win,221,34,0,1,2,NYJ,54,474,225,3,5.8459488803923065,44.38634719010725,25.11614803524978,19.270199154857472
0.41666666700000005,0.25,31.15,10/18/2015,21,14,away,-12,PIT,414,169,111,66,13,25,Loss,55,141,1,1,0,ARI,38,469,310,3,0.9073134920932215,45.09607976823057,23.001696630161895,22.09438313806867
0.25,0.41666666700000005,28.85,10/18/2015,14,21,home,12,ARI,169,414,48,53,25,13,Win,141,55,1,1,3,PIT,38,310,469,0,-0.9073134920932215,45.09607976823057,22.09438313806867,23.001696630161895
0.25,0.352941176,26.88333333,10/18/2015,16,16,away,-6,MIN,271,237,95,57,10,16,Loss,57,84,2,2,2,KCC,26,328,321,1,-4.459355643163331,38.1770453229704,16.858844839903533,21.318200483066867
0.352941176,0.25,33.11666667,10/18/2015,16,16,home,6,KCC,237,271,50,68,16,10,Win,84,57,2,2,1,MIN,26,321,328,2,4.459355643163331,38.1770453229704,21.318200483066867,16.858844839903533
0.583333333,0.384615385,30.0,10/18/2015,21,22,away,13,BUF,243,256,20,61,34,21,Win,112,112,0,2,1,CIN,55,355,368,0,-1.0711268074731688,47.627555691217864,23.278214441872347,24.349341249345517
0.384615385,0.583333333,30.0,10/18/2015,22,21,home,-13,CIN,256,243,93,67,21,34,Loss,112,112,2,0,0,BUF,55,368,355,1,1.0711268074731688,47.627555691217864,24.349341249345517,23.278214441872347
0.428571429,0.529411765,33.56666667,10/18/2015,24,26,away,-3,DET,353,391,76,73,0,3,Loss,91,155,1,2,3,CHI,3,444,546,1,-13.521906828728168,55.48284134481536,20.980467258043596,34.502374086771766
0.529411765,0.428571429,38.95,10/18/2015,26,24,home,3,CHI,391,353,98,76,3,0,Win,155,91,2,1,1,DET,3,546,444,3,13.521906828728168,55.48284134481536,34.502374086771766,20.980467258043596
0.222222222,0.4,36.9,10/18/2015,21,20,away,3,CLE,290,189,81,81,3,0,Win,152,109,0,4,3,DEN,3,442,298,3,-14.268860588166344,37.73310964495973,11.732124528396696,26.000985116563037
0.4,0.222222222,33.16666667,10/18/2015,20,21,home,-3,DEN,189,290,30,76,0,3,Loss,109,152,4,0,3,CLE,3,298,442,3,14.268860588166344,37.73310964495973,26.000985116563037,11.732124528396694
0.5,0.333333333,30.03333333,10/18/2015,24,26,away,11,JAX,287,311,69,68,31,20,Win,95,83,1,3,3,HOU,51,382,394,0,-14.159765081746352,52.75446615487007,19.297350536561858,33.457115618308215
0.333333333,0.5,29.96666667,10/18/2015,26,24,home,-11,HOU,311,287,64,77,20,31,Loss,83,95,3,1,0,JAX,51,394,382,3,14.159765081746352,52.75446615487007,33.45711561830821,19.29735053656186
0.5555555560000001,0.2,31.88333333,10/18/2015,26,22,away,28,TEN,254,236,97,63,38,10,Win,180,63,2,6,4,MIA,48,434,299,2,0.833929670398259,52.39062297477466,26.61227632258646,25.778346652188198
0.2,0.5555555560000001,28.11666667,10/18/2015,22,26,home,-28,MIA,236,254,50,65,10,38,Loss,63,180,6,2,2,TEN,48,299,434,4,-0.833929670398259,52.39062297477466,25.778346652188198,26.61227632258646
0.363636364,0.28571428600000004,32.2,10/18/2015,25,14,away,4,SEA,248,219,25,72,27,23,Win,135,115,3,4,0,CAR,50,383,334,2,-3.965020047899417,42.21951840435363,19.127249178227107,23.092269226126522
0.28571428600000004,0.363636364,27.8,10/18/2015,14,25,home,-4,CAR,219,248,48,60,23,27,Loss,115,135,4,3,2,SEA,50,334,383,0,3.965020047899417,42.21951840435363,23.092269226126522,19.127249178227107
0.5,0.333333333,37.98333333,10/18/2015,32,17,away,-7,GBP,488,237,76,89,20,27,Loss,60,133,3,3,0,LAC,47,548,370,1,-3.040221877626078,55.9639666178396,26.46187237010676,29.502094247732842
0.333333333,0.5,22.01666667,10/18/2015,17,32,home,7,LAC,237,488,50,49,27,20,Win,133,60,3,3,1,GBP,47,370,548,0,3.040221877626078,55.9639666178396,29.502094247732842,26.46187237010676
0.307692308,0.384615385,33.11666667,10/18/2015,25,15,away,-5,SFO,343,326,15,75,20,25,Loss,77,65,0,3,0,BAL,45,420,391,2,5.956612283601672,45.05984094141944,25.508226612510555,19.551614328908883
0.384615385,0.307692308,26.88333333,10/18/2015,15,25,home,5,BAL,326,343,25,55,25,20,Win,65,77,3,0,2,SFO,45,391,420,0,-5.956612283601672,45.05984094141944,19.551614328908883,25.508226612510555
0.41666666700000005,0.4375,27.46666667,10/18/2015,22,24,away,7,IND,301,289,72,64,34,27,Win,116,120,2,3,0,NEP,61,417,409,1,-0.603163302462197,49.87751964170731,24.637178169622555,25.240341472084754
0.4375,0.41666666700000005,32.53333333,10/18/2015,24,22,home,-7,NEP,289,301,103,75,27,34,Loss,120,116,3,2,1,IND,61,409,417,0,0.603163302462197,49.87751964170731,25.240341472084754,24.637178169622555
0.307692308,0.375,29.6,10/19/2015,18,24,away,-20,PHI,166,270,94,64,7,27,Loss,81,158,3,1,4,NYG,34,247,428,3,-7.612207256365636,50.377765871858585,21.382779307746475,28.99498656411211
0.375,0.307692308,30.4,10/19/2015,24,18,home,20,NYG,270,166,72,76,27,7,Win,158,81,1,3,3,PHI,34,428,247,4,7.612207256365636,50.377765871858585,28.99498656411211,21.382779307746475
0.384615385,0.090909091,38.08333333,10/22/2015,21,8,away,17,SFO,212,81,50,70,20,3,Win,176,61,5,6,0,SEA,23,388,142,2,6.327022421064927,27.916966808330592,17.121994614697762,10.794972193632832
0.090909091,0.384615385,21.91666667,10/22/2015,8,21,home,-17,SEA,81,212,33,45,3,20,Loss,61,176,6,5,2,SFO,23,142,388,0,-6.327022421064927,27.916966808330592,10.794972193632834,17.12199461469776
0.25,0.35714285700000004,31.36666667,10/25/2015,26,17,away,-3,JAX,260,175,87,74,31,34,Loss,115,120,4,2,1,BUF,65,375,295,4,-8.271290913510349,46.521050861631856,19.124879974060754,27.396170887571103
0.35714285700000004,0.25,28.63333333,10/25/2015,17,26,home,3,BUF,175,260,66,63,34,31,Win,120,115,2,4,4,JAX,65,295,375,1,8.271290913510349,46.521050861631856,27.396170887571103,19.124879974060754
0.583333333,0.454545455,31.3,10/25/2015,21,27,away,-1,WAS,289,305,142,60,30,31,Loss,190,50,1,1,1,TBB,61,479,355,1,-6.18392682913176,55.26109485831588,24.53858401459206,30.722510843723818
0.454545455,0.583333333,28.7,10/25/2015,27,21,home,1,TBB,305,289,20,60,31,30,Win,50,190,1,1,1,WAS,61,355,479,1,6.18392682913176,55.26109485831588,30.722510843723818,24.53858401459206
0.35714285700000004,0.111111111,34.75,10/25/2015,21,15,away,3,TEN,251,179,53,69,10,7,Win,127,77,0,1,2,ATL,17,378,256,2,-0.3461430786166648,38.826755796815206,19.24030635909927,19.586449437715935
0.111111111,0.35714285700000004,25.25,10/25/2015,15,21,home,-3,ATL,179,251,45,52,7,10,Loss,77,127,1,0,2,TEN,17,256,378,2,0.3461430786166648,38.826755796815206,19.586449437715935,19.24030635909927
0.35,0.23076923100000002,38.38333333,10/25/2015,22,15,away,6,IND,266,301,100,83,27,21,Win,183,75,2,4,3,NOS,48,449,376,1,-8.923842197581944,46.18693819041981,18.63154799641893,27.55539019400088
0.23076923100000002,0.35,21.61666667,10/25/2015,15,22,home,-6,NOS,301,266,42,61,21,27,Loss,75,183,4,2,1,IND,48,376,449,3,8.923842197581944,46.18693819041981,27.55539019400088,18.63154799641893
0.384615385,0.1,36.45,10/25/2015,25,14,away,9,DET,285,197,31,74,28,19,Win,140,77,4,7,0,MIN,47,425,274,1,5.1818185260700265,40.21682540474663,22.699321965408327,17.517503439338302
0.1,0.384615385,23.55,10/25/2015,14,25,home,-9,MIN,197,285,30,50,19,28,Loss,77,140,7,4,1,DET,47,274,425,0,-5.1818185260700265,40.21682540474663,17.517503439338302,22.699321965408327
0.2,0.5625,27.56666667,10/25/2015,18,18,away,-10,KCC,192,239,5,55,13,23,Loss,147,138,2,2,0,PIT,36,339,377,3,4.128186549397816,42.36198543780306,23.245085993600437,19.11689944420262
0.5625,0.2,32.43333333,10/25/2015,18,18,home,10,PIT,239,192,66,63,23,13,Win,138,147,2,2,3,KCC,36,377,339,0,-4.128186549397816,42.36198543780306,19.11689944420262,23.245085993600437
0.25,0.111111111,35.55,10/25/2015,19,16,away,-18,LAR,282,150,98,65,6,24,Loss,82,158,4,2,1,CLE,30,364,308,4,1.5867152908573612,40.74926569807405,21.167990494465705,19.581275203608342
0.111111111,0.25,24.45,10/25/2015,16,19,home,18,CLE,150,282,75,51,24,6,Win,158,82,2,4,4,LAR,30,308,364,1,-1.5867152908573612,40.74926569807405,19.581275203608342,21.167990494465705
0.4,0.111111111,27.91666667,10/25/2015,24,21,away,-18,MIA,251,255,25,78,26,44,Loss,71,248,4,4,1,HOU,70,322,503,1,-3.1334520289538084,45.816381981170125,21.341464976108156,24.474917005061968
0.111111111,0.4,32.08333333,10/25/2015,21,24,home,18,HOU,255,251,52,59,44,26,Win,248,71,4,4,1,MIA,70,503,322,1,3.1334520289538084,45.816381981170125,24.474917005061968,21.341464976108156
0.571428571,0.5,33.05,10/25/2015,25,20,away,-7,NEP,283,337,29,70,23,30,Loss,89,16,2,3,0,NYJ,53,372,353,1,3.0750079740755885,47.55221707991489,25.31361252699524,22.23860455291965
0.5,0.571428571,26.95,10/25/2015,20,25,home,7,NYJ,337,283,38,66,30,23,Win,16,89,3,2,1,NEP,53,353,372,0,-3.0750079740755885,47.55221707991489,22.23860455291965,25.31361252699524
0.41666666700000005,0.5,30.81666667,10/25/2015,19,28,away,8,LAC,282,327,136,58,37,29,Win,130,90,1,1,2,OAK,66,412,417,0,-14.663880389218587,56.18795934519502,20.762039477988218,35.4259198672068
0.5,0.41666666700000005,29.18333333,10/25/2015,28,19,home,-8,OAK,327,282,86,80,29,37,Loss,90,130,1,1,0,LAC,66,417,412,2,14.663880389218587,56.18795934519502,35.4259198672068,20.762039477988218
0.545454545,0.272727273,38.06666667,10/25/2015,27,13,away,-7,NYG,227,157,46,69,20,27,Loss,233,132,1,2,0,DAL,47,460,289,4,1.3600241101276307,47.9805177006728,24.670270905400216,23.310246795272583
0.272727273,0.545454545,21.93333333,10/25/2015,13,27,home,7,DAL,157,227,13,51,27,20,Win,132,233,2,1,4,NYG,47,289,460,0,-1.3600241101276307,47.9805177006728,23.310246795272583,24.670270905400216
0.38888888899999996,0.222222222,31.1,10/25/2015,20,21,away,-11,CAR,172,190,46,81,16,27,Loss,177,204,5,1,3,PHI,43,349,394,1,-7.543152286287934,47.42331213383228,19.940079923772174,27.48323221006011
0.222222222,0.38888888899999996,28.9,10/25/2015,21,20,home,11,PHI,190,172,43,58,27,16,Win,204,177,1,5,1,CAR,43,394,349,3,7.543152286287934,47.42331213383228,27.48323221006011,19.940079923772174
0.384615385,0.41666666700000005,30.4,10/26/2015,18,21,away,-8,ARI,221,264,64,59,18,26,Loss,55,150,3,2,0,BAL,44,276,414,2,8.471909076623467,41.62245823948409,25.04718365805378,16.57527458143031
0.41666666700000005,0.384615385,29.6,10/26/2015,21,18,home,8,BAL,264,221,40,59,26,18,Win,150,55,2,3,2,ARI,44,414,276,0,-8.471909076623467,41.62245823948409,16.57527458143031,25.04718365805378
0.181818182,0.25,27.38333333,10/29/2015,18,24,away,-29,NEP,255,342,40,62,7,36,Loss,15,95,5,2,0,MIA,43,270,437,2,11.700801447517758,40.68772021289526,26.19426083020651,14.49345938268875
0.25,0.181818182,32.61666667,10/29/2015,24,18,home,29,MIA,342,255,69,66,36,7,Win,95,15,2,5,2,NEP,43,437,270,0,-11.700801447517758,40.68772021289526,14.493459382688748,26.19426083020651
0.166666667,0.615384615,25.76666667,11/1/2015,16,24,away,-35,KCC,195,134,81,58,10,45,Loss,81,206,6,3,0,DET,55,276,340,2,2.211301514871174,39.94747632524928,21.07938892006023,18.868087405189055
0.615384615,0.166666667,34.23333333,11/1/2015,24,16,home,35,DET,134,195,20,63,45,10,Win,206,81,3,6,2,KCC,55,340,276,0,-2.211301514871174,39.94747632524928,18.868087405189055,21.07938892006023
0.46153846200000004,0.5,30.18333333,11/1/2015,21,28,away,3,ATL,173,395,43,63,3,0,Win,117,101,2,1,4,TBB,3,290,496,0,-8.973532474176348,46.97567215562799,19.00106984072582,27.97460231490217
0.5,0.46153846200000004,39.08333333,11/1/2015,28,21,home,-3,TBB,395,173,124,73,0,3,Loss,101,117,1,2,0,ATL,3,496,290,4,8.973532474176348,46.97567215562799,27.97460231490217,19.00106984072582
0.8125,0.5625,34.38333333,11/1/2015,25,16,away,14,CLE,372,215,25,77,34,20,Win,119,39,1,1,2,ARI,54,491,254,4,-8.102965525507994,50.52122954955574,21.209132012023872,29.31209753753187
0.5625,0.8125,25.61666667,11/1/2015,16,25,home,-14,ARI,215,372,35,61,20,34,Loss,39,119,1,1,4,CLE,54,254,491,2,8.102965525507994,50.52122954955574,29.31209753753187,21.209132012023872
0.176470588,0.083333333,28.03333333,11/1/2015,11,16,away,-21,LAR,151,191,93,65,6,27,Loss,38,197,3,0,1,SFO,33,189,388,0,-13.466906612134533,27.555879611180643,7.044486499523053,20.51139311165759
0.083333333,0.176470588,31.96666667,11/1/2015,16,11,home,21,SFO,191,151,93,64,27,6,Win,197,38,0,3,0,LAR,33,388,189,1,13.466906612134533,27.555879611180643,20.51139311165759,7.044486499523055
0.125,0.636363636,25.08333333,11/1/2015,28,35,away,-3,NOS,329,505,53,65,49,52,Loss,87,103,3,0,2,NYG,101,416,608,1,2.595964847452972,68.3530137587828,35.474489303117885,32.87852445566491
0.636363636,0.125,34.91666667,11/1/2015,35,28,home,3,NYG,505,329,93,76,52,49,Win,103,87,0,3,1,NOS,101,608,416,2,-2.595964847452972,68.3530137587828,32.87852445566491,35.474489303117885
0.41666666700000005,0.25,27.3,11/1/2015,17,18,away,3,CHI,180,208,35,56,23,20,Win,147,97,1,1,0,MIN,43,327,305,1,1.2382135392263394,38.28549699817769,19.761855268702014,18.523641729475678
0.25,0.41666666700000005,32.7,11/1/2015,18,17,home,-3,MIN,208,180,38,59,20,23,Loss,97,147,1,1,1,CHI,43,305,327,0,-1.2382135392263394,38.28549699817769,18.523641729475678,19.761855268702014
0.538461538,0.41666666700000005,30.1,11/1/2015,22,23,away,-3,BAL,290,293,66,64,26,29,Loss,81,72,1,3,0,LAC,55,371,365,0,0.8920195271725695,45.08923176171021,22.99062564444139,22.09860611726882
0.41666666700000005,0.538461538,29.9,11/1/2015,23,22,home,3,LAC,293,290,46,65,29,26,Win,72,81,3,1,0,BAL,55,365,371,0,-0.8920195271725695,45.08923176171021,22.09860611726882,22.99062564444139
0.26666666699999997,0.272727273,29.85,11/1/2015,16,21,away,6,PIT,218,240,94,64,16,10,Win,78,116,3,3,3,CIN,26,296,356,2,-2.4310394241353355,41.00093038488811,19.284945480376386,21.71598490451172
0.272727273,0.26666666699999997,30.15,11/1/2015,21,16,home,-6,CIN,240,218,91,67,10,16,Loss,116,78,3,3,2,PIT,26,356,296,3,2.4310394241353355,41.00093038488811,21.71598490451172,19.284945480376386
0.083333333,0.26666666699999997,31.13333333,11/1/2015,15,14,away,-14,HOU,125,214,45,58,6,20,Loss,86,56,7,3,0,TEN,26,211,270,3,-5.11822751139438,30.4167045929557,12.649238540780662,17.76746605217504
0.26666666699999997,0.083333333,28.86666667,11/1/2015,14,15,home,14,TEN,214,125,85,61,20,6,Win,56,86,3,7,3,HOU,26,270,211,0,5.11822751139438,30.4167045929557,17.76746605217504,12.64923854078066
0.4375,0.4,29.36666667,11/1/2015,22,21,away,-14,OAK,292,333,40,71,20,34,Loss,74,118,3,0,0,NYJ,54,366,451,1,-6.101123829049456,53.61500238452874,23.75693927773964,29.858063106789096
0.4,0.4375,30.63333333,11/1/2015,21,22,home,14,NYJ,333,292,61,61,34,20,Win,118,74,0,3,1,OAK,54,451,366,0,6.101123829049456,53.61500238452874,29.858063106789096,23.75693927773964
0.41666666700000005,0.28571428600000004,29.63333333,11/1/2015,19,14,away,1,DAL,210,91,40,61,13,12,Win,113,129,0,1,0,SEA,25,323,220,1,-0.11098556520763037,30.758617047285288,15.323815741038828,15.43480130624646
0.28571428600000004,0.41666666700000005,30.36666667,11/1/2015,14,19,home,-1,SEA,91,210,40,57,12,13,Loss,129,113,1,0,1,DAL,25,220,323,0,0.11098556520763037,30.758617047285288,15.43480130624646,15.323815741038828
0.25,0.5,26.55,11/1/2015,14,24,away,-19,DEN,50,340,15,46,10,29,Loss,90,160,3,0,1,GBP,39,140,500,0,10.599312768753663,45.159258561865116,27.87928566530939,17.279972896555726
0.5,0.25,33.45,11/1/2015,24,14,home,19,GBP,340,50,93,63,29,10,Win,160,90,0,3,0,DEN,39,500,140,1,-10.599312768753663,45.159258561865116,17.279972896555726,27.87928566530939
0.333333333,0.25,36.0,11/2/2015,19,17,away,-3,CAR,223,239,15,84,3,6,Loss,136,140,2,2,3,IND,9,359,379,4,-19.256947024465784,39.731369205571745,10.237211090552982,29.494158115018763
0.25,0.333333333,33.63333333,11/2/2015,17,19,home,3,IND,239,223,55,73,6,3,Win,140,136,2,2,4,CAR,9,379,359,3,19.256947024465784,39.731369205571745,29.494158115018763,10.23721109055298
0.307692308,0.571428571,23.95,11/5/2015,13,23,away,-21,CIN,144,219,28,53,10,31,Loss,69,152,3,2,0,CLE,41,213,371,0,3.4996779349987843,34.059508236535464,18.779593085767125,15.279915150768339
0.571428571,0.307692308,36.05,11/5/2015,23,13,home,21,CLE,219,144,20,66,31,10,Win,152,69,2,3,0,CIN,41,371,213,0,-3.4996779349987843,34.059508236535464,15.279915150768339,18.779593085767125
0.214285714,0.333333333,27.8,11/8/2015,21,20,away,-8,CAR,331,297,87,72,29,37,Loss,71,130,5,0,1,GBP,66,402,427,2,-7.916861039646058,51.500484375800966,21.791811668077454,29.70867270772351
0.333333333,0.214285714,32.2,11/8/2015,20,21,home,8,GBP,297,331,45,66,37,29,Win,130,71,0,5,2,CAR,66,427,402,1,7.916861039646058,51.500484375800966,29.70867270772351,21.791811668077454
0.5,0.5625,22.91666667,11/8/2015,16,27,away,-17,NEP,213,299,27,56,10,27,Loss,37,161,1,0,2,WAS,37,250,460,2,0.07900438682169053,47.514049611061495,23.796526998941594,23.7175226121199
0.5625,0.5,37.08333333,11/8/2015,27,16,home,17,WAS,299,213,43,76,27,10,Win,161,37,0,1,2,NEP,37,460,250,2,-0.07900438682169053,47.514049611061495,23.7175226121199,23.796526998941594
0.384615385,0.545454545,32.35,11/8/2015,25,30,away,6,NOS,371,355,66,67,6,0,Win,112,61,0,4,2,TEN,6,483,416,1,-1.8140977924755326,58.07768666503659,28.13179443628053,29.94589222875606
0.545454545,0.384615385,32.81666667,11/8/2015,30,25,home,-6,TEN,355,371,75,70,0,6,Loss,61,112,4,0,1,NOS,6,416,483,2,1.8140977924755326,58.07768666503659,29.94589222875606,28.13179443628053
0.444444444,0.615384615,28.78333333,11/8/2015,29,18,away,-16,BUF,289,154,62,62,17,33,Loss,108,266,2,3,0,MIA,50,397,420,1,5.956818125414121,54.93224073248598,30.44452942895005,24.487711303535928
0.615384615,0.444444444,31.21666667,11/8/2015,18,29,home,16,MIA,154,289,94,51,33,17,Win,266,108,3,2,1,BUF,50,420,397,0,-5.956818125414121,54.93224073248598,24.487711303535928,30.44452942895005
0.125,0.23076923100000002,32.45,11/8/2015,18,21,away,-3,MIN,160,148,87,70,0,3,Loss,160,145,1,1,1,LAR,3,320,293,0,-9.90157831581067,31.56324198159345,10.830831832891391,20.73241014870206
0.23076923100000002,0.125,33.21666667,11/8/2015,21,18,home,3,LAR,148,160,67,63,3,0,Win,145,160,1,1,0,MIN,3,293,320,1,9.90157831581067,31.56324198159345,20.73241014870206,10.83083183289139
0.4375,0.333333333,29.26666667,11/8/2015,19,14,away,-5,NYJ,338,261,30,65,23,28,Loss,98,29,6,2,0,JAX,51,436,290,4,-4.854841197911988,45.95215050400476,20.548654653046388,25.403495850958375
0.333333333,0.4375,30.73333333,11/8/2015,14,19,home,5,JAX,261,338,41,64,28,23,Win,29,98,2,6,4,NYJ,51,290,436,0,4.854841197911988,45.95215050400476,25.403495850958375,20.548654653046388
0.428571429,0.352941176,27.93333333,11/8/2015,24,27,away,-3,PIT,301,402,21,69,35,38,Loss,139,195,0,1,2,OAK,73,440,597,4,-7.3309520883029595,65.36991752169483,29.019482716695933,36.3504348049989
0.352941176,0.428571429,32.06666667,11/8/2015,27,24,home,3,OAK,402,301,42,81,38,35,Win,195,139,1,0,4,PIT,73,597,440,2,7.3309520883029595,65.36991752169483,36.3504348049989,29.019482716695936
0.5625,0.46153846200000004,34.91666667,11/8/2015,24,19,away,14,TBB,213,247,49,73,32,18,Win,114,136,0,0,3,NYG,50,327,383,2,-11.508464152095387,51.49002649490712,19.990781171405867,31.499245323501253
0.46153846200000004,0.5625,25.08333333,11/8/2015,19,24,home,-14,NYG,247,213,79,59,18,32,Loss,136,114,0,0,2,TBB,50,383,327,3,11.508464152095387,51.49002649490712,31.499245323501253,19.990781171405867
0.333333333,0.428571429,32.13333333,11/8/2015,17,18,away,-1,SFO,285,185,63,61,16,17,Loss,17,133,2,0,2,ATL,33,302,318,0,-2.7528250549369906,36.33557268673021,16.79137381589661,19.5441988708336
0.428571429,0.333333333,27.86666667,11/8/2015,18,17,home,1,ATL,185,285,30,64,17,16,Win,133,17,0,2,0,SFO,33,318,302,2,2.7528250549369906,36.33557268673021,19.5441988708336,16.79137381589661
0.5,0.6,21.35,11/8/2015,16,27,away,-3,IND,274,245,56,51,24,27,Loss,35,120,1,1,0,DEN,51,309,365,2,0.13090689611422412,49.550112317080526,24.840509606597376,24.70960271048315
0.6,0.5,38.65,11/8/2015,27,16,home,3,DEN,245,274,30,77,27,24,Win,120,35,1,1,2,IND,51,365,309,0,-0.13090689611422412,49.550112317080526,24.70960271048315,24.840509606597376
0.23076923100000002,0.5,25.7,11/8/2015,25,25,away,6,DAL,287,277,70,72,6,0,Win,172,134,1,4,1,PHI,6,459,411,0,-5.785562284724621,49.004662684060264,21.609550199667822,27.395112484392442
0.5,0.23076923100000002,38.31666667,11/8/2015,25,25,home,-6,PHI,277,287,58,71,0,6,Loss,134,172,4,1,0,DAL,6,411,459,1,5.785562284724621,49.004662684060264,27.395112484392442,21.609550199667822
0.6,0.538461538,33.58333333,11/9/2015,25,19,away,3,LAC,337,262,55,70,22,19,Win,109,77,1,2,1,CHI,41,446,339,2,-8.609040664599611,52.0292274779946,21.710093406697496,30.319134071297107
0.538461538,0.6,26.41666667,11/9/2015,19,25,home,-3,CHI,262,337,54,63,19,22,Loss,77,109,2,1,2,LAC,41,339,446,1,8.609040664599611,52.0292274779946,30.319134071297107,21.710093406697496
0.3125,0.23076923100000002,33.26666667,11/12/2015,13,15,away,5,NYJ,132,190,44,64,22,17,Win,148,128,4,1,4,BUF,39,280,318,0,-1.724912478052417,36.16126560794152,17.218176564944553,18.94308904299697
0.23076923100000002,0.3125,26.73333333,11/12/2015,15,13,home,-5,BUF,190,132,20,59,17,22,Loss,128,148,1,4,0,NYJ,39,318,280,4,1.724912478052417,36.16126560794152,18.94308904299697,17.218176564944553
0.3125,0.473684211,30.66666667,11/15/2015,16,22,away,2,GBP,242,325,35,64,18,16,Win,45,47,0,3,0,DET,34,287,372,1,-12.358325173123756,41.03419317267857,14.337933999777405,26.696259172901165
0.473684211,0.3125,29.33333333,11/15/2015,22,16,home,-2,DET,325,242,55,82,16,18,Loss,47,45,3,0,1,GBP,34,372,287,0,12.358325173123756,41.03419317267857,26.696259172901165,14.337933999777407
0.307692308,0.333333333,30.06666667,11/15/2015,12,23,away,-4,TBB,174,246,65,53,6,10,Loss,42,84,3,2,2,DAL,16,216,330,1,-4.954006692651975,34.86798004408344,14.956986675715733,19.910993368367706
0.333333333,0.307692308,29.93333333,11/15/2015,23,12,home,4,DAL,246,174,62,67,10,6,Win,84,42,2,3,1,TBB,16,330,216,2,4.954006692651975,34.86798004408344,19.910993368367706,14.956986675715733
0.538461538,0.41666666700000005,35.91666667,11/15/2015,24,11,away,17,TEN,184,178,45,64,27,10,Win,119,64,5,1,2,CAR,37,303,242,0,-1.2527729687869424,42.17441366739474,20.460820349303898,21.71359331809084
0.41666666700000005,0.538461538,24.08333333,11/15/2015,11,24,home,-17,CAR,178,184,30,46,10,27,Loss,64,119,1,5,0,TEN,37,242,303,2,1.2527729687869424,42.17441366739474,21.71359331809084,20.460820349303898
0.25,0.28571428600000004,34.36666667,11/15/2015,17,12,away,24,LAR,244,191,44,63,37,13,Win,153,94,2,1,2,CHI,50,397,285,2,-6.270735602378139,39.506541016466805,16.617902707044333,22.888638309422472
0.28571428600000004,0.25,25.63333333,11/15/2015,12,17,home,-24,CHI,191,244,57,59,13,37,Loss,94,153,1,2,2,LAR,50,285,397,2,6.270735602378139,39.506541016466805,22.888638309422472,16.617902707044333
0.363636364,0.545454545,26.43333333,11/15/2015,16,23,away,-33,WAS,192,301,50,55,14,47,Loss,158,209,2,3,0,NOS,61,350,510,2,3.845170682088664,50.59427289287303,27.219721787480847,23.374551105392182
0.545454545,0.363636364,33.56666667,11/15/2015,23,16,home,33,NOS,301,192,26,59,47,14,Win,209,158,3,2,2,WAS,61,510,350,0,-3.845170682088664,50.59427289287303,23.374551105392182,27.219721787480847
0.333333333,0.38888888899999996,28.88333333,11/15/2015,15,29,away,1,PHI,190,353,84,66,20,19,Win,99,83,4,4,1,MIA,39,289,436,0,-12.612355307098708,42.383054172572656,14.885349432736973,27.497704739835683
0.38888888899999996,0.333333333,31.11666667,11/15/2015,29,15,home,-1,MIA,353,190,54,87,19,20,Loss,83,99,4,4,0,PHI,39,436,289,1,12.612355307098708,42.383054172572656,27.497704739835683,14.885349432736973
0.384615385,0.3,32.71666667,11/15/2015,20,22,away,-21,PIT,327,399,188,65,9,30,Loss,15,60,6,1,2,CLE,39,342,459,3,0.30948787170892444,51.6091592335871,25.959323552648012,25.649835680939088
0.3,0.384615385,27.28333333,11/15/2015,22,20,home,21,CLE,399,327,50,59,30,9,Win,60,15,1,6,3,PIT,39,459,342,2,-0.30948787170892444,51.6091592335871,25.649835680939088,25.959323552648012
0.25,0.571428571,30.53333333,11/15/2015,22,22,away,2,BAL,168,308,30,70,22,20,Win,90,89,3,1,4,JAX,42,258,397,1,-5.1790336746628345,46.33955199945048,20.580259162393823,25.759292837056655
0.571428571,0.25,29.46666667,11/15/2015,22,22,home,-2,JAX,308,168,121,67,20,22,Loss,89,90,1,3,1,BAL,42,397,258,4,5.1790336746628345,46.33955199945048,25.759292837056655,20.580259162393823
0.363636364,0.5,33.01666667,11/15/2015,21,20,away,16,OAK,122,287,15,59,30,14,Win,263,84,4,2,2,MIN,44,385,371,0,-1.7729350384064375,50.556542785417186,24.391803873505374,26.16473891191181
0.5,0.363636364,26.98333333,11/15/2015,20,21,home,-16,MIN,287,122,82,64,14,30,Loss,84,263,2,4,0,OAK,44,371,385,2,1.7729350384064375,50.556542785417186,26.16473891191181,24.391803873505374
0.5,0.46666666700000003,31.6,11/15/2015,22,21,away,1,NYG,329,342,93,68,27,26,Win,77,80,3,3,1,NEP,53,406,422,2,-1.0606360500391538,53.05980429962326,25.99958412479205,27.06022017483121
0.46666666700000003,0.5,28.4,11/15/2015,21,22,home,-1,NEP,342,329,49,70,26,27,Loss,80,77,3,3,2,NYG,53,422,406,1,1.0606360500391538,53.05980429962326,27.06022017483121,25.99958412479205
0.25,0.214285714,33.45,11/15/2015,13,18,away,16,DEN,197,152,102,65,29,13,Win,106,69,2,5,5,KCC,42,303,221,0,-4.445590597479001,33.41147682457904,14.482943113550022,18.92853371102902
0.214285714,0.25,26.55,11/15/2015,18,13,home,-16,KCC,152,197,55,65,13,29,Loss,69,106,5,2,0,DEN,42,221,303,5,4.445590597479001,33.41147682457904,18.92853371102902,14.48294311355002
0.470588235,0.125,38.86666667,11/15/2015,30,18,away,7,SEA,334,228,66,83,39,32,Win,117,115,3,2,1,ARI,71,451,343,3,-0.9114056044532013,48.31635607601086,23.70247523577883,24.61388084023203
0.125,0.470588235,21.13333333,11/15/2015,18,30,home,-7,ARI,228,334,131,52,32,39,Loss,115,117,2,3,3,SEA,71,343,451,1,0.9114056044532013,48.31635607601086,24.61388084023203,23.70247523577883
0.333333333,0.28571428600000004,28.56666667,11/16/2015,16,16,away,4,CIN,174,182,54,61,10,6,Win,82,74,3,4,2,HOU,16,256,256,1,-3.079344159909991,33.89880327619299,15.4097295581415,18.489073718051493
0.28571428600000004,0.333333333,31.43333333,11/16/2015,16,16,home,-4,HOU,182,174,70,62,6,10,Loss,74,82,4,3,1,CIN,16,256,256,2,3.079344159909991,33.89880327619299,18.489073718051493,15.409729558141501
0.384615385,0.307692308,31.58333333,11/19/2015,22,18,away,-6,JAX,212,218,59,65,13,19,Loss,104,90,4,4,2,TEN,32,316,308,1,-5.16879885543098,43.758437539033594,19.294819341801308,24.463618197232286
0.307692308,0.384615385,28.41666667,11/19/2015,18,22,home,6,TEN,218,212,88,58,19,13,Win,90,104,4,4,1,JAX,32,308,316,2,5.16879885543098,43.758437539033594,24.463618197232286,19.294819341801308
0.363636364,0.428571429,23.96666667,11/22/2015,13,22,away,-5,DET,164,266,31,47,13,18,Loss,52,109,1,4,0,OAK,31,216,375,0,-0.8956025466635218,41.54892886774982,20.32666316054315,21.222265707206674
0.428571429,0.363636364,36.03333333,11/22/2015,22,13,home,5,OAK,266,164,55,70,18,13,Win,109,52,4,1,0,DET,31,375,216,0,0.8956025466635218,41.54892886774982,21.222265707206674,20.32666316054315
0.5,0.5,32.65,11/22/2015,17,21,away,3,ATL,202,275,42,61,24,21,Win,74,100,2,1,4,IND,45,276,375,3,-4.579308774214112,47.10909761806689,21.26489442192639,25.8442031961405
0.5,0.5,27.35,11/22/2015,21,17,home,-3,IND,275,202,69,71,21,24,Loss,100,74,1,2,3,ATL,45,375,276,4,4.579308774214112,47.10909761806689,25.8442031961405,21.26489442192639
0.214285714,0.38888888899999996,26.68333333,11/22/2015,16,19,away,-7,HOU,197,241,54,63,17,24,Loss,70,123,3,1,1,NYJ,41,267,364,2,-11.92052625338135,38.93005650596802,13.504765126293336,25.425291379674682
0.38888888899999996,0.214285714,33.31666667,11/22/2015,19,16,home,7,NYJ,241,197,54,73,24,17,Win,123,70,1,3,2,HOU,41,364,267,1,11.92052625338135,38.93005650596802,25.425291379674682,13.504765126293334
0.625,0.46666666700000003,35.9,11/22/2015,25,21,away,28,PHI,238,247,82,72,45,17,Win,283,136,1,3,4,TBB,62,521,383,1,-11.669236558254475,58.100142146920604,23.21545279433306,34.88468935258754
0.46666666700000003,0.625,24.1,11/22/2015,21,25,home,-28,TBB,247,238,25,72,17,45,Loss,136,283,3,1,1,PHI,62,383,521,4,11.669236558254475,58.100142146920604,34.88468935258754,23.215452794333064
0.428571429,0.333333333,33.21666667,11/22/2015,21,19,away,2,CHI,219,261,118,68,17,15,Win,170,86,5,2,2,DEN,32,389,347,0,-1.3609606682953057,46.081002444871466,22.36002088828808,23.720981556583386
0.333333333,0.428571429,26.78333333,11/22/2015,19,21,home,-2,DEN,261,219,0,59,15,17,Loss,86,170,2,5,0,CHI,32,347,389,2,1.3609606682953057,46.081002444871466,23.720981556583386,22.36002088828808
0.23076923100000002,0.25,27.13333333,11/22/2015,13,16,away,-3,BAL,131,292,35,56,13,16,Loss,82,96,1,1,2,LAR,29,213,388,4,-6.063265470078776,36.8754239758782,15.406079252899712,21.469344722978487
0.25,0.23076923100000002,32.86666667,11/22/2015,16,13,home,3,LAR,292,131,137,73,16,13,Win,96,82,1,1,4,BAL,29,388,213,2,6.063265470078776,36.8754239758782,21.469344722978487,15.406079252899712
0.5,0.1,38.83333333,11/22/2015,22,9,away,10,MIA,220,140,79,68,24,14,Win,166,70,2,3,1,DAL,38,386,210,2,3.1305697552525764,35.90668478049132,19.51862726787195,16.38805751261937
0.1,0.5,21.16666667,11/22/2015,9,22,home,-10,DAL,140,220,74,41,14,24,Loss,70,166,3,2,2,MIA,38,210,386,1,-3.1305697552525764,35.90668478049132,16.38805751261937,19.51862726787195
0.222222222,0.5,21.88333333,11/22/2015,9,27,away,-28,CAR,172,226,68,47,16,44,Loss,14,142,5,2,0,WAS,60,186,368,5,-8.24804650174211,41.30533414538097,16.52864382181943,24.77669032356154
0.5,0.222222222,38.11666667,11/22/2015,27,9,home,28,WAS,226,172,66,75,44,16,Win,142,14,2,5,5,CAR,60,368,186,0,8.24804650174211,41.30533414538097,24.77669032356154,16.52864382181943
0.41666666700000005,0.307692308,33.46666667,11/22/2015,22,14,away,30,LAC,232,149,35,59,33,3,Win,153,52,3,3,2,KCC,36,385,201,0,2.8442957877485853,36.028462192940644,19.436378990344615,16.59208320259603
0.307692308,0.41666666700000005,26.53333333,11/22/2015,14,22,home,-30,KCC,149,232,39,58,3,33,Loss,52,153,3,3,0,LAC,36,201,385,2,-2.8442957877485853,36.028462192940644,16.59208320259603,19.436378990344615
0.375,0.384615385,30.36666667,11/22/2015,19,16,away,17,MIN,196,248,19,70,30,13,Win,124,94,2,6,1,GBP,43,320,342,0,-6.638573224844528,39.98672163473264,16.674074204944056,23.312647429788584
0.384615385,0.375,29.63333333,11/22/2015,16,19,home,-17,GBP,248,196,110,62,13,30,Loss,94,124,6,2,0,MIN,43,342,320,1,6.638573224844528,39.98672163473264,23.312647429788584,16.674074204944056
0.181818182,0.571428571,22.35,11/22/2015,14,28,away,-16,SEA,247,253,42,52,13,29,Loss,59,255,2,2,0,SFO,42,306,508,0,1.3135655603275893,43.92659787161145,22.62008171596952,21.30651615564193
0.571428571,0.181818182,37.65,11/22/2015,28,14,home,16,SFO,253,247,51,75,29,13,Win,255,59,2,2,0,SEA,42,508,306,0,-1.3135655603275893,43.92659787161145,21.30651615564193,22.62008171596952
0.384615385,0.454545455,31.25,11/22/2015,24,21,away,-3,ARI,278,301,108,71,31,34,Loss,99,82,4,2,2,CIN,65,377,383,1,1.9498942951618305,48.50679206887385,25.22834318201784,23.278448886856008
0.454545455,0.384615385,28.75,11/22/2015,21,24,home,3,CIN,301,278,40,58,34,31,Win,82,99,2,4,1,ARI,65,383,377,2,-1.9498942951618305,48.50679206887385,23.278448886856008,25.22834318201784
0.2,0.28571428600000004,32.91666667,11/23/2015,16,18,away,-7,NEP,225,271,44,68,13,20,Loss,94,85,2,1,1,BUF,33,319,356,1,3.703248124539064,37.78971808699641,20.746483105767737,17.04323498122867
0.28571428600000004,0.2,27.08333333,11/23/2015,18,16,home,7,BUF,271,225,61,62,20,13,Win,85,94,1,2,1,NEP,33,356,319,1,-3.703248124539064,37.78971808699641,17.04323498122867,20.746483105767737
0.428571429,0.5,22.81666667,11/26/2015,14,28,away,-31,DET,159,322,30,58,14,45,Loss,68,108,6,2,0,PHI,59,227,430,1,2.595700688818635,45.556964866527146,24.07633277767289,21.480632088854257
0.5,0.428571429,37.18333333,11/26/2015,28,14,home,31,PHI,322,159,29,70,45,14,Win,108,68,2,6,1,DET,59,430,227,0,-2.595700688818635,45.556964866527146,21.480632088854257,24.07633277767289
0.5,0.46153846200000004,35.23333333,11/26/2015,18,14,away,19,DAL,165,179,53,65,33,14,Win,129,31,1,2,3,CAR,47,294,210,0,-9.332303505292463,36.95416000522489,13.810928249966214,23.14323175525868
0.46153846200000004,0.5,24.76666667,11/26/2015,14,18,home,-19,CAR,179,165,40,56,14,33,Loss,31,129,2,1,0,DAL,47,210,294,3,9.332303505292463,36.95416000522489,23.14323175525868,13.810928249966214
0.35714285700000004,0.272727273,31.2,11/26/2015,17,23,away,4,GBP,189,188,95,63,17,13,Win,101,177,1,2,2,CHI,30,290,365,0,-9.186428910520481,40.73105898708998,15.772315038284749,24.958743948805232
0.272727273,0.35714285700000004,28.8,11/26/2015,23,17,home,-4,CHI,188,189,38,73,13,17,Loss,177,101,2,1,0,GBP,30,365,290,2,9.186428910520481,40.73105898708998,24.958743948805232,15.772315038284749
0.25,0.46153846200000004,23.61666667,11/29/2015,14,23,away,-18,HOU,218,195,82,56,6,24,Loss,50,167,2,1,1,NOS,30,268,362,1,-2.637531784955881,40.86099219343268,19.1117302042384,21.74926198919428
0.46153846200000004,0.25,36.38333333,11/29/2015,23,14,home,18,NOS,195,218,40,66,24,6,Win,167,50,1,2,1,HOU,30,362,268,1,2.637531784955881,40.86099219343268,21.74926198919428,19.1117302042384
0.4,0.3,29.88333333,11/29/2015,19,19,away,-24,CIN,251,236,45,71,7,31,Loss,94,140,1,0,1,LAR,38,345,376,3,-2.5086863032485596,45.07496064285161,21.283137169801524,23.791823473050083
0.3,0.4,30.11666667,11/29/2015,19,19,home,24,LAR,236,251,35,59,31,7,Win,140,94,0,1,3,CIN,38,376,345,1,2.5086863032485596,45.07496064285161,23.791823473050083,21.283137169801524
0.583333333,0.454545455,33.46666667,11/29/2015,24,22,away,10,ATL,174,210,53,67,20,10,Win,191,116,0,2,3,MIN,30,365,326,1,-0.641660698787847,48.984985928059615,24.171662614635885,24.81332331342373
0.454545455,0.583333333,26.53333333,11/29/2015,22,24,home,-10,MIN,210,174,78,57,10,20,Loss,116,191,2,0,1,ATL,30,326,365,3,0.641660698787847,48.984985928059615,24.81332331342373,24.171662614635885
0.2,0.26666666699999997,24.0,11/29/2015,17,18,away,-6,WAS,299,302,35,67,14,20,Loss,33,105,3,0,0,NYG,34,332,407,3,-10.572911874830954,42.185384218528014,15.806236171848532,26.379148046679482
0.26666666699999997,0.2,36.0,11/29/2015,18,17,home,6,NYG,302,299,80,66,20,14,Win,105,33,0,3,3,WAS,34,407,332,0,10.572911874830954,42.185384218528014,26.379148046679482,15.80623617184853
0.46153846200000004,0.4375,27.58333333,11/29/2015,21,23,away,-13,IND,212,309,95,62,12,25,Loss,132,27,5,3,0,TBB,37,344,336,1,-8.284993412580572,44.435513003401525,18.075259795410474,26.36025320799105
0.4375,0.46153846200000004,32.41666667,11/29/2015,23,21,home,13,TBB,309,212,45,71,25,12,Win,27,132,3,5,1,IND,37,336,344,0,8.284993412580572,44.435513003401525,26.36025320799105,18.075259795410474
0.41666666700000005,0.46153846200000004,30.53333333,11/29/2015,25,21,away,-8,KCC,286,255,91,67,22,30,Loss,129,158,1,1,0,BUF,52,415,413,2,-0.4403411153487351,53.040986932788215,26.30032290871974,26.740664024068476
0.46153846200000004,0.41666666700000005,29.46666667,11/29/2015,21,25,home,8,BUF,255,286,58,58,30,22,Win,158,129,1,1,2,KCC,52,413,415,0,0.4403411153487351,53.040986932788215,26.740664024068476,26.30032290871974
0.533333333,0.25,34.91666667,11/29/2015,22,19,away,3,TEN,323,205,94,69,24,21,Win,84,44,1,2,2,OAK,45,407,249,2,-5.5960224986678115,50.20244906976491,22.303213285548548,27.899235784216362
0.25,0.533333333,25.08333333,11/29/2015,19,22,home,-3,OAK,205,323,25,57,21,24,Loss,44,84,2,1,2,TEN,45,249,407,2,5.5960224986678115,50.20244906976491,27.899235784216362,22.303213285548548
0.428571429,0.333333333,31.4,11/29/2015,24,20,away,6,JAX,290,318,70,71,31,25,Win,79,102,2,2,1,LAC,56,369,420,0,-11.74619312366529,46.5726281465024,17.41321751141856,29.159410635083844
0.333333333,0.428571429,28.6,11/29/2015,20,24,home,-6,LAC,318,290,35,70,25,31,Loss,102,79,2,2,0,JAX,56,420,369,1,11.74619312366529,46.5726281465024,29.159410635083844,17.41321751141856
0.26666666699999997,0.588235294,28.73333333,11/29/2015,20,24,away,-18,NYJ,321,274,45,70,20,38,Loss,12,137,3,1,0,MIA,58,333,411,2,-7.484484808380454,46.11173480155839,19.31362499658897,26.79810980496942
0.588235294,0.26666666699999997,31.26666667,11/29/2015,24,20,home,18,MIA,274,321,40,72,38,20,Win,137,12,1,3,2,NYJ,58,411,333,0,7.484484808380454,46.11173480155839,26.79810980496942,19.31362499658897
0.5,0.0,37.45,11/29/2015,26,17,away,6,SFO,267,301,47,70,19,13,Win,70,67,1,2,2,ARI,32,337,368,0,3.0402836316578536,41.60169564488821,22.320989638273034,19.280706006615176
0.0,0.5,22.55,11/29/2015,17,26,home,-6,ARI,301,267,81,55,13,19,Loss,67,70,2,1,0,SFO,32,368,337,2,-3.0402836316578536,41.60169564488821,19.280706006615176,22.320989638273034
0.454545455,0.538461538,32.0,11/29/2015,26,21,away,-9,SEA,480,336,65,75,30,39,Loss,58,100,2,2,0,PIT,69,538,436,4,0.5583746217646421,60.41356919734339,30.485971909554017,29.927597287789375
0.538461538,0.454545455,28.0,11/29/2015,21,26,home,9,PIT,336,480,76,59,39,30,Win,100,58,2,2,4,SEA,69,436,538,0,-0.5583746217646421,60.41356919734339,29.927597287789375,30.485971909554017
0.153846154,0.25,25.95,11/29/2015,16,23,away,-6,DEN,262,254,47,61,0,6,Loss,39,179,3,3,1,NEP,6,301,433,1,5.695452249335604,38.623110471275574,22.159281360305588,16.463829110969986
0.25,0.153846154,36.51666667,11/29/2015,23,16,home,6,NEP,254,262,46,77,6,0,Win,179,39,3,3,1,DEN,6,433,301,1,-5.695452249335604,38.623110471275574,16.463829110969986,22.159281360305588
0.181818182,0.26666666699999997,29.5,11/30/2015,16,21,away,6,CLE,232,275,50,57,33,27,Win,104,63,0,2,0,BAL,60,336,338,2,6.271005948514344,35.51392679067312,20.89246636959373,14.621460421079387
0.26666666699999997,0.181818182,30.5,11/30/2015,21,16,home,-6,BAL,275,232,15,68,27,33,Loss,63,104,2,0,2,CLE,60,338,336,0,-6.271005948514344,35.51392679067312,14.621460421079387,20.89246636959373
0.25,0.375,26.93333333,12/3/2015,19,17,away,4,DET,246,205,55,63,27,23,Win,67,101,3,3,1,GBP,50,313,306,1,-2.7019455483106403,41.269831264649895,19.283942858169627,21.985888406480267
0.375,0.25,33.06666667,12/3/2015,17,19,home,-4,GBP,205,246,108,63,23,27,Loss,101,67,3,3,1,DET,50,306,313,1,2.7019455483106403,41.269831264649895,21.985888406480267,19.283942858169627
0.4,0.26666666699999997,38.51666667,12/6/2015,28,14,away,3,NYG,373,281,61,77,3,0,Win,90,74,3,3,1,NYJ,3,463,355,1,-6.868194158834625,45.45552998745121,19.29366791430829,26.161862073142917
0.26666666699999997,0.4,29.93333333,12/6/2015,14,28,home,-3,NYJ,281,373,60,61,0,3,Loss,74,90,3,3,1,NYG,3,355,463,1,6.868194158834625,45.45552998745121,26.161862073142917,19.29366791430829
0.4375,0.083333333,39.78333333,12/6/2015,29,9,away,24,LAR,349,146,25,79,27,3,Win,175,66,2,0,1,ARI,30,524,212,0,-6.103786013490371,39.96789885449864,16.932056420504136,23.035842433994507
0.083333333,0.4375,20.21666667,12/6/2015,9,29,home,-24,ARI,146,349,104,50,3,27,Loss,66,175,0,2,0,LAR,30,212,524,1,6.103786013490371,39.96789885449864,23.035842433994507,16.932056420504136
0.5,0.545454545,28.75,12/6/2015,21,25,away,-4,TBB,255,222,58,66,19,23,Loss,64,166,3,1,2,ATL,42,319,388,1,-6.948348151346206,46.92379949945054,19.987725674052164,26.936073825398374
0.545454545,0.5,31.25,12/6/2015,25,21,home,4,ATL,222,255,53,65,23,19,Win,166,64,1,3,1,TBB,42,388,319,2,6.948348151346206,46.92379949945054,26.936073825398374,19.987725674052164
0.692307692,0.2,35.16666667,12/6/2015,25,9,away,31,MIN,260,94,65,66,38,7,Win,173,31,2,4,1,SEA,45,433,125,1,1.2865268179843738,37.792788749447155,19.539657783715764,18.25313096573139
0.2,0.692307692,24.83333333,12/6/2015,9,25,home,-31,SEA,94,260,95,48,7,38,Loss,31,173,4,2,1,MIN,45,125,433,1,-1.2865268179843738,37.792788749447155,18.25313096573139,19.539657783715764
0.46666666700000003,0.5,31.88333333,12/6/2015,21,15,away,-9,BUF,275,203,89,71,21,30,Loss,126,187,2,1,0,HOU,51,401,390,1,-11.54322265658069,47.92631898358636,18.191548163502837,29.734770820083526
0.5,0.46666666700000003,28.11666667,12/6/2015,15,21,home,9,HOU,203,275,42,58,30,21,Win,187,126,1,2,1,BUF,51,390,401,0,11.54322265658069,47.92631898358636,29.734770820083526,18.191548163502837
0.35714285700000004,0.307692308,38.15,12/6/2015,22,8,away,-2,MIA,281,82,36,75,13,15,Loss,94,137,3,1,1,BAL,28,375,219,2,4.49024335459686,33.398750866268,18.94449711043243,14.454253755835571
0.307692308,0.35714285700000004,21.85,12/6/2015,8,22,home,2,BAL,82,281,31,46,15,13,Win,137,94,1,3,2,MIA,28,219,375,1,-4.49024335459686,33.398750866268,14.454253755835573,18.94449711043243
0.41666666700000005,0.46153846200000004,30.96666667,12/6/2015,20,18,away,34,CLE,233,205,55,56,37,3,Win,144,68,1,3,2,CIN,40,377,273,0,3.5263762535062195,41.57623191174305,22.551304082624636,19.024927829118415
0.46153846200000004,0.41666666700000005,29.03333333,12/6/2015,18,20,home,-34,CIN,205,233,84,60,3,37,Loss,68,144,3,1,0,CLE,40,273,377,2,-3.5263762535062195,41.57623191174305,19.024927829118415,22.551304082624636
0.7142857140000001,0.615384615,26.43333333,12/6/2015,20,26,away,-3,TEN,302,257,21,59,39,42,Loss,81,210,2,4,2,JAX,81,383,467,1,-5.127792842466762,59.34502061864296,27.1086138880881,32.23640673055486
0.615384615,0.7142857140000001,33.56666667,12/6/2015,26,20,home,3,JAX,257,302,38,68,42,39,Win,210,81,4,2,1,TEN,81,467,383,2,5.127792842466762,59.34502061864296,32.23640673055486,27.1086138880881
0.4375,0.470588235,24.76666667,12/6/2015,13,20,away,6,CHI,170,194,50,59,6,0,Win,121,170,4,1,1,SFO,6,291,364,0,-13.897376908738439,35.29539451935645,10.699008805309006,24.596385714047443
0.470588235,0.4375,37.4,12/6/2015,20,13,home,-6,SFO,194,170,72,74,0,6,Loss,170,121,1,4,0,CHI,6,364,291,1,13.897376908738439,35.29539451935645,24.596385714047443,10.699008805309006
0.46153846200000004,0.35714285700000004,32.95,12/6/2015,19,15,away,14,LAC,159,179,18,66,17,3,Win,134,93,1,4,3,DEN,20,293,272,1,-3.7296993853050076,38.294120571283074,17.28221059298903,21.011909978294042
0.35714285700000004,0.46153846200000004,27.05,12/6/2015,15,19,home,-14,DEN,179,159,72,62,3,17,Loss,93,134,4,1,1,LAC,20,272,293,3,3.7296993853050076,38.294120571283074,21.011909978294042,17.28221059298903
0.375,0.428571429,25.53333333,12/6/2015,15,27,away,14,OAK,143,262,88,48,34,20,Win,89,99,4,4,3,KCC,54,232,361,2,0.347469062839286,46.56150633181729,23.45448769732829,23.107018634489002
0.428571429,0.375,34.46666667,12/6/2015,27,15,home,-14,KCC,262,143,21,76,20,34,Loss,99,89,4,4,2,OAK,54,361,232,3,-0.347469062839286,46.56150633181729,23.107018634489002,23.45448769732829
0.375,0.3,36.56666667,12/6/2015,33,21,away,3,NOS,322,264,87,76,41,38,Win,175,70,1,2,1,CAR,79,497,334,3,-2.99339355478806,58.40248869833563,27.704547571773787,30.697941126561844
0.3,0.375,23.43333333,12/6/2015,21,33,home,-3,CAR,264,322,104,58,38,41,Loss,70,175,2,1,3,NOS,79,334,497,1,2.99339355478806,58.40248869833563,30.697941126561844,27.704547571773787
0.428571429,0.41176470600000004,25.73333333,12/6/2015,15,27,away,7,NEP,120,324,97,58,35,28,Win,128,103,1,4,2,PHI,63,248,427,1,-1.786622293359763,43.73782557898177,20.975601642811004,22.762223936170766
0.41176470600000004,0.428571429,34.26666667,12/6/2015,27,15,home,-7,PHI,324,120,30,86,28,35,Loss,103,128,4,1,1,NEP,63,427,248,2,1.786622293359763,43.73782557898177,22.762223936170766,20.975601642811004
0.214285714,0.615384615,27.16666667,12/6/2015,11,24,away,-35,PIT,186,364,30,57,10,45,Loss,54,158,5,0,2,IND,55,240,522,3,-0.21038797628077432,47.81957686326943,23.80459444349433,24.0149824197751
0.615384615,0.214285714,32.83333333,12/6/2015,24,11,home,35,IND,364,186,48,71,45,10,Win,158,54,0,5,3,PIT,55,522,240,2,0.21038797628077432,47.81957686326943,24.0149824197751,23.80459444349433
0.111111111,0.375,27.21666667,12/7/2015,16,15,away,3,WAS,221,193,70,54,19,16,Win,97,73,1,3,1,DAL,35,318,266,3,-2.9760093158614502,34.96656681810255,15.995278751120551,18.971288066981998
0.375,0.111111111,32.78333333,12/7/2015,15,16,home,-3,DAL,193,221,72,60,16,19,Loss,73,97,3,1,3,WAS,35,266,318,1,2.9760093158614502,34.96656681810255,18.971288066981998,15.99527875112055
0.545454545,0.46153846200000004,28.01666667,12/10/2015,23,22,away,-3,ARI,317,296,25,63,20,23,Loss,72,97,3,2,0,MIN,43,389,393,3,2.107753017001766,50.5433620834261,26.325557550213937,24.217804533212167
0.46153846200000004,0.545454545,31.98333333,12/10/2015,22,23,home,3,MIN,296,317,30,66,23,20,Win,97,72,2,3,3,ARI,43,393,389,0,-2.107753017001766,50.5433620834261,24.217804533212167,26.325557550213937
0.375,0.5,35.03333333,12/13/2015,18,20,away,-3,PHI,260,232,101,69,20,23,Loss,152,116,1,1,1,BUF,43,412,348,2,-12.50884150010793,48.65116748852723,18.07116299420965,30.580004494317578
0.5,0.375,24.96666667,12/13/2015,20,18,home,3,BUF,232,260,55,73,23,20,Win,116,152,1,1,2,PHI,43,348,412,1,12.50884150010793,48.65116748852723,30.580004494317578,18.07116299420965
0.153846154,0.5,22.35,12/13/2015,15,28,away,-14,CLE,150,251,40,54,10,24,Loss,71,230,9,2,2,SFO,34,221,481,0,0.8546618396530761,39.6068129369237,20.23073738828839,19.376075548635313
0.5,0.153846154,37.65,12/13/2015,28,15,home,14,SFO,251,150,71,74,24,10,Win,230,71,2,9,0,CLE,34,481,221,2,-0.8546618396530761,39.6068129369237,19.376075548635313,20.23073738828839
0.384615385,0.363636364,33.83333333,12/13/2015,22,15,away,-7,LAR,220,114,45,70,14,21,Loss,111,203,4,1,1,DET,35,331,317,1,-2.825200927302814,41.450690687697076,19.31274488019713,22.137945807499946
0.363636364,0.384615385,26.16666667,12/13/2015,15,22,home,7,DET,114,220,48,52,21,14,Win,203,111,1,4,1,LAR,35,317,331,1,2.825200927302814,41.450690687697076,22.137945807499946,19.31274488019713
0.705882353,0.363636364,37.23333333,12/13/2015,26,18,away,7,TBB,301,176,95,78,24,17,Win,87,115,2,1,0,NOS,41,388,291,0,-10.721888015359038,44.73702812236841,17.007570053504686,27.72945806886372
0.363636364,0.705882353,22.76666667,12/13/2015,18,26,home,-7,NOS,176,301,80,52,17,24,Loss,115,87,1,2,0,TBB,41,291,388,0,10.721888015359038,44.73702812236841,27.72945806886372,17.007570053504686
0.214285714,0.46666666700000003,24.06666667,12/13/2015,15,24,away,-22,NYJ,268,256,20,58,8,30,Loss,24,183,5,1,0,TEN,38,292,439,1,-2.756861063686415,43.21843840619692,20.23078867125525,22.987649734941666
0.46666666700000003,0.214285714,35.93333333,12/13/2015,24,15,home,22,TEN,256,268,20,71,30,8,Win,183,24,1,5,1,NYJ,38,439,292,0,2.756861063686415,43.21843840619692,22.987649734941666,20.23078867125525
0.571428571,0.375,35.78333333,12/13/2015,22,22,away,13,CIN,270,321,82,69,33,20,Win,84,64,2,3,3,PIT,53,354,385,1,5.283293632662437,50.841263276463295,28.062278454562865,22.77898482190043
0.375,0.571428571,24.21666667,12/13/2015,22,22,home,-13,PIT,321,270,27,56,20,33,Loss,64,84,3,2,1,CIN,53,385,354,3,-5.283293632662437,50.841263276463295,22.77898482190043,28.062278454562865
0.25,0.222222222,30.8,12/13/2015,17,24,away,-35,JAX,227,226,85,69,16,51,Loss,95,154,3,3,2,IND,67,322,380,2,-2.892506222694223,44.98792565908033,21.047709718193055,23.940215940887278
0.222222222,0.25,29.2,12/13/2015,24,17,home,35,IND,226,227,40,62,51,16,Win,154,95,3,3,2,JAX,67,380,322,2,2.892506222694223,44.98792565908033,23.940215940887278,21.047709718193055
0.333333333,0.545454545,31.13333333,12/13/2015,15,18,away,-7,KCC,236,179,48,66,3,10,Loss,44,150,5,2,2,LAC,13,280,329,1,0.626451923693395,38.694914109807996,19.660683016750696,19.0342310930573
0.545454545,0.333333333,28.86666667,12/13/2015,18,15,home,7,LAC,179,236,53,50,10,3,Win,150,44,2,5,1,KCC,13,329,280,2,-0.626451923693395,38.694914109807996,19.0342310930573,19.660683016750696
0.583333333,0.454545455,34.36666667,12/13/2015,24,20,away,3,CHI,275,290,63,67,24,21,Win,99,87,3,3,1,WAS,45,374,377,1,-6.417391324998606,49.98944505209469,21.78602686354804,28.203418188546646
0.454545455,0.583333333,25.63333333,12/13/2015,20,24,home,-3,WAS,290,275,79,56,21,24,Loss,87,99,3,3,1,CHI,45,377,374,1,6.417391324998606,49.98944505209469,28.203418188546646,21.78602686354804
0.28571428600000004,0.5,28.5,12/13/2015,15,20,away,-38,CAR,176,282,54,62,0,38,Loss,54,142,5,2,0,ATL,38,230,424,4,-4.399094772456795,43.089718440085164,19.345311833814186,23.744406606270978
0.5,0.28571428600000004,31.5,12/13/2015,20,15,home,38,ATL,282,176,60,61,38,0,Win,142,54,2,5,4,CAR,38,424,230,0,4.399094772456795,43.089718440085164,23.744406606270978,19.345311833814186
0.666666667,0.272727273,35.71666667,12/13/2015,28,16,away,29,BAL,301,274,42,69,35,6,Win,123,28,0,1,2,SEA,41,424,302,1,6.489391434926802,48.18525204324099,27.337321739083897,20.847930304157096
0.272727273,0.666666667,24.28333333,12/13/2015,16,28,home,-29,SEA,274,301,94,55,6,35,Loss,28,123,1,0,1,BAL,41,302,424,2,-6.489391434926802,48.18525204324099,20.847930304157096,27.337321739083897
0.2,0.222222222,24.03333333,12/13/2015,8,20,away,3,DEN,99,276,70,55,15,12,Win,27,34,3,5,2,OAK,27,126,310,0,-7.500262084165429,29.59115899229353,11.04544845406405,18.54571053822948
0.222222222,0.2,35.96666667,12/13/2015,20,8,home,-3,OAK,276,99,27,77,12,15,Loss,34,27,5,3,0,DEN,27,310,126,2,7.500262084165429,29.59115899229353,18.54571053822948,11.04544845406405
0.090909091,0.5,22.2,12/13/2015,11,29,away,-21,GBP,99,205,30,51,7,28,Loss,171,230,2,2,0,DAL,35,270,435,1,-5.010021417623991,39.10426709038994,17.047122836382975,22.057144254006964
0.5,0.090909091,37.8,12/13/2015,29,11,home,21,DAL,205,99,69,81,28,7,Win,230,171,2,2,1,GBP,35,435,270,0,5.010021417623991,39.10426709038994,22.057144254006964,17.047122836382975
0.4375,0.214285714,35.23333333,12/13/2015,18,7,away,21,HOU,197,102,46,64,27,6,Win,116,87,3,6,1,NEP,33,313,189,1,4.500347153916156,29.138481093062552,16.819414123489352,12.319066969573198
0.214285714,0.4375,24.76666667,12/13/2015,7,18,home,-21,NEP,102,197,36,52,6,27,Loss,87,116,6,3,1,HOU,33,189,313,1,-4.500347153916156,29.138481093062552,12.3190669695732,16.819414123489352
0.454545455,0.4375,30.51666667,12/14/2015,25,16,away,7,MIA,337,235,25,62,31,24,Win,92,128,0,1,1,NYG,55,429,363,1,-4.425206123100386,50.89499450042592,23.234894188662768,27.660100311763156
0.4375,0.454545455,29.48333333,12/14/2015,16,25,home,-7,NYG,235,337,123,64,24,31,Loss,128,92,1,0,1,MIA,55,363,429,1,4.425206123100386,50.89499450042592,27.660100311763156,23.234894188662768
0.3,0.2,31.33333333,12/17/2015,30,16,away,-8,LAR,363,221,56,77,23,31,Loss,146,98,0,2,0,TBB,54,509,319,2,-3.3745191671037578,48.73405387182169,22.67976735235897,26.054286519462725
0.2,0.3,28.66666667,12/17/2015,16,30,home,8,TBB,221,363,35,52,31,23,Win,98,146,2,0,2,LAR,54,319,509,0,3.3745191671037578,48.73405387182169,26.054286519462725,22.67976735235897
0.35714285700000004,0.181818182,32.28333333,12/19/2015,20,15,away,3,DAL,299,176,61,67,19,16,Win,73,133,2,2,4,NYJ,35,372,309,1,-0.6940855405629591,42.269263750748635,20.787589105092838,21.481674645655797
0.181818182,0.35714285700000004,27.71666667,12/19/2015,15,20,home,-3,NYJ,176,299,54,56,16,19,Loss,133,73,2,2,1,DAL,35,309,372,4,0.6940855405629591,42.269263750748635,21.481674645655797,20.787589105092838
0.41666666700000005,0.666666667,27.83333333,12/20/2015,21,20,away,-21,MIN,199,221,39,62,17,38,Loss,94,129,5,1,0,CHI,55,293,350,2,-0.1417760147136029,45.43523116316088,22.64672757422364,22.78850358893724
0.666666667,0.41666666700000005,32.16666667,12/20/2015,20,21,home,21,CHI,221,199,45,57,38,17,Win,129,94,1,5,2,MIN,55,350,293,0,0.1417760147136029,45.43523116316088,22.78850358893724,22.64672757422364
0.5,0.0,34.53333333,12/20/2015,22,21,away,6,JAX,245,285,43,69,23,17,Win,83,85,1,2,1,ATL,40,328,370,1,-1.8985128211583011,42.046954908160494,20.074221043501097,21.972733864659396
0.0,0.5,25.46666667,12/20/2015,21,22,home,-6,ATL,285,245,62,60,17,23,Loss,85,83,2,1,1,JAX,40,370,328,1,1.8985128211583011,42.046954908160494,21.972733864659396,20.074221043501097
0.333333333,0.307692308,33.93333333,12/20/2015,20,14,away,6,IND,150,140,48,68,16,10,Win,155,50,3,3,2,HOU,26,305,190,2,-4.5918136639219345,36.48186814650775,15.945027241292909,20.53684090521484
0.307692308,0.333333333,26.06666667,12/20/2015,14,20,home,-6,HOU,140,150,94,54,10,16,Loss,50,155,3,3,2,IND,26,190,305,2,4.5918136639219345,36.48186814650775,20.53684090521484,15.945027241292909
0.529411765,0.4,30.86666667,12/20/2015,28,21,away,3,NYG,309,245,88,77,38,35,Win,171,161,3,0,2,CAR,73,480,406,1,-18.780685080267723,57.61693088445425,19.41812290209326,38.19880798236099
0.4,0.529411765,29.13333333,12/20/2015,21,28,home,-3,CAR,245,309,47,73,35,38,Loss,161,171,0,3,1,NYG,73,406,480,2,18.780685080267723,57.61693088445425,38.19880798236099,19.418122902093263
0.25,0.4375,30.38333333,12/20/2015,15,17,away,-17,NEP,223,253,29,60,16,33,Loss,59,93,5,2,1,TEN,49,282,346,3,6.277472116916066,39.01814497335396,22.647808545135014,16.37033642821895
0.4375,0.25,29.61666667,12/20/2015,17,15,home,17,TEN,253,223,35,63,33,16,Win,93,59,2,5,3,NEP,49,346,282,1,-6.277472116916066,39.01814497335396,16.37033642821895,22.647808545135014
0.384615385,0.636363636,30.93333333,12/20/2015,21,23,away,-10,WAS,212,308,56,63,25,35,Loss,240,123,5,1,1,BUF,60,452,431,0,1.2582435975138697,53.88309388158921,27.57066873955154,26.31242514203767
0.636363636,0.384615385,29.06666667,12/20/2015,23,21,home,10,BUF,308,212,6,56,35,25,Win,123,240,1,5,0,WAS,60,431,452,1,-1.2582435975138697,53.88309388158921,26.31242514203767,27.57066873955154
0.384615385,0.307692308,32.31666667,12/20/2015,15,19,away,20,BAL,164,273,55,56,34,14,Win,113,93,3,2,3,KCC,48,277,366,0,2.774461214955892,37.402445534512914,20.088453374734403,17.31399215977851
0.307692308,0.384615385,27.68333333,12/20/2015,19,15,home,-20,KCC,273,164,63,67,14,34,Loss,93,113,2,3,0,BAL,48,366,277,3,-2.774461214955892,37.402445534512914,17.31399215977851,20.088453374734403
0.5,0.75,25.45,12/20/2015,15,28,away,-17,SEA,136,241,40,52,13,30,Loss,94,182,3,2,0,CLE,43,230,423,1,2.620963745253942,42.94997726017098,22.785470502712464,20.16450675745852
0.75,0.5,34.55,12/20/2015,28,15,home,17,CLE,241,136,30,68,30,13,Win,182,94,2,3,1,SEA,43,423,230,0,-2.620963745253942,42.94997726017098,20.16450675745852,22.785470502712464
0.307692308,0.294117647,29.43333333,12/20/2015,18,20,away,10,OAK,190,252,75,69,30,20,Win,103,120,2,3,2,GBP,50,293,372,2,-14.62798799758222,45.53523956641584,15.453625784416808,30.08161378199903
0.294117647,0.307692308,30.56666667,12/20/2015,20,18,home,-10,GBP,252,190,95,75,20,30,Loss,120,103,3,2,2,OAK,50,372,293,2,14.62798799758222,45.53523956641584,30.08161378199903,15.45362578441681
0.529411765,0.46666666700000003,28.73333333,12/20/2015,20,28,away,-7,PIT,281,354,127,71,27,34,Loss,104,23,2,3,2,DEN,61,385,377,2,-9.852411289286433,53.35399969351275,21.750794202113156,31.603205491399592
0.46666666700000003,0.529411765,31.26666667,12/20/2015,28,20,home,7,DEN,354,281,63,75,34,27,Win,23,104,3,2,2,PIT,61,377,385,2,9.852411289286433,53.35399969351275,31.603205491399592,21.750794202113156
0.14285714300000002,0.642857143,21.11666667,12/20/2015,13,26,away,-16,LAC,187,302,72,56,14,30,Loss,44,140,3,1,2,MIA,44,231,442,1,-4.063344673945842,41.98238692673082,18.959521126392488,23.02286580033833
0.642857143,0.14285714300000002,38.88333333,12/20/2015,26,13,home,16,MIA,302,187,48,73,30,14,Win,140,44,1,3,1,LAC,44,442,231,2,4.063344673945842,41.98238692673082,23.02286580033833,18.959521126392488
0.28571428600000004,0.14285714300000002,30.98333333,12/20/2015,14,17,away,10,SFO,174,263,45,61,24,14,Win,68,55,4,4,4,CIN,38,242,318,1,-3.231600485682211,33.11978025985016,14.944089887083976,18.175690372766184
0.14285714300000002,0.28571428600000004,29.01666667,12/20/2015,17,14,home,-10,CIN,263,174,98,71,14,24,Loss,55,68,4,4,1,SFO,38,318,242,4,3.231600485682211,33.11978025985016,18.175690372766184,14.944089887083974
0.571428571,0.5,37.46666667,12/20/2015,28,19,away,23,PHI,263,350,10,74,40,17,Win,230,74,2,2,4,ARI,57,493,424,0,0.9375146556259359,58.289890755897275,29.613702705761604,28.67618805013567
0.5,0.571428571,22.53333333,12/20/2015,19,28,home,-23,ARI,350,263,38,63,17,40,Loss,74,230,2,2,0,PHI,57,424,493,4,-0.9375146556259359,58.289890755897275,28.67618805013567,29.613702705761604
0.5,0.35714285700000004,29.6,12/21/2015,24,27,away,8,NOS,246,330,92,51,35,27,Win,150,69,3,1,0,DET,62,396,399,1,7.429431623190621,53.98836037130533,30.70889599724798,23.279464374057355
0.35714285700000004,0.5,30.4,12/21/2015,27,24,home,-8,DET,330,246,28,71,27,35,Loss,69,150,1,3,1,NOS,62,399,396,0,-7.429431623190621,53.98836037130533,23.279464374057355,30.70889599724798
0.3125,0.26666666699999997,35.06666667,12/24/2015,19,14,away,-3,OAK,271,175,75,75,0,3,Loss,72,106,1,3,1,LAC,3,343,281,1,-19.212804295048784,33.58588574558968,7.186540725270447,26.39934502031923
0.26666666699999997,0.3125,33.35,12/24/2015,14,19,home,3,LAC,175,271,121,65,3,0,Win,106,72,3,1,1,OAK,3,281,343,1,19.212804295048784,33.58588574558968,26.39934502031923,7.186540725270447
0.35714285700000004,0.36842105299999994,34.25,12/26/2015,25,23,away,14,PHI,351,353,70,74,38,24,Win,67,45,2,5,2,WAS,62,418,398,0,-11.925722174192673,49.618923948258846,18.846600887033087,30.77232306122576
0.36842105299999994,0.35714285700000004,25.75,12/26/2015,23,25,home,-14,WAS,353,351,45,77,24,38,Loss,45,67,5,2,0,PHI,62,398,418,2,11.925722174192673,49.618923948258846,30.77232306122576,18.846600887033087
0.1,0.384615385,28.55,12/27/2015,16,24,away,-6,NYJ,221,285,7,55,0,6,Loss,63,143,2,1,1,NEP,6,284,428,1,12.787092797293276,40.328495054417736,26.557793925855506,13.77070112856223
0.384615385,0.1,34.06666667,12/27/2015,24,16,home,6,NEP,285,221,39,69,6,0,Win,143,63,1,2,1,NYJ,6,428,284,1,-12.787092797293276,40.328495054417736,13.77070112856223,26.557793925855506
0.4375,0.25,36.21666667,12/27/2015,19,13,away,28,TEN,202,227,28,69,34,6,Win,128,30,1,1,4,HOU,40,330,257,1,-12.047382319271673,39.2119245661553,13.582271123441814,25.629653442713483
0.25,0.4375,23.78333333,12/27/2015,13,19,home,-28,HOU,227,202,43,63,6,34,Loss,30,128,1,1,1,TEN,40,257,330,4,12.047382319271673,39.2119245661553,25.629653442713483,13.582271123441812
0.4,0.333333333,31.06666667,12/27/2015,21,16,away,-4,KCC,136,122,83,68,13,17,Loss,232,136,0,1,1,CLE,30,368,258,1,-0.9500344939184822,36.176245962992944,17.613105734537232,18.563140228455712
0.333333333,0.4,28.93333333,12/27/2015,16,21,home,4,CLE,122,136,33,50,17,13,Win,136,232,1,0,1,KCC,30,258,368,1,0.9500344939184822,36.176245962992944,18.563140228455712,17.613105734537232
0.5,0.4,27.18333333,12/27/2015,20,22,away,6,MIA,168,279,60,54,18,12,Win,100,82,2,6,1,IND,30,268,361,0,2.2976905149645717,42.36142710426198,22.329558809613275,20.031868294648703
0.4,0.5,32.81666667,12/27/2015,22,20,home,-6,IND,279,168,50,69,12,18,Loss,82,100,6,2,0,MIA,30,361,268,1,-2.2976905149645717,42.36142710426198,20.031868294648703,22.329558809613275
0.111111111,0.333333333,23.5,12/27/2015,20,26,away,-15,DET,201,284,65,59,17,32,Loss,121,87,3,2,0,SFO,49,322,371,1,2.841587134536038,42.58657190761259,22.71407952107431,19.872492386538276
0.333333333,0.111111111,36.5,12/27/2015,26,20,home,15,SFO,284,201,71,67,32,17,Win,87,121,2,3,1,DET,49,371,322,0,-2.841587134536038,42.58657190761259,19.872492386538276,22.71407952107431
0.5,0.428571429,28.5,12/27/2015,14,19,away,-10,BUF,186,172,65,56,6,16,Loss,121,236,0,3,2,DAL,22,307,408,2,-2.872239182782744,45.39376514523601,21.260762981226634,24.133002164009376
0.428571429,0.5,31.5,12/27/2015,19,14,home,10,DAL,172,186,62,61,16,6,Win,236,121,3,0,2,BUF,22,408,307,2,2.872239182782744,45.39376514523601,24.133002164009376,21.260762981226634
0.4,0.25,37.05,12/27/2015,21,19,away,5,TBB,153,285,25,67,26,21,Win,174,104,1,1,3,CHI,47,327,389,0,-2.6228037977882694,43.728848263409816,20.553022232810772,23.175826030599044
0.25,0.4,22.95,12/27/2015,19,21,home,-5,CHI,285,153,47,55,21,26,Loss,104,174,1,1,0,TBB,47,389,327,3,2.6228037977882694,43.728848263409816,23.175826030599044,20.553022232810772
0.4,0.6,24.36666667,12/27/2015,18,21,away,-7,ATL,113,296,40,52,13,20,Loss,155,77,2,2,1,CAR,33,268,373,1,1.5747712662250484,44.75651292344955,23.1656420948373,21.59087082861225
0.6,0.4,35.63333333,12/27/2015,21,18,home,7,CAR,296,113,20,62,20,13,Win,77,155,2,2,1,ATL,33,373,268,1,-1.5747712662250484,44.75651292344955,21.59087082861225,23.1656420948373
0.25,0.5,25.66666667,12/27/2015,21,22,away,-3,BAL,198,265,25,57,17,20,Loss,110,121,3,1,0,PIT,37,308,386,3,1.6222061429424208,43.50806367928843,22.56513491111543,20.942928768173005
0.5,0.25,34.33333333,12/27/2015,22,21,home,3,PIT,265,198,121,73,20,17,Win,121,110,1,3,3,BAL,37,386,308,0,-1.6222061429424208,43.50806367928843,20.942928768173005,22.56513491111543
0.666666667,0.615384615,22.11666667,12/27/2015,21,29,away,-11,NOS,347,402,55,52,27,38,Loss,65,135,2,1,0,JAX,65,412,537,2,2.3750193780656854,64.86936865085114,33.622194014458415,31.247174636392728
0.615384615,0.666666667,37.88333333,12/27/2015,29,21,home,11,JAX,402,347,40,72,38,27,Win,135,65,1,2,2,NOS,65,537,412,0,-2.3750193780656854,64.86936865085114,31.247174636392728,33.622194014458415
0.41666666700000005,0.470588235,27.9,12/27/2015,14,18,away,6,SEA,103,253,60,53,23,17,Win,102,59,0,4,3,LAR,40,205,312,0,-4.870555321778616,36.07990499648429,15.604674837352835,20.475230159131453
0.470588235,0.41666666700000005,32.1,12/27/2015,18,14,home,-6,LAR,253,103,83,67,17,23,Loss,59,102,4,0,0,SEA,40,312,205,3,4.870555321778616,36.07990499648429,20.475230159131453,15.604674837352835
0.294117647,0.5,29.73333333,12/27/2015,16,19,away,-30,ARI,77,260,59,64,8,38,Loss,101,121,9,2,2,GBP,46,178,381,4,1.5682178875207562,41.73477928833799,21.651498587929375,20.083280700408615
0.5,0.294117647,30.26666667,12/27/2015,19,16,home,30,GBP,260,77,119,56,38,8,Win,121,101,2,9,4,ARI,46,381,178,2,-1.5682178875207562,41.73477928833799,20.083280700408615,21.651498587929375
0.090909091,0.375,25.05,12/27/2015,15,17,away,-32,MIN,272,150,48,58,17,49,Loss,91,218,4,3,0,NYG,66,363,368,3,-1.2534932371356504,40.46245632619654,19.604481544530444,20.857974781666094
0.375,0.090909091,34.95,12/27/2015,17,15,home,32,NYG,150,272,10,68,49,17,Win,218,91,3,4,3,MIN,66,368,363,0,1.2534932371356504,40.46245632619654,20.857974781666094,19.604481544530444
0.588235294,0.363636364,37.46666667,12/28/2015,22,22,away,-3,DEN,186,277,45,70,0,3,Loss,108,113,2,3,1,CIN,3,294,390,1,1.249066847231885,43.439432439873606,22.344249643552747,21.09518279632086
0.363636364,0.588235294,27.83333333,12/28/2015,22,22,home,3,CIN,277,186,40,63,3,0,Win,113,108,3,2,1,DEN,3,390,294,1,-1.249066847231885,43.439432439873606,21.09518279632086,22.344249643552747
0.272727273,0.45,20.78333333,1/3/2016,15,18,away,-5,BUF,178,182,41,55,17,22,Loss,122,113,1,2,1,NYJ,39,300,295,3,-5.052737249342323,39.72304815564439,17.335155453151035,22.387892702493357
0.45,0.272727273,39.21666667,1/3/2016,18,15,home,5,NYJ,182,178,45,73,22,17,Win,113,122,2,1,3,BUF,39,295,300,1,5.052737249342323,39.72304815564439,22.387892702493357,17.335155453151035
0.28571428600000004,0.470588235,28.91666667,1/3/2016,12,20,away,-10,MIA,126,342,41,54,10,20,Loss,70,96,2,1,0,NEP,30,196,438,0,0.4137569353248356,34.35205049384032,17.38290371458258,16.969146779257745
0.470588235,0.28571428600000004,31.08333333,1/3/2016,20,12,home,10,NEP,342,126,93,73,20,10,Win,96,70,1,2,0,MIA,30,438,196,0,-0.4137569353248356,34.35205049384032,16.969146779257745,17.38290371458258
0.6,0.666666667,29.56666667,1/3/2016,24,25,away,3,ATL,323,327,45,65,20,17,Win,67,87,0,1,2,NOS,37,390,414,1,2.4825277744907894,55.89163898303863,29.18708337876471,26.70455560427392
0.666666667,0.6,30.43333333,1/3/2016,25,24,home,-3,NOS,327,323,32,63,17,20,Loss,87,67,1,0,1,ATL,37,414,390,2,-2.4825277744907894,55.89163898303863,26.70455560427392,29.18708337876471
0.6,0.0,29.21666667,1/3/2016,22,17,away,-8,CIN,282,147,38,78,16,24,Loss,59,145,1,3,0,BAL,40,341,292,2,0.6635545499414064,36.20024624907732,18.431900399509363,17.768345849567954
0.0,0.6,30.78333333,1/3/2016,17,22,home,8,BAL,147,282,72,57,24,16,Win,145,59,3,1,2,CIN,40,292,341,0,-0.6635545499414064,36.20024624907732,17.768345849567954,18.431900399509363
0.25,0.25,26.05,1/3/2016,16,22,away,16,CLE,349,177,45,55,28,12,Win,30,86,0,7,4,PIT,40,379,263,3,1.667932283436965,40.54664394551721,21.107288114477086,19.439355831040125
0.25,0.25,33.95,1/3/2016,22,16,home,-16,PIT,177,349,47,76,12,28,Loss,86,30,7,0,3,CLE,40,263,379,4,-1.667932283436965,40.54664394551721,19.439355831040125,21.107288114477086
0.083333333,0.470588235,24.38333333,1/3/2016,11,25,away,-24,HOU,183,242,53,54,6,30,Loss,32,160,8,2,1,JAX,36,215,402,4,-5.838226362179963,41.57474133234005,17.868257485080044,23.706483847260003
0.470588235,0.083333333,35.61666667,1/3/2016,25,11,home,24,JAX,242,183,55,74,30,6,Win,160,32,2,8,4,HOU,36,402,215,1,5.838226362179963,41.57474133234005,23.706483847260003,17.868257485080044
0.28571428600000004,0.41176470600000004,26.71666667,1/3/2016,14,20,away,-6,IND,94,200,60,58,24,30,Loss,137,127,4,1,1,TEN,54,231,327,1,-10.017755362271346,35.53657324572852,12.759408941728587,22.777164303999932
0.41176470600000004,0.28571428600000004,33.28333333,1/3/2016,20,14,home,6,TEN,200,94,71,71,30,24,Win,127,137,1,4,1,IND,54,327,231,1,10.017755362271346,35.53657324572852,22.777164303999932,12.759408941728587
0.5,0.2,33.96666667,1/3/2016,19,27,away,11,DAL,291,412,20,63,34,23,Win,146,100,1,4,4,WAS,57,437,512,0,-1.458559024062252,54.42329958790933,26.482370281923536,27.94092930598579
0.2,0.5,26.03333333,1/3/2016,27,19,home,-11,WAS,412,291,44,68,23,34,Loss,100,146,4,1,0,DAL,57,512,437,4,1.458559024062252,54.42329958790933,27.94092930598579,26.482370281923536
0.7692307690000001,0.46666666700000003,28.1,1/3/2016,23,30,away,5,NYG,315,294,11,65,35,30,Win,120,208,1,2,1,PHI,65,435,502,2,-4.537504133709141,63.49630378238725,29.479399824339055,34.016903958048196
0.46666666700000003,0.7692307690000001,31.9,1/3/2016,30,23,home,-5,PHI,294,315,10,81,30,35,Loss,208,120,2,1,2,NYG,65,502,435,1,4.537504133709141,63.49630378238725,34.016903958048196,29.479399824339055
0.4,0.583333333,32.5,1/3/2016,22,16,away,4,CHI,282,231,21,64,24,20,Win,67,111,4,5,3,DET,44,349,342,0,5.670348394404167,47.340391288798415,26.50536984160129,20.835021447197125
0.583333333,0.4,27.5,1/3/2016,16,22,home,-4,DET,231,282,15,52,20,24,Loss,111,67,5,4,0,CHI,44,342,349,3,-5.670348394404167,47.340391288798415,20.835021447197125,26.50536984160129
0.5,0.7,28.16666667,1/3/2016,21,23,away,-28,CAR,309,255,65,71,10,38,Loss,77,111,2,4,2,TBB,48,386,366,3,-11.60952188316757,55.42199625517155,21.906237186001988,33.51575906916956
0.7,0.5,31.83333333,1/3/2016,23,21,home,28,TBB,255,309,33,62,38,10,Win,111,77,4,2,3,CAR,48,366,386,2,11.60952188316757,55.42199625517155,33.51575906916956,21.906237186001988
0.214285714,0.46153846200000004,25.08333333,1/3/2016,14,23,away,-6,KCC,157,150,59,55,17,23,Loss,48,189,6,1,2,OAK,40,205,339,1,-1.031194304607137,39.37854355061579,19.173674623004324,20.204868927611464
0.46153846200000004,0.214285714,34.91666667,1/3/2016,23,14,home,6,OAK,150,157,55,65,23,17,Win,189,48,1,6,1,KCC,40,339,205,2,1.031194304607137,39.37854355061579,20.204868927611464,19.173674623004324
0.333333333,0.454545455,34.53333333,1/3/2016,15,21,away,-7,DEN,207,293,45,67,20,27,Loss,110,210,3,2,5,LAC,47,317,503,1,-2.066901812567691,50.364847652623205,24.148972920027756,26.21587473259545
0.454545455,0.333333333,25.46666667,1/3/2016,21,15,home,7,LAC,293,207,35,65,27,20,Win,210,110,2,3,1,DEN,47,503,317,5,2.066901812567691,50.364847652623205,26.21587473259545,24.148972920027756
0.533333333,0.41666666700000005,36.61666667,1/3/2016,22,16,away,30,ARI,209,205,70,69,36,6,Win,145,27,1,2,3,SEA,42,354,232,0,-2.139903817376471,38.34796464613376,18.104030414378645,20.243934231755116
0.41666666700000005,0.533333333,23.38333333,1/3/2016,16,22,home,-30,SEA,205,209,43,58,6,36,Loss,27,145,2,1,0,ARI,42,232,354,3,2.139903817376471,38.34796464613376,20.243934231755116,18.104030414378645
0.23076923100000002,0.444444444,38.5,1/3/2016,21,21,away,-3,SFO,231,350,105,71,0,3,Loss,133,108,0,1,1,LAR,3,364,458,0,-18.682575351205237,38.56386388634839,9.940644267571578,28.623219618776815
0.444444444,0.23076923100000002,33.05,1/3/2016,21,21,home,3,LAR,350,231,60,78,3,0,Win,108,133,1,0,0,SFO,3,458,364,1,18.682575351205237,38.56386388634839,28.623219618776815,9.940644267571578
0.181818182,0.133333333,24.3,1/3/2016,14,19,away,7,GBP,91,274,37,49,20,13,Win,151,76,3,5,2,MIN,33,242,350,2,3.5237594671944876,36.25781969842588,19.890789582810182,16.367030115615695
0.133333333,0.181818182,35.7,1/3/2016,19,14,home,-7,MIN,274,91,54,75,13,20,Loss,76,151,5,3,2,GBP,33,350,242,2,-3.5237594671944876,36.25781969842588,16.367030115615695,19.890789582810182
0.363636364,0.428571429,34.41666667,1/9/2016,18,14,away,30,HOU,173,112,52,62,30,0,Win,141,114,3,3,5,KCC,30,314,226,1,-4.950384565322873,37.547391724635446,16.298503579656288,21.24888814497916
0.428571429,0.363636364,25.58333333,1/9/2016,14,18,home,-30,KCC,112,173,29,62,0,30,Loss,114,141,3,3,1,HOU,30,226,314,5,4.950384565322873,37.547391724635446,21.24888814497916,16.298503579656288
0.153846154,0.333333333,30.61666667,1/9/2016,21,19,away,2,CIN,202,188,142,69,18,16,Win,167,91,4,3,4,PIT,34,369,279,2,-5.652534259267087,41.509211245930864,17.92833849333189,23.580872752598975
0.333333333,0.153846154,29.38333333,1/9/2016,19,21,home,-2,PIT,188,202,79,68,16,18,Loss,91,167,3,4,2,CIN,34,279,369,4,5.652534259267087,41.509211245930864,23.580872752598975,17.92833849333189
0.35714285700000004,0.23076923100000002,27.56666667,1/10/2016,13,14,away,1,MIN,129,125,65,56,10,9,Win,97,58,2,3,1,SEA,19,226,183,1,2.6361991856253004,26.03862098904058,14.337410087332941,11.70121090170764
0.23076923100000002,0.35714285700000004,32.43333333,1/10/2016,14,13,home,-1,SEA,125,129,46,56,9,10,Loss,58,97,3,2,1,MIN,19,183,226,1,-2.6361991856253004,26.03862098904058,11.70121090170764,14.337410087332941
0.272727273,0.333333333,29.55,1/10/2016,24,20,away,17,WAS,205,270,23,69,35,18,Win,141,84,1,6,1,GBP,53,346,354,1,-6.619772833751186,42.218756643330025,17.79949190478942,24.419264738540605
0.333333333,0.272727273,30.45,1/10/2016,20,24,home,-17,GBP,270,205,55,70,18,35,Loss,84,141,6,1,1,WAS,53,354,346,1,6.619772833751186,42.218756643330025,24.419264738540605,17.79949190478942
0.6,0.5,37.85,1/16/2016,27,21,away,-7,NEP,243,302,40,83,20,27,Loss,135,38,1,0,0,KCC,47,378,340,1,1.2308311343579348,45.8633634163521,23.547097275355018,22.316266140997083
0.5,0.6,22.15,1/16/2016,21,27,home,7,KCC,302,243,24,56,27,20,Win,38,135,0,1,1,NEP,47,340,378,0,-1.2308311343579348,45.8633634163521,22.316266140997083,23.547097275355018
0.46666666700000003,0.384615385,30.23333333,1/16/2016,18,20,away,-6,ARI,251,328,55,67,0,6,Loss,135,40,1,3,2,GBP,6,386,368,1,-0.6062173534712971,46.28120379754857,22.83749322203864,23.443710575509932
0.384615385,0.46666666700000003,30.85,1/16/2016,20,18,home,6,GBP,328,251,26,63,6,0,Win,40,135,3,1,1,ARI,6,368,386,2,0.6062173534712971,46.28120379754857,23.443710575509932,22.83749322203864
0.454545455,0.533333333,24.36666667,1/17/2016,23,19,away,-7,CAR,325,151,20,65,24,31,Loss,78,144,5,1,0,SEA,55,403,295,2,-2.2395761954989357,46.2180685394086,21.989246171954832,24.228822367453766
0.533333333,0.454545455,35.63333333,1/17/2016,19,23,home,7,SEA,151,325,25,64,31,24,Win,144,78,1,5,2,CAR,55,295,403,0,2.2395761954989357,46.2180685394086,24.228822367453766,21.989246171954832
0.166666667,0.2,28.45,1/17/2016,16,19,away,-7,DEN,311,215,38,59,16,23,Loss,85,109,3,1,0,PIT,39,396,324,1,0.5829204197839815,38.077738050227815,19.330329235005898,18.747408815221917
0.2,0.166666667,31.55,1/17/2016,19,16,home,7,PIT,215,311,49,71,23,16,Win,109,85,1,3,1,DEN,39,324,396,0,-0.5829204197839815,38.077738050227815,18.747408815221917,19.330329235005898
0.133333333,0.352941176,30.2,1/24/2016,20,12,away,-2,DEN,292,145,53,77,18,20,Loss,44,99,4,3,1,NEP,38,336,244,2,-1.338307357396964,32.283516204959184,15.47260442378111,16.810911781178074
0.352941176,0.133333333,29.8,1/24/2016,12,20,home,2,NEP,145,292,51,65,20,18,Win,99,44,3,4,2,DEN,38,244,336,1,1.338307357396964,32.283516204959184,16.810911781178074,15.47260442378111
0.3,0.571428571,23.35,1/24/2016,21,21,away,-34,CAR,227,324,51,60,15,49,Loss,60,152,3,1,1,ARI,64,287,476,7,-0.2718216520734842,55.474340128083455,27.601259238004985,27.87308089007847
0.571428571,0.3,36.65,1/24/2016,21,21,home,34,ARI,324,227,45,66,49,15,Win,152,60,1,3,7,CAR,64,476,287,1,0.2718216520734842,55.474340128083455,27.87308089007847,27.601259238004985
0.2,0.071428571,32.78333333,2/7/2016,21,11,away,-14,DEN,197,104,102,75,10,24,Loss,118,90,7,5,2,CAR,34,315,194,4,-5.30492298962967,35.1264946592337,14.910785834802013,20.215708824431687
0.071428571,0.2,27.21666667,2/7/2016,11,21,home,14,CAR,104,197,51,56,24,10,Win,90,118,5,7,4,DEN,34,194,315,2,5.30492298962967,35.1264946592337,20.215708824431687,14.910785834802015
0.6,0.5,32.31666667,9/8/2016,21,21,away,-1,DEN,176,159,85,68,20,21,Loss,157,148,3,2,3,CAR,41,333,307,1,-3.9042816393494295,50.39599336892919,23.24585586478988,27.15013750413931
0.5,0.6,27.68333333,9/8/2016,21,21,home,1,CAR,159,176,22,57,21,20,Win,148,157,2,3,1,DEN,41,307,333,3,3.9042816393494295,50.39599336892919,27.15013750413931,23.24585586478988
0.333333333,0.23076923100000002,27.61666667,9/11/2016,20,19,away,7,ATL,281,322,48,60,31,24,Win,90,52,0,3,0,TBB,55,371,374,1,-3.087360909708565,41.19266021905818,19.05264965467481,22.140010564383374
0.23076923100000002,0.333333333,32.38333333,9/11/2016,19,20,home,-7,TBB,322,281,74,64,24,31,Loss,52,90,3,0,1,ATL,55,374,371,0,3.087360909708565,41.19266021905818,22.140010564383374,19.05264965467481
0.428571429,0.571428571,29.58333333,9/11/2016,15,19,away,9,TEN,236,252,39,61,25,16,Win,65,64,0,2,3,MIN,41,301,316,0,-6.497764697926162,42.168975813290864,17.83560555768235,24.333370255608514
0.571428571,0.428571429,30.41666667,9/11/2016,19,15,home,-9,MIN,252,236,10,65,16,25,Loss,64,65,2,0,0,TEN,41,316,301,3,6.497764697926162,42.168975813290864,24.333370255608514,17.83560555768235
0.2,0.333333333,20.66666667,9/11/2016,14,23,away,-19,PHI,168,270,15,50,10,29,Loss,120,133,3,2,0,CLE,39,288,403,1,4.690719441379715,38.64011084926662,21.665415145323166,16.974695703943453
0.333333333,0.2,39.33333333,9/11/2016,23,14,home,19,CLE,270,168,46,73,29,10,Win,133,120,2,3,1,PHI,39,403,288,0,-4.690719441379715,38.64011084926662,16.974695703943453,21.665415145323166
0.272727273,0.333333333,25.11666667,9/11/2016,18,22,away,1,NYJ,324,188,44,56,23,22,Win,57,152,7,1,1,CIN,45,381,340,1,4.646784197983051,44.7493348704931,24.698059534238077,20.051275336255024
0.333333333,0.272727273,34.88333333,9/11/2016,22,18,home,-1,CIN,188,324,95,66,22,23,Loss,152,57,1,7,1,NYJ,45,340,381,1,-4.646784197983051,44.7493348704931,20.051275336255024,24.698059534238077
0.363636364,0.363636364,30.41666667,9/11/2016,25,27,away,1,NOS,319,419,141,64,35,34,Win,167,88,0,1,1,OAK,69,486,507,0,-0.6905826446749304,64.04011127946463,31.674764317394846,32.36534696206978
0.363636364,0.363636364,29.58333333,9/11/2016,27,25,home,-1,OAK,419,319,53,65,34,35,Loss,88,167,1,0,0,NOS,69,507,486,1,0.6905826446749304,64.04011127946463,32.36534696206978,31.674764317394846
0.46666666700000003,0.35714285700000004,34.01666667,9/11/2016,25,26,away,-6,KCC,233,330,30,69,0,6,Loss,155,83,1,3,1,LAC,6,388,413,0,-3.5364368226921217,44.95199139301041,20.707777285159143,24.244214107851267
0.35714285700000004,0.46666666700000003,31.1,9/11/2016,26,25,home,6,LAC,330,233,46,70,6,0,Win,83,155,3,1,0,KCC,6,413,388,1,3.5364368226921217,44.95199139301041,24.244214107851267,20.707777285159143
0.23076923100000002,0.4,27.11666667,9/11/2016,11,18,away,-6,BAL,95,225,89,48,7,13,Loss,65,83,2,4,1,BUF,20,160,308,0,5.054300883500769,29.58465125499649,17.31947606924863,12.26517518574786
0.4,0.23076923100000002,32.88333333,9/11/2016,18,11,home,6,BUF,225,95,35,65,13,7,Win,83,65,4,2,0,BAL,20,308,160,1,-5.054300883500769,29.58465125499649,12.26517518574786,17.31947606924863
0.307692308,0.6,23.68333333,9/11/2016,14,17,away,-9,HOU,185,215,30,54,14,23,Loss,73,129,5,2,1,CHI,37,258,344,1,-11.442198094182443,37.76682849721633,13.162315201516943,24.604513295699387
0.6,0.307692308,36.31666667,9/11/2016,17,14,home,9,CHI,215,185,69,72,23,14,Win,129,73,2,5,1,HOU,37,344,258,1,11.442198094182443,37.76682849721633,24.604513295699387,13.162315201516943
0.5,0.26666666699999997,28.61666667,9/11/2016,18,20,away,4,JAX,199,300,24,60,27,23,Win,95,48,1,3,1,GBP,50,294,348,0,-4.8350245347589915,42.84618671273196,19.00558108898648,23.840605623745475
0.26666666699999997,0.5,31.38333333,9/11/2016,20,18,home,-4,GBP,300,199,79,68,23,27,Loss,48,95,3,1,0,JAX,50,348,294,1,4.8350245347589915,42.84618671273196,23.840605623745475,19.00558108898648
0.214285714,0.3125,25.46666667,9/11/2016,11,21,away,-2,SEA,150,240,40,54,10,12,Loss,64,112,5,3,2,MIA,22,214,352,0,-3.6854677684407897,29.589420437700582,12.951976334629897,16.637444103070685
0.3125,0.214285714,34.53333333,9/11/2016,21,11,home,2,MIA,240,150,69,78,12,10,Win,112,64,3,5,0,SEA,22,352,214,2,3.6854677684407897,29.589420437700582,16.637444103070685,12.951976334629896
0.5,0.588235294,23.28333333,9/11/2016,18,24,away,1,DAL,203,227,40,54,20,19,Win,113,101,2,0,0,NYG,39,316,328,1,-8.298301833352117,43.76856658586104,17.735132376254462,26.033434209606575
0.588235294,0.5,36.71666667,9/11/2016,24,18,home,-1,NYG,227,203,50,75,19,20,Loss,101,113,0,2,1,DAL,39,328,316,0,8.298301833352117,43.76856658586104,26.033434209606575,17.735132376254462
0.5555555560000001,0.5625,30.6,9/11/2016,28,25,away,4,IND,332,368,70,64,39,35,Win,116,82,1,2,0,DET,74,448,450,0,-0.3763554461031742,60.08259094773065,29.853117750813738,30.229473196916913
0.5625,0.5555555560000001,29.4,9/11/2016,25,28,home,-4,DET,368,332,45,68,35,39,Loss,82,116,2,1,0,IND,74,450,448,0,0.3763554461031742,60.08259094773065,30.229473196916913,29.853117750813738
0.625,0.5,33.98333333,9/11/2016,19,21,away,2,ARI,257,252,69,66,23,21,Win,106,92,2,3,0,NEP,44,363,344,2,4.71803305211853,45.29565703219518,25.006845042156854,20.288811990038326
0.5,0.625,26.01666667,9/11/2016,21,19,home,-2,NEP,252,257,58,59,21,23,Loss,92,106,3,2,2,ARI,44,344,363,0,-4.71803305211853,45.29565703219518,20.288811990038326,25.006845042156854
0.642857143,0.3,33.3,9/12/2016,23,18,away,22,WAS,290,329,81,68,38,16,Win,147,55,1,0,2,PIT,54,437,384,1,-4.601078229275749,51.642876745987174,23.520899258355712,28.12197748763146
0.3,0.642857143,26.7,9/12/2016,18,23,home,-22,PIT,329,290,55,55,16,38,Loss,55,147,0,1,1,WAS,54,384,437,2,4.601078229275749,51.642876745987174,28.12197748763146,23.520899258355712
0.2,0.470588235,27.83333333,9/12/2016,10,28,away,-28,SFO,120,170,102,60,0,28,Loss,65,150,2,0,1,LAR,28,185,320,2,-12.476490182538004,33.15011545431419,10.336812635888094,22.813302818426095
0.470588235,0.2,32.16666667,9/12/2016,28,10,home,28,LAR,170,120,10,77,28,0,Win,150,65,0,2,2,SFO,28,320,185,1,12.476490182538004,33.15011545431419,22.813302818426095,10.336812635888093
0.615384615,0.3,39.2,9/15/2016,28,16,away,6,BUF,370,307,50,71,37,31,Win,123,86,1,0,1,NYJ,68,493,393,1,3.0606861458857537,58.12175103847208,30.591218592178915,27.53053244629316
0.3,0.615384615,20.8,9/15/2016,16,28,home,-6,NYJ,307,370,59,50,31,37,Loss,86,123,0,1,1,BUF,68,393,493,1,-3.0606861458857537,58.12175103847208,27.53053244629316,30.591218592178915
0.28571428600000004,0.46666666700000003,24.1,9/18/2016,16,26,away,-19,CAR,237,353,50,64,27,46,Loss,65,176,2,1,4,SFO,73,302,529,3,-10.957637246113633,54.42379724135658,21.733079997621473,32.69071724373511
0.46666666700000003,0.28571428600000004,35.9,9/18/2016,26,16,home,19,SFO,353,237,65,78,46,27,Win,176,65,1,2,3,CAR,73,529,302,4,10.957637246113633,54.42379724135658,32.69071724373511,21.733079997621473
0.5,0.41666666700000005,32.85,9/18/2016,24,24,away,4,WAS,278,350,39,64,27,23,Win,102,82,4,2,1,DAL,50,380,432,1,-3.585081028130947,50.24176693524767,23.328342953558362,26.913423981689306
0.41666666700000005,0.5,27.15,9/18/2016,24,24,home,-4,DAL,350,278,51,65,23,27,Loss,82,102,2,4,1,WAS,50,432,380,1,3.585081028130947,50.24176693524767,26.913423981689306,23.328342953558362
0.25,0.41176470600000004,27.08333333,9/18/2016,21,19,away,-8,PIT,366,250,31,73,16,24,Loss,46,124,1,1,2,CIN,40,412,374,2,-7.505285734871594,44.831230681022745,18.662972473075577,26.16825820794717
0.41176470600000004,0.25,32.91666667,9/18/2016,19,21,home,8,CIN,250,366,54,74,24,16,Win,124,46,1,1,2,PIT,40,374,412,2,7.505285734871594,44.831230681022745,26.16825820794717,18.662972473075577
0.23076923100000002,0.46666666700000003,25.88333333,9/18/2016,16,22,away,-3,NYG,247,353,76,59,13,16,Loss,41,64,2,2,3,NOS,29,288,417,0,-4.422335503049194,44.8814040317585,20.229534264354655,24.651869767403845
0.46666666700000003,0.23076923100000002,34.11666667,9/18/2016,22,16,home,3,NOS,353,247,25,75,16,13,Win,64,41,2,2,0,NYG,29,417,288,3,4.422335503049194,44.8814040317585,24.651869767403845,20.229534264354655
0.5,0.5,23.23333333,9/18/2016,23,29,away,-7,NEP,387,302,49,61,24,31,Loss,70,161,0,2,1,MIA,55,457,463,4,7.912940668598916,60.521461471200716,34.217201069899815,26.3042604013009
0.5,0.5,36.76666667,9/18/2016,29,23,home,7,MIA,302,387,65,75,31,24,Win,161,70,2,0,4,NEP,55,463,457,1,-7.912940668598916,60.521461471200716,26.3042604013009,34.217201069899815
0.214285714,0.26666666699999997,26.01666667,9/18/2016,14,15,away,-7,HOU,172,254,77,60,12,19,Loss,119,97,4,2,2,KCC,31,291,351,3,-8.252905404732449,36.72075056574003,14.233922580503794,22.48682798523624
0.26666666699999997,0.214285714,33.98333333,9/18/2016,15,14,home,7,KCC,254,172,44,69,19,12,Win,97,119,2,4,3,HOU,31,351,291,2,8.252905404732449,36.72075056574003,22.48682798523624,14.233922580503792
0.41666666700000005,0.4375,30.85,9/18/2016,22,22,away,1,DET,224,238,83,60,16,15,Win,139,137,3,4,1,TEN,31,363,375,1,-8.090804081621485,50.035459702550504,20.97232781046451,29.063131892085995
0.4375,0.41666666700000005,29.15,9/18/2016,22,22,home,-1,TEN,238,224,138,67,15,16,Loss,137,139,4,3,1,DET,31,375,363,1,8.090804081621485,50.035459702550504,29.063131892085995,20.97232781046451
0.625,0.533333333,30.98333333,9/18/2016,22,17,away,5,CLE,302,242,29,71,25,20,Win,80,145,0,3,2,BAL,45,382,387,2,-0.8237799299734351,47.81952954027032,23.49787480514844,24.321654735121875
0.533333333,0.625,29.01666667,9/18/2016,17,22,home,-5,BAL,242,302,59,59,20,25,Loss,145,80,3,0,2,CLE,45,387,382,2,0.8237799299734351,47.81952954027032,24.321654735121875,23.49787480514844
0.307692308,0.25,30.05,9/18/2016,17,17,away,-6,LAR,239,219,114,61,3,9,Loss,67,64,2,3,0,SEA,12,306,283,1,-2.8796743718426585,35.73655896277342,16.42844229546538,19.30811666730804
0.25,0.307692308,29.95,9/18/2016,17,17,home,6,SEA,219,239,78,58,9,3,Win,64,67,3,2,1,LAR,12,283,306,0,2.8796743718426585,35.73655896277342,19.30811666730804,16.42844229546538
0.384615385,0.428571429,30.95,9/18/2016,21,20,away,-33,ARI,221,311,39,76,7,40,Loss,85,105,3,1,0,TBB,47,306,416,5,-9.917504242679424,44.00237016612526,17.042432961722916,26.959937204402344
0.428571429,0.384615385,29.05,9/18/2016,20,21,home,33,TBB,311,221,30,65,40,7,Win,105,85,1,3,5,ARI,47,416,306,0,9.917504242679424,44.00237016612526,26.959937204402344,17.042432961722916
0.181818182,0.538461538,25.13333333,9/18/2016,20,25,away,-24,LAC,319,207,93,63,14,38,Loss,69,150,2,3,1,JAX,52,388,357,3,-0.9925380189233977,50.1750053165277,24.591233648802152,25.58377166772555
0.538461538,0.181818182,34.86666667,9/18/2016,25,20,home,24,JAX,207,319,23,63,38,14,Win,150,69,3,2,3,LAC,52,357,388,1,0.9925380189233977,50.1750053165277,25.58377166772555,24.591233648802152
0.5,0.41666666700000005,27.25,9/18/2016,27,29,away,7,OAK,389,299,72,64,35,28,Win,139,155,1,1,0,ATL,63,528,454,1,-2.7253289816583615,63.1221367363473,30.198403877344468,32.92373285900283
0.41666666700000005,0.5,32.75,9/18/2016,29,27,home,-7,ATL,299,389,58,71,28,35,Loss,155,139,1,1,1,OAK,63,454,528,0,2.7253289816583615,63.1221367363473,32.92373285900283,30.198403877344468
0.428571429,0.454545455,29.31666667,9/18/2016,19,24,away,-14,DEN,170,266,94,66,20,34,Loss,83,134,5,1,1,IND,54,253,400,2,-1.883620563197006,47.12283867119186,22.619609053997426,24.50322961719443
0.454545455,0.428571429,30.68333333,9/18/2016,24,19,home,14,IND,266,170,54,65,34,20,Win,134,83,1,5,2,DEN,54,400,253,1,1.883620563197006,47.12283867119186,24.50322961719443,22.619609053997426
0.46153846200000004,0.28571428600000004,29.7,9/18/2016,20,15,away,-3,MIN,180,254,72,64,14,17,Loss,83,30,5,4,1,GBP,31,263,284,3,-1.6818684985368977,41.7714645781058,20.04479803978445,21.72666653832135
0.28571428600000004,0.46153846200000004,30.3,9/18/2016,15,20,home,3,GBP,254,180,137,57,17,14,Win,30,83,4,5,3,MIN,31,284,263,1,1.6818684985368977,41.7714645781058,21.72666653832135,20.04479803978445
0.2,0.4,36.08333333,9/19/2016,21,16,away,15,CHI,180,220,34,68,29,14,Win,100,64,2,3,3,PHI,43,280,284,0,4.635958545545508,39.95248077743626,22.29421966149088,17.658261115945376
0.4,0.2,23.91666667,9/19/2016,16,21,home,-15,PHI,220,180,60,50,14,29,Loss,64,100,3,2,0,CHI,43,284,280,3,-4.635958545545508,39.95248077743626,17.658261115945376,22.29421966149088
0.4,0.28571428600000004,31.36666667,9/22/2016,19,15,away,-27,NEP,175,97,43,70,0,27,Loss,109,185,2,1,0,HOU,27,284,282,3,0.3488584189460635,34.42309161960196,17.385975019274014,17.03711660032795
0.28571428600000004,0.4,28.63333333,9/22/2016,15,19,home,27,HOU,97,175,15,59,27,0,Win,185,109,1,2,3,NEP,27,282,284,0,-0.3488584189460635,34.42309161960196,17.03711660032795,17.385975019274014
0.333333333,0.307692308,34.0,9/25/2016,25,16,away,-15,BUF,260,89,50,77,18,33,Loss,88,208,5,4,1,ARI,51,348,297,5,-4.849285225993329,41.87064473298052,18.510679753493598,23.359964979486925
0.307692308,0.333333333,26.0,9/25/2016,16,25,home,15,ARI,89,260,75,61,33,18,Win,208,88,4,5,5,BUF,51,297,348,1,4.849285225993329,41.87064473298052,23.359964979486925,18.510679753493598
0.384615385,0.166666667,29.05,9/25/2016,17,19,away,7,TEN,245,212,58,61,17,10,Win,123,181,1,1,3,OAK,27,368,393,1,-6.254027765090449,49.45837402043868,21.602173127674117,27.856200892764566
0.166666667,0.384615385,30.95,9/25/2016,19,17,home,-7,OAK,212,245,70,63,10,17,Loss,181,123,1,1,1,TEN,27,393,368,3,6.254027765090449,49.45837402043868,27.856200892764566,21.602173127674117
0.4375,0.444444444,33.43333333,9/25/2016,20,28,away,2,NYG,313,337,70,68,29,27,Win,90,120,2,2,3,WAS,56,403,457,1,-7.632584490505522,58.526164834016335,25.446790171755403,33.07937466226093
0.444444444,0.4375,26.56666667,9/25/2016,28,20,home,-2,WAS,337,313,128,61,27,29,Loss,120,90,2,2,1,NYG,56,457,403,3,7.632584490505522,58.526164834016335,33.07937466226093,25.446790171755406
0.26666666699999997,0.2,37.36666667,9/25/2016,21,23,away,-6,MIA,261,311,91,74,0,6,Loss,169,115,4,1,3,CLE,6,430,426,1,-4.335694481763846,43.1093085337788,19.386807026007478,23.722501507771323
0.2,0.26666666699999997,29.2,9/25/2016,23,21,home,6,CLE,311,261,67,65,6,0,Win,115,169,1,4,1,MIA,6,426,430,3,4.335694481763846,43.1093085337788,23.722501507771323,19.386807026007478
0.23076923100000002,0.375,31.1,9/25/2016,18,14,away,2,JAX,199,168,58,64,19,17,Win,84,48,2,4,3,BAL,36,283,216,3,-2.1688767009702734,35.430699029239754,16.63091116413474,18.799787865105014
0.375,0.23076923100000002,28.9,9/25/2016,14,18,home,-2,BAL,168,199,75,63,17,19,Loss,48,84,4,2,3,JAX,36,216,283,3,2.1688767009702734,35.430699029239754,18.799787865105014,16.63091116413474
0.571428571,0.5,35.11666667,9/25/2016,22,17,away,-7,GBP,368,201,86,67,27,34,Loss,50,123,3,2,0,DET,61,418,324,1,2.432916502291249,51.838282106893445,27.135599304592347,24.702682802301098
0.5,0.571428571,24.88333333,9/25/2016,17,22,home,7,DET,201,368,45,50,34,27,Win,123,50,2,3,1,GBP,61,324,418,0,-2.432916502291249,51.838282106893445,24.702682802301098,27.135599304592347
0.5,0.41666666700000005,27.9,9/25/2016,21,20,away,12,CIN,303,189,41,60,29,17,Win,52,143,2,4,2,DEN,46,355,332,1,5.211561735587351,47.785693430663656,26.498627583125504,21.287065847538152
0.41666666700000005,0.5,32.1,9/25/2016,20,21,home,-12,DEN,189,303,69,64,17,29,Loss,143,52,4,2,1,CIN,46,332,355,2,-5.211561735587351,47.785693430663656,21.287065847538152,26.498627583125504
0.25,0.375,25.13333333,9/25/2016,13,18,away,12,CAR,153,201,42,54,22,10,Win,58,105,2,8,3,MIN,32,211,306,0,-7.5565968749364725,34.51200760052285,13.477705362793188,21.034302237729662
0.375,0.25,34.86666667,9/25/2016,18,13,home,-12,MIN,201,153,65,72,10,22,Loss,105,58,8,2,0,CAR,32,306,211,3,7.5565968749364725,34.51200760052285,21.034302237729662,13.477705362793188
0.46153846200000004,0.5,26.4,9/25/2016,18,30,away,5,TBB,183,389,69,60,37,32,Win,137,83,1,2,2,LAR,69,320,472,2,-15.477713838953354,53.03428259110781,18.77828437607723,34.25599821503058
0.5,0.46153846200000004,33.6,9/25/2016,30,18,home,-5,LAR,389,183,80,82,32,37,Loss,83,137,2,1,2,TBB,69,472,320,2,15.477713838953354,53.03428259110781,34.25599821503059,18.778284376077227
0.26666666699999997,0.642857143,24.05,9/25/2016,12,18,away,-19,SEA,119,291,35,56,18,37,Loss,135,127,0,2,2,SFO,55,254,418,1,-1.4546200442287454,38.99476074386904,18.770070349820145,20.224690394048892
0.642857143,0.26666666699999997,35.95,9/25/2016,18,12,home,19,SFO,291,119,50,65,37,18,Win,127,135,2,0,1,SEA,55,418,254,2,1.4546200442287454,38.99476074386904,20.224690394048892,18.770070349820145
0.5,0.46666666700000003,27.91666667,9/25/2016,17,18,away,-21,KCC,188,221,15,66,3,24,Loss,117,72,0,2,1,NYJ,27,305,293,8,-2.783190330082018,46.32491045457258,21.770860062245283,24.554050392327298
0.46666666700000003,0.5,32.08333333,9/25/2016,18,17,home,21,NYJ,221,188,59,62,24,3,Win,72,117,2,0,8,KCC,27,293,305,1,2.783190330082018,46.32491045457258,24.554050392327298,21.770860062245283
0.363636364,0.222222222,27.28333333,9/25/2016,17,24,away,-4,IND,315,317,80,58,22,26,Loss,37,93,2,2,2,LAC,48,352,410,3,3.2971927584912146,50.47864369479107,26.88791822664114,23.590725468149927
0.222222222,0.363636364,32.71666667,9/25/2016,24,17,home,4,LAC,317,315,66,65,26,22,Win,93,37,2,2,3,IND,48,410,352,2,-3.2971927584912146,50.47864369479107,23.590725468149927,26.88791822664114
0.363636364,0.4,25.06666667,9/25/2016,15,25,away,-31,PHI,222,301,77,58,3,34,Loss,29,125,4,0,0,PIT,37,251,426,2,3.3009295654327957,46.80405068087422,25.052490123153508,21.751560557720712
0.4,0.363636364,34.93333333,9/25/2016,25,15,home,31,PIT,301,222,99,61,34,3,Win,125,29,0,4,2,PHI,37,426,251,0,-3.3009295654327957,46.80405068087422,21.751560557720712,25.052490123153508
0.2,0.454545455,24.68333333,9/25/2016,21,25,away,-14,DAL,312,248,45,64,17,31,Loss,78,199,1,0,1,CHI,48,390,447,2,-1.707916287156479,49.75787744426989,24.024980578556704,25.732896865713183
0.454545455,0.2,35.31666667,9/25/2016,25,21,home,14,CHI,248,312,45,65,31,17,Win,199,78,0,1,2,DAL,48,447,390,1,1.707916287156479,49.75787744426989,25.732896865713183,24.024980578556704
0.454545455,0.538461538,27.43333333,9/26/2016,26,32,away,13,NOS,225,359,35,63,45,32,Win,217,115,2,2,2,ATL,77,442,474,0,-1.3071369771193488,57.20614633457912,27.949504678729884,29.256641655849233
0.538461538,0.454545455,32.56666667,9/26/2016,32,26,home,-13,ATL,359,225,75,79,32,45,Loss,115,217,2,2,0,NOS,77,474,442,2,1.3071369771193488,57.20614633457912,29.256641655849233,27.949504678729884
0.181818182,0.2,21.96666667,9/29/2016,8,19,away,-15,CIN,160,285,68,43,7,22,Loss,62,77,5,1,0,MIA,29,222,362,2,7.65558020781943,31.713924775998315,19.684752491908874,12.029172284089443
0.2,0.181818182,38.03333333,9/29/2016,19,8,home,15,MIA,285,160,40,69,22,7,Win,77,62,1,5,2,CIN,29,362,222,0,-7.65558020781943,31.713924775998315,12.02917228408944,19.684752491908874
0.529411765,0.272727273,32.65,10/2/2016,23,23,away,-3,JAX,190,195,78,73,27,30,Loss,94,136,6,3,0,IND,57,284,331,1,-13.221368337500017,42.91952591933101,14.849078790915495,28.070447128415513
0.272727273,0.529411765,27.35,10/2/2016,23,23,home,3,IND,195,190,145,65,30,27,Win,136,94,3,6,1,JAX,57,331,284,0,13.221368337500017,42.91952591933101,28.070447128415513,14.849078790915495
0.46666666700000003,0.41666666700000005,31.7,10/2/2016,16,21,away,-7,HOU,196,244,93,62,20,27,Loss,124,115,1,1,2,TEN,47,320,359,1,-10.943557952680123,46.307319133349615,17.681880590334746,28.62543854301487
0.41666666700000005,0.46666666700000003,28.3,10/2/2016,21,16,home,7,TEN,244,196,59,62,27,20,Win,115,124,1,1,1,HOU,47,359,320,2,10.943557952680123,46.307319133349615,28.62543854301487,17.681880590334746
0.666666667,0.5,28.95,10/2/2016,26,24,away,-11,WAS,217,156,101,69,20,31,Loss,163,145,1,3,1,CLE,51,380,301,3,-6.5810510531468225,50.06781127800999,21.743380112431584,28.324431165578407
0.5,0.666666667,31.05,10/2/2016,24,26,home,11,CLE,156,217,75,56,31,20,Win,145,163,3,1,3,WAS,51,301,380,1,6.5810510531468225,50.06781127800999,28.324431165578407,21.743380112431584
0.3,0.46666666700000003,30.75,10/2/2016,21,20,away,10,NYJ,288,247,71,60,27,17,Win,66,58,2,4,3,SEA,44,354,305,0,2.1353020513335395,44.36663204929449,23.250967050314014,21.115664998980474
0.46666666700000003,0.3,29.25,10/2/2016,20,21,home,-10,SEA,247,288,60,65,17,27,Loss,58,66,4,2,0,NYJ,44,305,354,3,-2.1353020513335395,44.36663204929449,21.115664998980474,23.250967050314014
0.46666666700000003,0.083333333,36.18333333,10/2/2016,24,13,away,16,NEP,244,187,60,73,16,0,Win,134,90,2,3,1,BUF,16,378,277,0,5.896710950123447,38.252488482446196,22.074599716284823,16.177888766161374
0.083333333,0.46666666700000003,23.81666667,10/2/2016,13,24,home,-16,BUF,187,244,74,52,0,16,Loss,90,134,3,2,0,NEP,16,277,378,1,-5.896710950123447,38.252488482446196,16.177888766161374,22.074599716284823
0.4375,0.615384615,26.18333333,10/2/2016,20,25,away,-15,ATL,329,481,55,64,33,48,Loss,49,90,1,3,1,CAR,81,378,571,2,-4.596862586730225,61.19260291601452,28.29787016464215,32.89473275137237
0.615384615,0.4375,33.81666667,10/2/2016,25,20,home,15,CAR,481,329,77,65,48,33,Win,90,49,3,1,2,ATL,81,571,378,1,4.596862586730225,61.19260291601452,32.89473275137237,28.29787016464215
0.25,0.294117647,25.26666667,10/2/2016,13,25,away,1,BAL,199,282,93,54,28,27,Win,62,130,0,2,1,OAK,55,261,412,1,-7.956897766968671,42.394381368572056,17.21874180080169,25.175639567770364
0.294117647,0.25,34.73333333,10/2/2016,25,13,home,-1,OAK,282,199,105,80,27,28,Loss,130,62,2,0,1,BAL,55,412,261,1,7.956897766968671,42.394381368572056,25.175639567770364,17.21874180080169
0.333333333,0.384615385,26.76666667,10/2/2016,16,23,away,-3,CHI,197,294,76,56,14,17,Loss,66,114,2,2,0,DET,31,263,408,2,-2.6087370689877982,43.77405453810061,20.582658734556404,23.191395803544204
0.384615385,0.333333333,33.23333333,10/2/2016,23,16,home,3,DET,294,197,55,67,17,14,Win,114,66,2,2,2,CHI,31,408,263,0,2.6087370689877982,43.77405453810061,23.191395803544204,20.582658734556404
0.23076923100000002,0.3125,31.4,10/2/2016,22,15,away,20,TBB,218,143,88,67,27,7,Win,89,72,4,5,3,DEN,34,307,215,0,-8.25442048798848,34.3908199316999,13.068199721855713,21.32262020984419
0.3125,0.23076923100000002,28.6,10/2/2016,15,22,home,-20,DEN,143,218,69,66,7,27,Loss,72,89,5,4,0,TBB,34,215,307,3,8.25442048798848,34.3908199316999,21.32262020984419,13.068199721855711
0.428571429,0.46153846200000004,27.85,10/2/2016,12,26,away,4,ARI,247,302,84,55,17,13,Win,41,118,2,3,5,LAR,30,288,420,1,-5.657430774956179,47.86369438765563,21.103131806349722,26.760562581305905
0.46153846200000004,0.428571429,32.15,10/2/2016,26,12,home,-4,LAR,302,247,45,75,13,17,Loss,118,41,3,2,1,ARI,30,420,288,5,5.657430774956179,47.86369438765563,26.760562581305905,21.103131806349722
0.611111111,0.46153846200000004,32.65,10/2/2016,21,21,away,1,LAC,192,308,34,72,35,34,Win,83,38,2,3,3,NOS,69,275,346,2,-6.654510446028837,44.884455154645856,19.11497235430851,25.769482800337347
0.46153846200000004,0.611111111,27.35,10/2/2016,21,21,home,-1,NOS,308,192,46,67,34,35,Loss,38,83,3,2,2,LAC,69,346,275,3,6.654510446028837,44.884455154645856,25.769482800337347,19.11497235430851
0.428571429,0.571428571,36.45,10/2/2016,26,14,away,7,SFO,234,189,45,73,24,17,Win,194,106,2,1,1,DAL,41,428,295,0,-4.324117771396411,42.44590096982343,19.06089159921351,23.385009370609918
0.571428571,0.428571429,23.55,10/2/2016,14,26,home,-7,DAL,189,234,32,53,17,24,Loss,106,194,1,2,0,SFO,41,295,428,1,4.324117771396411,42.44590096982343,23.385009370609918,19.06089159921351
0.470588235,0.545454545,30.6,10/2/2016,22,18,away,-29,PIT,270,287,40,72,14,43,Loss,87,149,4,2,0,KCC,57,357,436,2,-2.085794344581764,47.72287262768414,22.818539141551188,24.904333486132952
0.545454545,0.470588235,29.4,10/2/2016,18,22,home,29,KCC,287,270,68,55,43,14,Win,149,87,2,4,2,PIT,57,436,357,0,2.085794344581764,47.72287262768414,24.904333486132952,22.818539141551188
0.166666667,0.5,24.46666667,10/3/2016,18,22,away,-14,MIN,261,262,69,63,10,24,Loss,78,104,0,0,0,NYG,34,339,366,2,-6.552950758232798,44.720026690602374,19.08353796618479,25.636488724417585
0.5,0.166666667,35.53333333,10/3/2016,22,18,home,14,NYG,262,261,37,69,24,10,Win,104,78,0,0,2,MIN,34,366,339,0,6.552950758232798,44.720026690602374,25.636488724417585,19.08353796618479
0.3125,0.28571428600000004,31.73333333,10/6/2016,17,25,away,12,SFO,116,135,50,66,33,21,Win,172,151,1,7,3,ARI,54,288,286,0,-6.083174324089567,32.576869952489545,13.246847814199988,19.330022138289557
0.28571428600000004,0.3125,28.26666667,10/6/2016,25,17,home,-12,ARI,135,116,34,74,21,33,Loss,151,172,7,1,0,SFO,54,286,288,3,6.083174324089567,32.576869952489545,19.330022138289557,13.246847814199988
0.529411765,0.384615385,34.65,10/9/2016,24,17,away,20,CLE,403,235,61,77,33,13,Win,98,27,1,2,1,NEP,46,501,262,0,0.6745318408135699,43.36257749467366,22.018554667743615,21.344022826930043
0.384615385,0.529411765,25.35,10/9/2016,17,24,home,-20,NEP,235,403,35,59,13,33,Loss,27,98,2,1,0,CLE,46,262,501,1,-0.6745318408135699,43.36257749467366,21.344022826930043,22.018554667743615
0.454545455,0.333333333,29.6,10/9/2016,18,21,away,-1,DET,230,164,111,57,23,24,Loss,116,80,3,4,1,PHI,47,346,244,2,8.287336346460567,45.48979770564604,26.888567026053302,18.60123067959274
0.333333333,0.454545455,30.4,10/9/2016,21,18,home,1,PHI,164,230,18,56,24,23,Win,80,116,4,3,2,DET,47,244,346,1,-8.287336346460567,45.48979770564604,18.60123067959274,26.888567026053302
0.222222222,0.25,30.08333333,10/9/2016,25,20,away,-6,IND,397,298,80,62,23,29,Loss,125,98,0,5,0,CHI,52,522,396,1,1.252684345999965,52.49956601482533,26.876125180412647,25.62344083441268
0.25,0.222222222,29.91666667,10/9/2016,20,25,home,6,CHI,298,397,68,65,29,23,Win,98,125,5,0,1,IND,52,396,522,0,-1.252684345999965,52.49956601482533,25.62344083441268,26.876125180412647
0.41666666700000005,0.363636364,36.73333333,10/9/2016,23,8,away,13,MIA,163,149,40,70,30,17,Win,235,51,0,6,2,TEN,47,398,200,0,-0.30101461865725554,37.5586675849358,18.62882648313927,18.929841101796526
0.363636364,0.41666666700000005,23.26666667,10/9/2016,8,23,home,-13,TEN,149,163,83,41,17,30,Loss,51,235,6,0,0,MIA,47,200,398,2,0.30101461865725554,37.5586675849358,18.929841101796526,18.62882648313927
0.25,0.2,29.58333333,10/9/2016,18,18,away,6,BAL,250,188,46,62,16,10,Win,60,118,1,3,1,WAS,26,310,306,2,-3.582251244450352,34.048060790295224,15.232904772922435,18.81515601737279
0.2,0.25,30.41666667,10/9/2016,18,18,home,-6,WAS,188,250,65,69,10,16,Loss,118,60,3,1,2,BAL,26,306,310,1,3.582251244450352,34.048060790295224,18.815156017372786,15.232904772922437
0.076923077,0.5,22.53333333,10/9/2016,16,22,away,-18,MIN,155,255,15,60,13,31,Loss,59,96,4,2,0,HOU,44,214,351,1,-6.677847342541144,35.55475153313836,14.438452095298608,21.11629943783975
0.5,0.076923077,37.46666667,10/9/2016,22,16,home,18,HOU,255,155,97,69,31,13,Win,96,59,2,4,1,MIN,44,351,214,0,6.677847342541144,35.55475153313836,21.11629943783975,14.438452095298608
0.181818182,0.5,28.16666667,10/9/2016,16,30,away,-18,PIT,244,375,18,58,13,31,Loss,72,61,3,1,1,NYJ,44,316,436,0,4.3614287935339355,46.261419668099755,25.311424230816847,20.949995437282908
0.5,0.181818182,31.83333333,10/9/2016,30,16,home,18,NYJ,375,244,10,72,31,13,Win,61,72,1,3,0,PIT,44,436,316,1,-4.3614287935339355,46.261419668099755,20.949995437282908,25.311424230816847
0.166666667,0.25,28.86666667,10/9/2016,19,18,away,7,DEN,250,183,78,62,23,16,Win,122,84,2,6,1,ATL,39,372,267,1,1.3106099879379016,36.39513167017374,18.85287082905582,17.54226084111792
0.25,0.166666667,31.13333333,10/9/2016,18,19,home,-7,ATL,183,250,57,65,16,23,Loss,84,122,6,2,1,DEN,39,267,372,1,-1.3106099879379016,36.39513167017374,17.54226084111792,18.85287082905582
0.41666666700000005,0.5,32.28333333,10/9/2016,27,21,away,-14,DAL,249,222,49,64,14,28,Loss,96,180,4,1,1,CIN,42,345,402,0,7.862831849918125,48.28078540583114,28.07180862787463,20.208976777956508
0.5,0.41666666700000005,27.71666667,10/9/2016,21,27,home,14,CIN,222,249,45,54,28,14,Win,180,96,1,4,0,DAL,42,402,345,1,-7.862831849918125,48.28078540583114,20.208976777956508,28.07180862787463
0.333333333,0.333333333,24.43333333,10/9/2016,15,23,away,11,LAR,112,243,60,52,30,19,Win,193,102,2,4,3,BUF,49,305,345,0,2.7600456908303226,43.61093224370975,23.185488967270036,20.42544327643971
0.333333333,0.333333333,35.56666667,10/9/2016,23,15,home,-11,BUF,243,112,40,64,19,30,Loss,102,193,4,2,0,LAR,49,345,305,3,-2.7600456908303226,43.61093224370975,20.42544327643971,23.185488967270036
0.25,0.35714285700000004,23.7,10/9/2016,17,20,away,-3,OAK,351,300,38,51,31,34,Loss,72,89,2,3,1,LAC,65,423,389,4,4.252212789283485,53.43917250144658,28.84569264536503,24.593479856081547
0.35714285700000004,0.25,36.3,10/9/2016,20,17,home,3,LAC,300,351,36,68,34,31,Win,89,72,3,2,4,OAK,65,389,423,1,-4.252212789283485,53.43917250144658,24.593479856081547,28.84569264536503
0.307692308,0.473684211,23.36666667,10/9/2016,14,23,away,-7,GBP,178,259,51,54,16,23,Loss,43,147,4,0,2,NYG,39,221,406,1,-5.628566604787398,43.720598775736974,19.04601608547479,24.674582690262184
0.473684211,0.307692308,36.63333333,10/9/2016,23,14,home,7,NYG,259,178,57,77,23,16,Win,147,43,0,4,1,GBP,39,406,221,2,5.628566604787398,43.720598775736974,24.674582690262184,19.04601608547479
0.4,0.125,34.15,10/10/2016,20,20,away,3,CAR,202,278,40,69,17,14,Win,113,136,2,0,4,TBB,31,315,414,0,-3.934600552117236,47.22268063037227,21.644040039127514,25.578640591244753
0.125,0.4,25.85,10/10/2016,20,20,home,-3,TBB,278,202,60,53,14,17,Loss,136,113,0,2,0,CAR,31,414,315,4,3.934600552117236,47.22268063037227,25.578640591244753,21.644040039127514
0.4,0.23076923100000002,26.53333333,10/13/2016,16,16,away,-8,LAC,220,166,103,68,13,21,Loss,84,99,2,2,2,DEN,34,304,265,2,-4.644480639335057,36.77499439151401,16.065256876089475,20.709737515424532
0.23076923100000002,0.4,33.46666667,10/13/2016,16,16,home,8,DEN,166,220,20,60,21,13,Win,99,84,2,2,2,LAC,34,265,304,2,4.644480639335057,36.77499439151401,20.709737515424532,16.065256876089475
0.23076923100000002,0.615384615,24.81666667,10/16/2016,16,29,away,-29,BUF,167,179,52,60,16,45,Loss,133,313,3,3,2,SFO,61,300,492,1,-4.829791337682293,48.72057761358446,21.945393137951083,26.775184475633377
0.615384615,0.23076923100000002,35.18333333,10/16/2016,29,16,home,29,SFO,179,167,71,74,45,16,Win,313,133,3,3,1,BUF,61,492,300,2,4.829791337682293,48.72057761358446,26.775184475633377,21.945393137951083
0.333333333,0.538461538,25.78333333,10/16/2016,12,26,away,-7,WAS,145,263,114,48,20,27,Loss,94,230,5,0,1,PHI,47,239,493,0,-2.7986857668609773,47.00307872844576,22.10219648079239,24.900882247653367
0.538461538,0.333333333,34.21666667,10/16/2016,26,12,home,7,PHI,263,145,75,67,27,20,Win,230,94,0,5,0,WAS,47,493,239,1,2.7986857668609773,47.00307872844576,24.900882247653367,22.10219648079239
0.214285714,0.538461538,28.98333333,10/16/2016,16,19,away,-2,TEN,301,270,69,63,26,28,Loss,40,137,6,2,1,CLE,54,341,407,0,-4.493768139208441,42.810334678297025,19.15828326954429,23.652051408752733
0.538461538,0.214285714,31.01666667,10/16/2016,19,16,home,2,CLE,270,301,96,57,28,26,Win,137,40,2,6,0,TEN,54,407,341,1,4.493768139208441,42.810334678297025,23.652051408752733,19.15828326954429
0.27777777800000003,0.28571428600000004,35.06666667,10/16/2016,22,19,away,-4,NYG,293,397,111,76,23,27,Loss,98,38,2,1,3,BAL,50,391,435,0,-8.356737714194209,49.17418545780773,20.40872387180676,28.76546158600097
0.28571428600000004,0.27777777800000003,24.93333333,10/16/2016,19,22,home,4,BAL,397,293,119,64,27,23,Win,38,98,1,2,0,NYG,50,435,391,3,8.356737714194209,49.17418545780773,28.76546158600097,20.40872387180676
0.272727273,0.5,31.08333333,10/16/2016,32,23,away,-3,NOS,303,460,51,76,38,41,Loss,103,63,2,1,1,CAR,79,406,523,2,-9.69361484859187,61.21144327053208,25.758914210970104,35.452529059561975
0.5,0.272727273,28.91666667,10/16/2016,23,32,home,3,CAR,460,303,126,71,41,38,Win,63,103,1,2,2,NOS,79,523,406,1,9.69361484859187,61.21144327053208,35.452529059561975,25.758914210970104
0.2,0.41176470600000004,24.21666667,10/16/2016,20,22,away,1,CHI,263,297,50,55,17,16,Win,54,92,2,1,0,JAX,33,317,389,2,-8.667873830406334,44.75400439711235,18.043065283353005,26.71093911375934
0.41176470600000004,0.2,35.78333333,10/16/2016,22,20,home,-1,JAX,297,263,87,77,16,17,Loss,92,54,1,2,2,CHI,33,389,317,0,8.667873830406334,44.75400439711235,26.71093911375934,18.043065283353005
0.666666667,0.545454545,27.8,10/16/2016,23,20,away,-3,DET,311,265,62,55,28,31,Loss,76,83,1,1,0,LAR,59,387,348,1,1.1646736509778206,54.18625351779679,27.675463584387305,26.510789933409487
0.545454545,0.666666667,32.2,10/16/2016,20,23,home,3,LAR,265,311,62,58,31,28,Win,83,76,1,1,1,DET,59,348,387,0,-1.1646736509778206,54.18625351779679,26.510789933409487,27.675463584387305
0.272727273,0.5,23.5,10/16/2016,15,24,away,-15,MIA,169,252,65,53,15,30,Loss,128,222,2,0,0,PIT,45,297,474,2,-0.8755635506029122,45.4856590224192,22.305047735908143,23.180611286511056
0.5,0.272727273,36.5,10/16/2016,24,15,home,15,PIT,252,169,95,68,30,15,Win,222,128,0,2,2,MIA,45,474,297,0,0.8755635506029122,45.4856590224192,23.180611286511056,22.305047735908143
0.41666666700000005,0.4,32.05,10/16/2016,20,25,away,-18,NEP,237,358,46,65,17,35,Loss,120,79,2,3,0,CIN,52,357,437,0,11.940092103802849,47.11700520185743,29.52854865283014,17.588456549027292
0.4,0.41666666700000005,27.95,10/16/2016,25,20,home,18,CIN,358,237,55,61,35,17,Win,79,120,3,2,0,NEP,52,437,357,0,-11.940092103802849,47.11700520185743,17.588456549027292,29.52854865283014
0.538461538,0.4,36.75,10/16/2016,22,16,away,16,OAK,223,221,10,64,26,10,Win,183,64,1,2,2,KCC,36,406,285,0,2.3612588558467706,47.19549601626853,24.77837743605765,22.41711858021088
0.4,0.538461538,23.25,10/16/2016,16,22,home,-16,KCC,221,223,25,53,10,26,Loss,64,183,2,1,0,OAK,36,285,406,2,-2.3612588558467706,47.19549601626853,22.41711858021088,24.77837743605765
0.272727273,0.35714285700000004,29.85,10/16/2016,22,22,away,-2,SEA,310,261,66,64,24,26,Loss,52,72,4,1,0,ATL,50,362,333,2,3.8981701576668186,41.122213302339404,22.51019173000311,18.612021572336293
0.35714285700000004,0.272727273,30.15,10/16/2016,22,22,home,2,ATL,261,310,30,65,26,24,Win,72,52,1,4,2,SEA,50,333,362,0,-3.8981701576668186,41.122213302339404,18.612021572336293,22.51019173000311
0.272727273,0.538461538,29.83333333,10/16/2016,24,24,away,14,GBP,233,294,60,62,30,16,Win,191,78,2,1,4,DAL,46,424,372,2,3.994954302018669,55.38340617242141,29.68918023722004,25.69422593520137
0.538461538,0.272727273,30.16666667,10/16/2016,24,24,home,-14,DAL,294,233,23,67,16,30,Loss,78,191,1,2,2,GBP,46,372,424,4,-3.994954302018669,55.38340617242141,25.69422593520137,29.68918023722004
0.35714285700000004,0.454545455,36.55,10/16/2016,19,26,away,-3,HOU,231,256,42,67,0,3,Loss,161,158,3,1,1,IND,3,392,414,1,-6.263039439691136,46.70756090002475,20.22226073016681,26.485300169857943
0.454545455,0.35714285700000004,30.28333333,10/16/2016,26,19,home,3,IND,256,231,59,68,3,0,Win,158,161,1,3,1,HOU,3,414,392,1,6.263039439691136,46.70756090002475,26.485300169857943,20.22226073016681
0.153846154,0.545454545,23.96666667,10/17/2016,11,28,away,-25,ARI,197,225,83,52,3,28,Loss,33,171,1,0,0,NYJ,31,230,396,2,-1.81032643411584,40.43559789484685,19.312635730365507,21.122962164481343
0.545454545,0.153846154,36.03333333,10/17/2016,28,11,home,25,NYJ,225,197,64,70,28,3,Win,171,33,0,1,2,ARI,31,396,230,0,1.81032643411584,40.43559789484685,21.122962164481343,19.312635730365507
0.25,0.5625,20.4,10/20/2016,13,32,away,-16,GBP,120,303,108,45,10,26,Loss,69,103,1,2,1,CHI,36,189,406,2,-2.555313235065185,45.917782545604204,21.68123465526951,24.236547890334695
0.5625,0.25,39.6,10/20/2016,32,13,home,16,CHI,303,120,56,81,26,10,Win,103,69,2,1,2,GBP,36,406,189,1,2.555313235065185,45.917782545604204,24.236547890334695,21.68123465526951
0.307692308,0.473684211,24.95,10/23/2016,13,20,away,7,LAR,196,271,33,57,17,10,Win,36,74,0,3,4,NYG,27,232,345,1,-10.408676262632726,40.93392051083688,15.262622124102077,25.6712983867348
0.473684211,0.307692308,35.05,10/23/2016,20,13,home,-7,NYG,271,196,43,76,10,17,Loss,74,36,3,0,1,LAR,27,345,232,4,10.408676262632726,40.93392051083688,25.6712983867348,15.262622124102077
0.642857143,0.333333333,32.63333333,10/23/2016,27,20,away,-6,KCC,359,214,75,71,21,27,Loss,104,112,1,0,0,NOS,48,463,326,2,4.215634747455698,51.91430077323765,28.064967760346672,23.849333012890977
0.333333333,0.642857143,27.36666667,10/23/2016,20,27,home,6,NOS,214,359,30,52,27,21,Win,112,104,0,1,2,KCC,48,326,463,0,-4.215634747455698,51.91430077323765,23.849333012890977,28.064967760346672
0.4,0.6,32.5,10/23/2016,26,26,away,8,TEN,341,207,131,65,34,26,Win,81,124,2,3,1,IND,60,422,331,0,-6.237771542604001,53.37931030918935,23.570769383292674,29.808540925896676
0.6,0.4,27.5,10/23/2016,26,26,home,-8,IND,207,341,38,68,26,34,Loss,124,81,3,2,0,TEN,60,331,422,1,6.237771542604001,53.37931030918935,29.808540925896676,23.570769383292674
0.473684211,0.363636364,32.13333333,10/23/2016,18,15,away,-11,PHI,189,138,56,74,10,21,Loss,93,101,6,0,4,MIN,31,282,239,4,-1.7692479933004872,42.54148263597002,20.386117321334766,22.155365314635254
0.363636364,0.473684211,27.86666667,10/23/2016,15,18,home,11,MIN,138,189,53,54,21,10,Win,101,93,0,6,4,PHI,31,239,282,4,1.7692479933004872,42.54148263597002,22.155365314635254,20.386117321334766
0.428571429,0.5,31.8,10/23/2016,22,23,away,-14,CIN,172,288,35,63,17,31,Loss,180,271,2,3,1,CLE,48,352,559,2,6.0964516027417694,52.919773743319865,29.508112673030816,23.41166107028905
0.5,0.428571429,28.2,10/23/2016,23,22,home,14,CLE,288,172,30,61,31,17,Win,271,180,3,2,2,CIN,48,559,352,1,-6.0964516027417694,52.919773743319865,23.41166107028905,29.508112673030816
0.6,0.333333333,34.98333333,10/23/2016,26,19,away,-3,DET,283,250,20,70,17,20,Loss,130,94,2,3,0,WAS,37,413,344,2,2.016481843505139,49.93286782943741,25.974674836471277,23.958192992966136
0.333333333,0.6,25.01666667,10/23/2016,19,26,home,3,WAS,250,283,30,51,20,17,Win,94,130,3,2,2,DET,37,344,413,0,-2.016481843505139,49.93286782943741,23.958192992966136,25.974674836471277
0.444444444,0.307692308,33.45,10/23/2016,21,19,away,17,JAX,200,239,117,71,33,16,Win,144,105,0,1,3,OAK,49,344,344,0,-15.664841640969096,49.81293237453679,17.07404536678385,32.73888700775294
0.307692308,0.444444444,26.55,10/23/2016,19,21,home,-17,OAK,239,200,112,60,16,33,Loss,105,144,1,0,0,JAX,49,344,344,3,15.664841640969096,49.81293237453679,32.73888700775294,17.07404536678385
0.23076923100000002,0.41666666700000005,22.96666667,10/23/2016,16,26,away,-3,MIA,200,198,45,54,25,28,Loss,67,256,4,1,0,BUF,53,267,454,0,0.6897992370767589,43.13111386684304,21.910456551959896,21.22065731488314
0.41666666700000005,0.23076923100000002,37.03333333,10/23/2016,26,16,home,3,BUF,198,200,116,67,28,25,Win,256,67,1,4,0,MIA,53,454,267,0,-0.6897992370767589,43.13111386684304,21.22065731488314,21.910456551959896
0.214285714,0.375,23.38333333,10/23/2016,11,16,away,-8,NYJ,234,189,35,57,16,24,Loss,11,155,2,5,2,BAL,40,245,344,3,3.985794800396665,35.08304109030804,19.534417945352352,15.54862314495569
0.375,0.214285714,36.61666667,10/23/2016,16,11,home,8,BAL,189,234,25,66,24,16,Win,155,11,5,2,3,NYJ,40,344,245,2,-3.985794800396665,35.08304109030804,15.548623144955691,19.534417945352352
0.428571429,0.4,33.81666667,10/23/2016,27,20,away,17,SFO,264,113,78,73,34,17,Win,249,160,2,4,3,TBB,51,513,273,1,-9.360815390778729,47.75702667380896,19.198105641515113,28.558921032293846
0.4,0.428571429,26.18333333,10/23/2016,20,27,home,-17,TBB,113,264,31,66,17,34,Loss,160,249,4,2,1,SFO,51,273,513,3,9.360815390778729,47.75702667380896,28.558921032293846,19.198105641515113
0.5625,0.5,35.48333333,10/23/2016,26,21,away,3,ATL,348,256,14,75,3,0,Win,78,130,4,3,1,LAC,3,426,386,2,-4.626652868262687,47.22676130126297,21.30005421650014,25.92670708476283
0.5,0.5625,30.5,10/23/2016,21,26,home,-3,LAC,256,348,70,63,0,3,Loss,130,78,3,4,2,ATL,3,386,426,1,4.626652868262687,47.22676130126297,25.92670708476283,21.30005421650014
0.583333333,0.3125,27.51666667,10/23/2016,21,17,away,11,PIT,222,281,40,55,27,16,Win,140,94,0,0,1,NEP,43,362,375,2,5.369511786188611,46.03656284788694,25.703037317037776,20.333525530849165
0.3125,0.583333333,32.48333333,10/23/2016,17,21,home,-11,NEP,281,222,85,69,16,27,Loss,94,140,0,0,2,PIT,43,375,362,1,-5.369511786188611,46.03656284788694,20.333525530849165,25.703037317037776
0.214285714,0.47619047600000003,28.65,10/23/2016,11,23,away,0,ARI,205,311,90,57,3,3,Tie,52,132,1,4,0,SEA,6,257,443,0,-14.735771907788111,24.62911181466296,4.946669953437425,19.682441861225534
0.47619047600000003,0.214285714,46.35,10/23/2016,23,11,home,0,SEA,311,205,45,90,3,3,Tie,132,52,4,1,0,ARI,6,443,257,0,14.735771907788111,24.62911181466296,19.682441861225534,4.946669953437424
0.38888888899999996,0.272727273,29.36666667,10/24/2016,14,19,away,-18,DEN,131,157,15,67,9,27,Loss,140,190,1,0,0,HOU,36,271,347,2,-7.367247892834648,37.901232085608946,15.266992096387149,22.634239989221797
0.272727273,0.38888888899999996,30.63333333,10/24/2016,19,14,home,18,HOU,157,131,83,60,27,9,Win,190,140,0,1,2,DEN,36,347,271,0,7.367247892834648,37.901232085608946,22.634239989221797,15.266992096387149
0.46153846200000004,0.6,25.58333333,10/27/2016,27,25,away,-14,TEN,322,280,75,67,22,36,Loss,48,214,2,0,0,JAX,58,370,494,1,-8.873020257986612,58.29175521662023,24.70936747931681,33.58238773730342
0.6,0.46153846200000004,34.41666667,10/27/2016,25,27,home,14,JAX,280,322,54,66,36,22,Win,214,48,0,2,1,TEN,58,494,370,0,8.873020257986612,58.29175521662023,33.58238773730342,24.70936747931681
0.470588235,0.533333333,39.7,10/30/2016,30,35,away,0,CIN,446,263,106,88,0,0,Tie,100,152,1,3,2,WAS,0,546,415,1,-19.717947617385576,53.178597215982606,16.730324799298515,36.44827241668409
0.533333333,0.470588235,35.3,10/30/2016,35,30,home,0,WAS,263,446,85,81,0,0,Tie,152,100,3,1,1,CIN,0,415,546,2,19.717947617385576,53.178597215982606,36.44827241668409,16.730324799298515
0.4375,0.307692308,33.6,10/30/2016,20,18,away,16,IND,334,172,40,71,30,14,Win,88,105,3,6,2,KCC,44,422,277,0,-2.8819160727930306,40.87782733479144,18.997955630999204,21.879871703792237
0.307692308,0.4375,26.4,10/30/2016,18,20,home,-16,KCC,172,334,45,62,14,30,Loss,105,88,6,3,0,IND,44,277,422,2,2.8819160727930306,40.87782733479144,21.879871703792237,18.997955630999204
0.38888888899999996,0.307692308,44.2,10/30/2016,27,18,away,6,TBB,498,168,200,85,6,0,Win,128,102,2,2,0,OAK,6,626,270,1,-22.311100672690202,47.03878383458825,12.363841580949021,34.67494225363923
0.307692308,0.38888888899999996,29.05,10/30/2016,18,27,home,-6,OAK,168,498,64,61,0,6,Loss,102,128,2,2,1,TBB,6,270,626,0,22.311100672690202,47.03878383458825,34.67494225363923,12.363841580949025
0.454545455,0.6,23.8,10/30/2016,15,28,away,-5,NOS,285,252,76,54,20,25,Loss,74,123,1,2,1,SEA,45,359,375,1,3.1609008971882053,47.79979013073625,25.480345513962227,22.31944461677402
0.6,0.454545455,36.2,10/30/2016,28,15,home,5,SEA,252,285,10,72,25,20,Win,123,74,2,1,1,NOS,45,375,359,1,-3.1609008971882053,47.79979013073625,22.31944461677402,25.480345513962227
0.272727273,0.4,26.03333333,10/30/2016,19,20,away,-7,HOU,231,164,75,56,13,20,Loss,58,105,1,3,1,DET,33,289,269,0,-1.7899732960876515,39.23764736662035,18.72383703526635,20.513810331354
0.4,0.272727273,33.96666667,10/30/2016,20,19,home,7,DET,164,231,49,63,20,13,Win,105,58,3,1,0,HOU,33,269,289,1,1.7899732960876515,39.23764736662035,20.513810331354,18.72383703526635
0.46666666700000003,0.5,33.68333333,10/30/2016,21,22,away,3,CLE,222,339,37,71,31,28,Win,171,68,2,1,2,NYJ,59,393,407,0,-8.110532717765595,46.82959227227464,19.359529777254522,27.470062495020116
0.5,0.46666666700000003,26.31666667,10/30/2016,22,21,home,-3,NYJ,339,222,10,70,28,31,Loss,68,171,1,2,0,CLE,59,407,393,2,8.110532717765595,46.82959227227464,27.470062495020116,19.359529777254522
0.692307692,0.307692308,29.85,10/30/2016,23,25,away,16,BUF,285,209,116,61,41,25,Win,72,167,5,2,0,NEP,66,357,376,0,2.7721270747112783,48.953087710959686,25.862607392835482,23.090480318124204
0.307692308,0.692307692,30.15,10/30/2016,25,23,home,-16,NEP,209,285,84,68,25,41,Loss,167,72,2,5,0,BUF,66,376,357,0,-2.7721270747112783,48.953087710959686,23.090480318124204,25.862607392835482
0.333333333,0.428571429,29.2,10/30/2016,22,19,away,-10,CAR,316,208,88,64,20,30,Loss,24,141,8,1,1,ARI,50,340,349,2,-4.088780821625049,45.43727074820943,20.67424496329219,24.76302578491724
0.428571429,0.333333333,30.8,10/30/2016,19,22,home,10,ARI,208,316,40,64,30,20,Win,141,24,1,8,2,CAR,50,349,340,1,4.088780821625049,45.43727074820943,24.76302578491724,20.67424496329219
0.41176470600000004,0.333333333,33.13333333,10/30/2016,21,15,away,-8,DEN,246,267,52,77,19,27,Loss,123,57,4,1,3,LAC,46,369,324,3,-7.967728785299155,44.516716867038575,18.274494040869712,26.242222826168863
0.333333333,0.41176470600000004,26.86666667,10/30/2016,15,21,home,8,LAC,267,246,45,64,27,19,Win,57,123,1,4,3,DEN,46,324,369,3,7.967728785299155,44.516716867038575,26.242222826168863,18.274494040869712
0.6,0.444444444,31.28333333,10/30/2016,24,25,away,-1,ATL,223,277,68,60,32,33,Loss,108,90,3,2,0,GBP,65,331,367,0,7.975546673992474,49.732812512672695,28.854179593332585,20.87863291934011
0.444444444,0.6,28.71666667,10/30/2016,25,24,home,1,GBP,277,223,46,56,33,32,Win,90,108,2,3,0,ATL,65,367,331,0,-7.975546673992474,49.732812512672695,20.87863291934011,28.854179593332585
0.4,0.28571428600000004,33.25,10/30/2016,21,26,away,-6,DAL,194,273,40,71,0,6,Loss,97,187,3,2,1,PHI,6,291,460,1,-9.280411131204003,41.15255274068278,15.936070804739387,25.216481935943392
0.28571428600000004,0.4,33.95,10/30/2016,26,21,home,6,PHI,273,194,84,76,6,0,Win,187,97,2,3,1,DAL,6,460,291,1,9.280411131204003,41.15255274068278,25.216481935943392,15.936070804739387
0.153846154,0.5,27.31666667,10/31/2016,15,19,away,-10,CHI,201,245,10,60,10,20,Loss,57,158,5,1,0,MIN,30,258,403,0,0.24090868758234052,36.34150496963971,18.291206828611024,18.050298141028684
0.5,0.153846154,32.68333333,10/31/2016,19,15,home,10,MIN,245,201,20,61,20,10,Win,158,57,1,5,0,CHI,30,403,258,0,-0.24090868758234052,36.34150496963971,18.050298141028684,18.291206828611024
0.6,0.571428571,33.46666667,11/3/2016,31,23,away,15,TBB,325,326,34,70,43,28,Win,136,70,2,2,2,ATL,71,461,396,1,-8.485691100247458,56.67701607433677,24.095662487044656,32.581353587292114
0.571428571,0.6,26.53333333,11/3/2016,23,31,home,-15,ATL,326,325,85,70,28,43,Loss,70,136,2,2,1,TBB,71,396,461,2,8.485691100247458,56.67701607433677,32.581353587292114,24.095662487044656
0.5,0.428571429,33.51666667,11/6/2016,18,22,away,6,MIN,214,259,57,62,6,0,Win,97,78,1,2,0,DET,6,311,337,1,-5.23601022486392,39.704676819006394,17.234333297071238,22.470343521935156
0.428571429,0.5,33.13333333,11/6/2016,22,18,home,-6,DET,259,214,54,67,0,6,Loss,78,97,2,1,1,MIN,6,337,311,0,5.23601022486392,39.704676819006394,22.470343521935156,17.234333297071238
0.2,0.307692308,32.66666667,11/6/2016,21,16,away,-5,NYG,347,248,43,74,23,28,Loss,96,54,2,1,2,PHI,51,443,302,2,-1.8614040583558196,47.03003136869728,22.58431365517073,24.445717713526548
0.307692308,0.2,27.33333333,11/6/2016,16,21,home,5,PHI,248,347,30,61,28,23,Win,54,96,1,2,2,NYG,51,302,443,2,1.8614040583558196,47.03003136869728,24.445717713526548,22.58431365517073
0.3,0.454545455,29.63333333,11/6/2016,18,20,away,-4,MIA,191,137,77,53,23,27,Loss,140,137,3,1,0,NYJ,50,331,274,2,1.206393220772025,40.86360873911997,21.035000979946,19.82860775917397
0.454545455,0.3,30.36666667,11/6/2016,20,18,home,4,NYJ,137,191,85,62,27,23,Win,137,140,1,3,2,MIA,50,274,331,0,-1.206393220772025,40.86360873911997,19.82860775917397,21.035000979946
0.384615385,0.071428571,29.65,11/6/2016,25,10,away,-5,KCC,244,169,46,75,14,19,Loss,205,62,2,2,0,JAX,33,449,231,4,-7.854151748098241,39.05983008402538,15.60283916796357,23.45699091606181
0.071428571,0.384615385,30.35,11/6/2016,10,25,home,5,JAX,169,244,75,57,19,14,Win,62,205,2,2,4,KCC,33,231,449,0,7.854151748098241,39.05983008402538,23.45699091606181,15.60283916796357
0.666666667,0.111111111,39.65,11/6/2016,29,13,away,25,CLE,255,177,38,70,35,10,Win,168,45,0,4,0,DAL,45,423,222,0,5.467227968722423,38.2281249460301,21.84767645737626,16.38044848865384
0.111111111,0.666666667,20.35,11/6/2016,13,29,home,-25,DAL,177,255,33,44,10,35,Loss,45,168,4,0,0,CLE,45,222,423,0,-5.467227968722423,38.2281249460301,16.38044848865384,21.84767645737626
0.25,0.235294118,27.83333333,11/6/2016,15,13,away,-7,BAL,241,224,99,65,14,21,Loss,36,50,2,3,1,PIT,35,277,274,1,-4.826692708515302,29.622416355964784,12.397861823724742,17.22455453224004
0.235294118,0.25,32.16666667,11/6/2016,13,15,home,7,PIT,224,241,94,63,21,14,Win,50,36,3,2,1,BAL,35,274,277,1,4.826692708515302,29.622416355964784,17.22455453224004,12.39786182372474
0.647058824,0.222222222,38.88333333,11/6/2016,29,19,away,18,SFO,323,393,40,82,41,23,Win,248,93,1,1,4,NOS,64,571,486,0,-2.218358276448029,61.695772569723076,29.738707146637523,31.957065423085552
0.222222222,0.647058824,21.11666667,11/6/2016,19,29,home,-18,NOS,393,323,78,57,23,41,Loss,93,248,1,1,0,SFO,64,486,571,4,2.218358276448029,61.695772569723076,31.957065423085552,29.738707146637523
0.4,0.28571428600000004,34.2,11/6/2016,16,18,away,3,LAR,185,280,35,62,13,10,Win,59,59,5,4,1,CAR,23,244,339,0,-12.849253811231733,37.79934755937845,12.475046874073357,25.32430068530509
0.28571428600000004,0.4,25.8,11/6/2016,18,16,home,-3,CAR,280,185,109,67,10,13,Loss,59,59,4,5,0,LAR,23,339,244,1,12.849253811231733,37.79934755937845,25.32430068530509,12.475046874073357
0.5,0.333333333,30.05,11/6/2016,22,25,away,5,GBP,270,289,35,66,31,26,Win,85,116,2,3,1,IND,57,355,405,2,4.6602958617406625,52.60992371180305,28.635109786771856,23.974813925031192
0.333333333,0.5,29.95,11/6/2016,25,22,home,-5,IND,289,270,25,65,26,31,Loss,116,85,3,2,2,GBP,57,405,355,1,-4.6602958617406625,52.60992371180305,23.974813925031192,28.635109786771856
0.454545455,0.454545455,23.51666667,11/6/2016,24,31,away,-8,LAC,313,268,57,62,35,43,Loss,80,208,0,1,0,TEN,78,393,476,3,-6.754142738876812,58.59351700762218,25.919687134372687,32.673829873249495
0.454545455,0.454545455,36.48333333,11/6/2016,31,24,home,8,TEN,268,313,107,73,43,35,Win,208,80,1,0,3,LAC,78,476,393,0,6.754142738876812,58.59351700762218,32.673829873249495,25.919687134372687
0.272727273,0.35714285700000004,18.53333333,11/6/2016,13,30,away,-10,OAK,266,179,104,51,20,30,Loss,33,218,2,2,0,DEN,50,299,397,2,-2.916410410345204,49.26944585025568,23.176517719955235,26.092928130300443
0.35714285700000004,0.272727273,41.46666667,11/6/2016,30,13,home,10,DEN,179,266,72,76,30,20,Win,218,33,2,2,2,OAK,50,397,299,0,2.916410410345204,49.26944585025568,26.092928130300443,23.176517719955235
0.705882353,0.28571428600000004,40.28333333,11/7/2016,30,19,away,-6,SEA,263,245,115,82,25,31,Loss,162,33,5,4,0,BUF,56,425,278,1,2.2469303209776093,49.64321742621032,25.945073873593966,23.698143552616354
0.28571428600000004,0.705882353,19.71666667,11/7/2016,19,30,home,6,BUF,245,263,75,42,31,25,Win,33,162,4,5,1,SEA,56,278,425,0,-2.2469303209776093,49.64321742621032,23.698143552616354,25.945073873593966
0.2,0.583333333,21.4,11/10/2016,11,29,away,-21,BAL,111,277,35,48,7,28,Loss,33,119,4,2,2,CLE,35,144,396,3,5.4114760386838405,37.48767338515659,21.449574711920214,16.038098673236377
0.583333333,0.2,38.6,11/10/2016,29,11,home,21,CLE,277,111,61,77,28,7,Win,119,33,2,4,3,BAL,35,396,144,2,-5.4114760386838405,37.48767338515659,16.038098673236377,21.449574711920214
0.46666666700000003,0.588235294,27.83333333,11/13/2016,16,23,away,3,JAX,92,247,89,61,24,21,Win,181,80,1,2,2,HOU,45,273,327,0,-17.73110926875581,42.67913255569934,12.474011643471766,30.205120912227574
0.588235294,0.46666666700000003,32.16666667,11/13/2016,23,16,home,-3,HOU,247,92,49,73,21,24,Loss,80,181,2,1,0,JAX,45,327,273,2,17.73110926875581,42.67913255569934,30.205120912227574,12.474011643471766
0.578947368,0.444444444,39.36666667,11/13/2016,24,19,away,2,NOS,234,293,10,83,25,23,Win,103,80,6,1,4,DEN,48,337,373,2,4.063388567791861,51.546353742189275,27.80487115499057,23.741482587198707
0.444444444,0.578947368,20.63333333,11/13/2016,19,24,home,-2,DEN,293,234,25,51,23,25,Loss,80,103,1,6,2,NOS,48,373,337,4,-4.063388567791861,51.546353742189275,23.741482587198707,27.80487115499057
0.352941176,0.333333333,34.48333333,11/13/2016,16,17,away,3,NYJ,155,157,55,67,9,6,Win,125,139,3,1,1,LAR,15,280,296,0,-7.261213285962976,34.892619226359365,13.815702970198195,21.07691625616117
0.333333333,0.352941176,25.51666667,11/13/2016,17,16,home,-3,LAR,157,155,31,58,6,9,Loss,139,125,1,3,0,NYJ,15,296,280,1,7.261213285962976,34.892619226359365,21.07691625616117,13.815702970198195
0.181818182,0.35714285700000004,21.83333333,11/13/2016,11,25,away,-9,PHI,255,221,67,48,15,24,Loss,48,208,2,2,1,ATL,39,303,429,1,0.7603319155782415,42.19458221637989,21.477457065979067,20.717125150400825
0.35714285700000004,0.181818182,38.16666667,11/13/2016,25,11,home,9,ATL,221,255,77,76,24,15,Win,208,48,2,2,1,PHI,39,429,303,1,-0.7603319155782415,42.19458221637989,20.717125150400825,21.477457065979067
0.166666667,0.428571429,24.8,11/13/2016,18,22,away,3,CAR,165,242,45,61,20,17,Win,91,99,3,2,2,KCC,37,256,341,1,-5.742606629786476,39.50764894226925,16.88252115624139,22.62512778602786
0.428571429,0.166666667,35.2,11/13/2016,22,18,home,-3,KCC,242,165,53,69,17,20,Loss,99,91,2,3,1,CAR,37,341,256,2,5.742606629786476,39.50764894226925,22.62512778602786,16.88252115624139
0.181818182,0.533333333,22.85,11/13/2016,15,22,away,-26,TBB,161,280,74,54,10,36,Loss,122,80,4,4,1,CHI,46,283,360,4,-5.833682365702664,43.239122015543465,18.7027198249204,24.536402190623065
0.533333333,0.181818182,37.15,11/13/2016,22,15,home,26,CHI,280,161,85,68,36,10,Win,80,122,4,4,4,TBB,46,360,283,1,5.833682365702664,43.239122015543465,24.536402190623065,18.7027198249204
0.454545455,0.5,30.06666667,11/13/2016,22,23,away,-6,WAS,284,260,35,64,20,26,Loss,47,128,3,1,1,MIN,46,331,388,1,-2.608646333532044,47.58917185615201,22.49026276130998,25.098909094842025
0.5,0.454545455,29.93333333,11/13/2016,23,22,home,6,MIN,260,284,35,62,26,20,Win,128,47,1,3,1,WAS,46,388,331,1,2.608646333532044,47.58917185615201,25.098909094842025,22.49026276130998
0.26666666699999997,0.5,30.48333333,11/13/2016,21,19,away,-22,TEN,333,292,107,73,25,47,Loss,69,154,5,1,0,GBP,72,402,446,3,-6.995470288420684,53.40846527012025,23.206497490849785,30.20196777927047
0.5,0.26666666699999997,29.51666667,11/13/2016,19,21,home,22,GBP,292,333,65,59,47,25,Win,154,69,1,5,3,TEN,72,446,402,0,6.995470288420684,53.40846527012025,30.20196777927047,23.206497490849785
0.4,0.545454545,27.01666667,11/13/2016,17,29,away,7,LAC,231,309,81,50,31,24,Win,106,70,1,3,4,MIA,55,337,379,1,4.986439780610602,51.66215680753164,28.32429829407112,23.337858513460517
0.545454545,0.4,32.98333333,11/13/2016,29,17,home,-7,MIA,309,231,29,71,24,31,Loss,70,106,3,1,1,LAC,55,379,337,4,-4.986439780610602,51.66215680753164,23.337858513460517,28.32429829407112
0.41176470600000004,0.5,27.7,11/13/2016,15,26,away,-3,ARI,198,363,100,61,20,23,Loss,83,80,3,2,4,SFO,43,281,443,1,-4.387660469527925,46.322020530356895,20.967180030414486,25.35484049994241
0.5,0.41176470600000004,32.3,11/13/2016,26,15,home,3,SFO,363,198,10,74,23,20,Win,80,83,2,3,1,ARI,43,443,281,4,4.387660469527925,46.322020530356895,25.35484049994241,20.967180030414486
0.538461538,0.4,30.4,11/13/2016,20,30,away,5,PIT,295,400,98,59,35,30,Win,127,48,2,1,0,DAL,65,422,448,1,1.5626457021459483,54.57767989820141,28.07016280017368,26.50751709802773
0.4,0.538461538,29.6,11/13/2016,30,20,home,-5,DAL,400,295,40,66,30,35,Loss,48,127,1,2,1,PIT,65,448,422,0,-1.5626457021459483,54.57767989820141,26.50751709802773,28.07016280017368
0.5,0.6,30.41666667,11/13/2016,23,25,away,7,NEP,324,304,60,66,31,24,Win,96,81,3,2,2,SEA,55,420,385,0,9.956508897550597,52.64232780240321,31.299418349976904,21.342909452426305
0.6,0.5,29.58333333,11/13/2016,25,23,home,-7,SEA,304,324,61,62,24,31,Loss,81,96,2,3,0,NEP,55,385,420,2,-9.956508897550597,52.64232780240321,21.342909452426305,31.299418349976904
0.181818182,0.428571429,28.61666667,11/14/2016,12,23,away,-1,NYG,186,229,60,55,20,21,Loss,78,122,3,1,2,CIN,41,264,351,1,-0.437472878350718,38.87841601749615,19.220471569572716,19.657944447923434
0.428571429,0.181818182,31.38333333,11/14/2016,23,12,home,1,CIN,229,186,15,72,21,20,Win,122,78,1,3,1,NYG,41,351,264,2,0.437472878350718,38.87841601749615,19.657944447923434,19.220471569572716
0.307692308,0.41176470600000004,32.25,11/17/2016,28,17,away,-3,CAR,264,173,48,72,20,23,Loss,107,50,3,2,0,NOS,43,371,223,2,-4.964192039672358,42.18880924061191,18.612308600469778,23.576500640142132
0.41176470600000004,0.307692308,27.75,11/17/2016,17,28,home,3,NOS,173,264,45,62,23,20,Win,50,107,2,3,2,CAR,43,223,371,0,4.964192039672358,42.18880924061191,23.576500640142132,18.612308600469778
0.41666666700000005,0.26666666699999997,33.96666667,11/20/2016,24,17,away,15,CLE,167,176,70,64,24,9,Win,146,33,0,8,2,PIT,33,313,209,0,-0.5386444739709475,33.360424580986205,16.41089005350763,16.949534527478576
0.26666666699999997,0.41666666700000005,26.03333333,11/20/2016,17,24,home,-15,PIT,176,167,52,62,9,24,Loss,33,146,8,0,0,CLE,33,209,313,2,0.5386444739709475,33.360424580986205,16.949534527478576,16.41089005350763
0.333333333,0.583333333,24.35,11/20/2016,17,27,away,-10,DAL,267,299,136,52,17,27,Loss,101,118,1,1,0,BAL,44,368,417,0,2.6047360441730305,47.58723938937494,25.095987716773987,22.491251672600956
0.583333333,0.333333333,35.65,11/20/2016,27,17,home,10,BAL,299,267,45,67,27,17,Win,118,101,1,1,0,DAL,44,417,368,0,-2.6047360441730305,47.58723938937494,22.491251672600956,25.095987716773987
0.28571428600000004,0.35714285700000004,32.91666667,11/20/2016,16,14,away,-7,DET,202,263,25,62,19,26,Loss,83,14,0,3,2,JAX,45,285,277,3,-0.09685931492949251,39.89777723006053,19.90045895756552,19.997318272495008
0.35714285700000004,0.28571428600000004,27.08333333,11/20/2016,14,16,home,7,JAX,263,202,32,57,26,19,Win,14,83,3,0,3,DET,45,277,285,2,0.09685931492949251,39.89777723006053,19.997318272495008,19.90045895756552
0.35714285700000004,0.41666666700000005,31.01666667,11/20/2016,20,18,away,-7,IND,254,251,109,70,17,24,Loss,97,76,5,2,1,TEN,41,351,327,0,-8.479707477466707,43.25862704424918,17.38945978339124,25.869167260857942
0.41666666700000005,0.35714285700000004,28.98333333,11/20/2016,18,20,home,7,TEN,251,254,70,58,24,17,Win,76,97,2,5,0,IND,41,327,351,1,8.479707477466707,43.25862704424918,25.869167260857942,17.38945978339124
0.25,0.533333333,32.18333333,11/20/2016,20,23,away,4,CIN,159,207,75,63,16,12,Win,183,93,2,1,2,BUF,28,342,300,1,-2.4549573634514488,43.04959598972249,20.29731931313552,22.75227667658697
0.533333333,0.25,27.81666667,11/20/2016,23,20,home,-4,BUF,207,159,25,71,12,16,Loss,93,183,1,2,1,CIN,28,300,342,2,2.4549573634514488,43.04959598972249,22.75227667658697,20.29731931313552
0.6875,0.5,35.3,11/20/2016,27,19,away,2,KCC,326,261,42,74,19,17,Win,116,82,1,0,2,TBB,36,442,343,1,-3.3157269509579086,53.069871225550145,24.877072137296118,28.192799088254027
0.5,0.6875,24.7,11/20/2016,19,27,home,-2,TBB,261,326,30,52,17,19,Loss,82,116,0,1,1,KCC,36,343,442,2,3.3157269509579086,53.069871225550145,28.192799088254027,24.877072137296118
0.333333333,0.35714285700000004,30.48333333,11/20/2016,17,19,away,-6,NYG,222,227,40,59,16,22,Loss,93,102,4,0,0,CHI,38,315,329,1,-4.26594117556862,39.72338944865995,17.728724136545665,21.994665312114286
0.35714285700000004,0.333333333,29.51666667,11/20/2016,19,17,home,6,CHI,227,222,35,65,22,16,Win,102,93,0,4,1,NYG,38,329,315,0,4.26594117556862,39.72338944865995,21.994665312114286,17.728724136545665
0.307692308,0.46153846200000004,31.03333333,11/20/2016,24,16,away,-6,MIN,155,145,96,70,24,30,Loss,135,72,4,2,1,ARI,54,290,217,2,-2.9974155849197928,36.226245645082216,16.61441503008121,19.611830615001004
0.46153846200000004,0.307692308,28.96666667,11/20/2016,16,24,home,6,ARI,145,155,73,54,30,24,Win,72,135,2,4,2,MIN,54,217,290,1,2.9974155849197928,36.226245645082216,19.611830615001004,16.61441503008121
0.090909091,0.153846154,28.68333333,11/20/2016,17,12,away,4,LAR,142,125,82,57,14,10,Win,98,102,4,1,1,MIA,24,240,227,1,-2.2807285066313936,26.45555990250083,12.087415697934718,14.368144204566113
0.153846154,0.090909091,31.31666667,11/20/2016,12,17,home,-4,MIA,125,142,70,60,10,14,Loss,102,98,1,4,1,LAR,24,227,240,1,2.2807285066313936,26.45555990250083,14.368144204566113,12.087415697934718
0.5,0.35714285700000004,29.28333333,11/20/2016,28,20,away,13,SFO,273,177,40,71,30,17,Win,171,122,1,5,0,NEP,47,444,299,0,5.0332488014770895,43.957341279228025,24.49529504035256,19.462046238875466
0.35714285700000004,0.5,30.71666667,11/20/2016,20,28,home,-13,NEP,177,273,68,62,17,30,Loss,122,171,5,1,0,SFO,47,299,444,0,-5.0332488014770895,43.957341279228025,19.462046238875466,24.49529504035256
0.375,0.333333333,31.1,11/20/2016,20,18,away,-11,SEA,195,287,48,73,15,26,Loss,113,152,2,1,0,PHI,41,308,439,2,-2.9670764207752036,43.27930839981833,20.156115989521567,23.123192410296767
0.333333333,0.375,28.9,11/20/2016,18,20,home,11,PHI,287,195,48,63,26,15,Win,152,113,1,2,2,SEA,41,439,308,0,2.9670764207752036,43.27930839981833,23.123192410296767,20.156115989521567
0.46666666700000003,0.642857143,30.38333333,11/20/2016,19,21,away,-18,WAS,340,364,59,65,24,42,Loss,84,151,2,2,0,GBP,66,424,515,2,-5.076782969202647,57.59168693527037,26.25745198303386,31.334234952236507
0.642857143,0.46666666700000003,29.61666667,11/20/2016,21,19,home,18,GBP,364,340,40,62,42,24,Win,151,84,2,2,2,WAS,66,515,424,0,5.076782969202647,57.59168693527037,31.334234952236507,26.25745198303386
0.5,0.363636364,36.45,11/21/2016,22,16,away,-7,OAK,230,295,101,74,20,27,Loss,124,30,2,0,1,HOU,47,354,325,2,-8.199933731583542,49.84778103209951,20.823923650257985,29.023857381841527
0.363636364,0.5,23.55,11/21/2016,16,22,home,7,HOU,295,230,21,51,27,20,Win,30,124,0,2,2,OAK,47,325,354,1,8.199933731583542,49.84778103209951,29.023857381841527,20.823923650257985
0.2,0.428571429,31.51666667,11/24/2016,17,18,away,-3,DET,224,214,40,53,13,16,Loss,82,94,0,2,0,MIN,29,306,308,1,5.5254315133248415,38.89349526623236,22.2094633897786,16.68403187645376
0.428571429,0.2,28.48333333,11/24/2016,18,17,home,3,MIN,214,224,16,61,16,13,Win,94,82,2,0,1,DET,29,308,306,0,-5.5254315133248415,38.89349526623236,16.68403187645376,22.2094633897786
0.533333333,0.5,33.4,11/24/2016,25,24,away,-5,DAL,449,190,30,72,26,31,Loss,56,163,0,1,0,WAS,57,505,353,0,-3.5689023709113865,51.5397774197566,23.985437524422604,27.554339895333992
0.5,0.533333333,26.6,11/24/2016,24,25,home,5,WAS,190,449,25,55,31,26,Win,163,56,1,0,0,DAL,57,353,505,0,3.5689023709113865,51.5397774197566,27.554339895333992,23.985437524422604
0.636363636,0.533333333,28.25,11/24/2016,16,18,away,21,IND,221,219,67,50,28,7,Win,148,91,0,3,2,PIT,35,369,310,0,2.8004432918659212,45.97096783534655,24.385705563606237,21.585262271740312
0.533333333,0.636363636,31.75,11/24/2016,18,16,home,-21,PIT,219,221,10,63,7,28,Loss,91,148,3,0,0,IND,35,310,369,2,-2.8004432918659212,45.97096783534655,21.585262271740312,24.385705563606237
0.454545455,0.529411765,29.41666667,11/27/2016,18,25,away,6,CHI,226,316,118,52,27,21,Win,149,95,0,0,2,TEN,48,375,411,0,-11.1829457127091,51.78508363850559,20.301068962898245,31.484014675607344
0.529411765,0.454545455,30.58333333,11/27/2016,25,18,home,-6,TEN,316,226,48,76,21,27,Loss,95,149,0,0,0,CHI,48,411,375,2,11.1829457127091,51.78508363850559,31.484014675607344,20.301068962898245
0.533333333,0.41666666700000005,33.58333333,11/27/2016,20,15,away,-7,BUF,118,151,60,65,21,28,Loss,183,153,2,5,0,JAX,49,301,304,0,-3.473688381478875,39.53288668057384,18.029599149547483,21.503287531026356
0.41666666700000005,0.533333333,26.41666667,11/27/2016,15,20,home,7,JAX,151,118,31,52,28,21,Win,153,183,5,2,0,BUF,49,304,301,0,3.473688381478875,39.53288668057384,21.503287531026356,18.029599149547483
0.3125,0.3125,28.71666667,11/27/2016,22,16,away,-5,BAL,261,219,15,71,14,19,Loss,64,92,3,2,1,CIN,33,325,311,2,-0.0382375326573432,36.62057074278704,18.29116660506485,18.32940413772219
0.3125,0.3125,31.28333333,11/27/2016,16,22,home,5,CIN,219,261,69,68,19,14,Win,92,64,2,3,2,BAL,33,311,325,1,0.0382375326573432,36.62057074278704,18.32940413772219,18.29116660506485
0.363636364,0.444444444,25.63333333,11/27/2016,23,28,away,-19,ATL,274,244,60,61,19,38,Loss,58,116,2,3,1,ARI,57,332,360,1,4.996050531095213,44.75852172343936,24.877286127267286,19.881235596172072
0.444444444,0.363636364,34.36666667,11/27/2016,28,23,home,19,ARI,244,274,23,67,38,19,Win,116,58,3,2,1,ATL,57,360,332,1,-4.996050531095213,44.75852172343936,19.881235596172072,24.877286127267286
0.307692308,0.214285714,26.15,11/27/2016,13,21,away,14,CLE,192,285,100,55,27,13,Win,104,58,1,7,3,NYG,40,296,343,1,-3.7426981366909047,38.58951437250257,17.423408117905833,21.166106254596738
0.214285714,0.307692308,33.85,11/27/2016,21,13,home,-14,NYG,285,192,35,72,13,27,Loss,58,104,7,1,1,CLE,40,343,296,3,3.7426981366909047,38.58951437250257,21.166106254596738,17.423408117905833
0.2,0.46153846200000004,24.06666667,11/27/2016,13,27,away,-28,NOS,178,346,62,52,21,49,Loss,69,209,3,2,1,LAR,70,247,555,2,1.9695139429540873,48.76904864377308,25.369281293363585,23.399767350409498
0.46153846200000004,0.2,35.93333333,11/27/2016,27,13,home,28,LAR,346,178,45,71,49,21,Win,209,69,2,3,2,NOS,70,555,247,1,-1.9695139429540873,48.76904864377308,23.399767350409498,25.369281293363585
0.5,0.5,29.46666667,11/27/2016,25,19,away,-7,MIA,282,263,65,73,24,31,Loss,193,95,2,2,0,SFO,55,475,358,2,-2.777986075067927,50.19749671977721,23.709755322354642,26.48774139742257
0.5,0.5,30.53333333,11/27/2016,19,25,home,7,SFO,263,282,42,58,31,24,Win,95,193,2,2,2,MIA,55,358,475,0,2.777986075067927,50.19749671977721,26.48774139742257,23.709755322354642
0.363636364,0.363636364,29.98333333,11/27/2016,18,22,away,8,HOU,235,239,78,49,21,13,Win,67,114,1,1,4,LAC,34,302,353,1,1.8791161450740397,47.883050828415065,24.88108348674455,23.001967341670515
0.363636364,0.363636364,30.01666667,11/27/2016,22,18,home,-8,LAC,239,235,58,65,13,21,Loss,114,67,1,1,1,HOU,34,353,302,4,-1.8791161450740397,47.883050828415065,23.001967341670515,24.88108348674455
0.090909091,0.363636364,26.35,11/27/2016,16,19,away,-9,TBB,118,220,27,61,5,14,Loss,127,118,6,0,2,SEA,19,245,338,3,-0.10460399712717106,35.08709088035642,17.491243441614625,17.595847438741796
0.363636364,0.090909091,33.65,11/27/2016,19,16,home,9,SEA,220,118,68,63,14,5,Win,118,127,0,6,3,TBB,19,338,245,2,0.10460399712717106,35.08709088035642,17.595847438741796,17.491243441614625
0.3,0.533333333,26.38333333,11/27/2016,19,22,away,-3,OAK,229,310,67,56,32,35,Loss,129,56,2,1,2,CAR,67,358,366,2,-7.264455500740711,54.40745087671792,23.571497687988604,30.835953188729313
0.533333333,0.3,33.61666667,11/27/2016,22,19,home,3,CAR,310,229,46,71,35,32,Win,56,129,1,2,2,OAK,67,366,358,2,7.264455500740711,54.40745087671792,30.835953188729313,23.571497687988604
0.28571428600000004,0.454545455,30.6,11/27/2016,26,16,away,5,NYJ,286,269,15,71,22,17,Win,91,64,0,1,2,NEP,39,377,333,0,7.9658552151197854,45.29823022201843,26.63204271856911,18.666187503449322
0.454545455,0.28571428600000004,29.4,11/27/2016,16,26,home,-5,NEP,269,286,66,56,17,22,Loss,64,91,1,0,0,NYJ,39,333,377,2,-7.9658552151197854,45.29823022201843,18.666187503449322,26.63204271856911
0.294117647,0.45,37.65,11/27/2016,23,21,away,3,DEN,190,340,71,76,6,3,Win,83,124,6,5,1,KCC,9,273,464,0,-13.618255939798933,33.90588762106135,10.14381584063121,23.762071780430144
0.45,0.294117647,37.31666667,11/27/2016,21,23,home,-3,KCC,340,190,97,77,3,6,Loss,124,83,5,6,0,DEN,9,464,273,1,13.618255939798933,33.90588762106135,23.762071780430144,10.14381584063121
0.7142857140000001,0.454545455,35.38333333,11/28/2016,25,20,away,14,PHI,313,211,51,67,27,13,Win,74,81,0,4,1,GBP,40,387,292,0,3.2120088355629655,52.18096119035303,27.696485012958,24.48447617739503
0.454545455,0.7142857140000001,24.61666667,11/28/2016,20,25,home,-14,GBP,211,313,42,58,13,27,Loss,81,74,4,0,0,PHI,40,292,387,1,-3.2120088355629655,52.18096119035303,24.48447617739503,27.696485012958
0.111111111,0.375,26.71666667,12/1/2016,13,21,away,2,MIN,124,231,78,49,17,15,Win,140,87,3,3,1,DAL,32,264,318,2,0.06571711056125729,34.89193540305051,17.478826256805885,17.413109146244626
0.375,0.111111111,33.28333333,12/1/2016,21,13,home,-2,DAL,231,124,57,69,15,17,Loss,87,140,3,3,2,MIN,32,318,264,1,-0.06571711056125729,34.89193540305051,17.413109146244626,17.478826256805885
0.3,0.6,28.13333333,12/4/2016,17,32,away,1,ATL,266,290,128,48,29,28,Win,123,128,1,2,1,KCC,57,389,418,1,7.673205891075519,52.69705170950343,30.185128800289473,22.511922909213954
0.6,0.3,31.86666667,12/4/2016,32,17,home,-1,KCC,290,266,30,66,28,29,Loss,128,123,2,1,1,ATL,57,418,389,1,-7.673205891075519,52.69705170950343,22.511922909213954,30.185128800289473
0.41666666700000005,0.46153846200000004,36.86666667,12/4/2016,24,20,away,15,NOS,337,319,39,67,28,13,Win,85,50,2,1,3,DET,41,422,369,0,3.9571956223000537,53.75881702339114,28.858006322845597,24.90081070054554
0.46153846200000004,0.41666666700000005,23.13333333,12/4/2016,20,24,home,-15,DET,319,337,83,57,13,28,Loss,50,85,1,2,0,NOS,41,369,422,3,-3.9571956223000537,53.75881702339114,24.90081070054554,28.858006322845597
0.083333333,0.25,22.05,12/4/2016,7,20,away,-16,NEP,126,269,30,49,10,26,Loss,36,133,4,0,0,LAR,36,162,402,2,3.3327899800025733,28.829042335421434,16.080916157712004,12.74812617770943
0.25,0.083333333,37.95,12/4/2016,20,7,home,16,LAR,269,126,46,75,26,10,Win,133,36,0,4,2,NEP,36,402,162,0,-3.3327899800025733,28.829042335421434,12.74812617770943,16.080916157712004
0.076923077,0.333333333,25.43333333,12/4/2016,10,19,away,10,JAX,102,179,32,54,20,10,Win,104,154,2,1,3,DEN,30,206,333,0,-10.856043369423773,31.08926846499555,10.116612547785888,20.97265591720966
0.333333333,0.076923077,34.56666667,12/4/2016,19,10,home,-10,DEN,179,102,65,81,10,20,Loss,154,104,1,2,0,JAX,30,333,206,3,10.856043369423773,31.08926846499555,20.97265591720966,10.116612547785888
0.4,0.333333333,31.51666667,12/4/2016,17,16,away,-8,GBP,184,200,12,64,13,21,Loss,123,109,2,1,1,HOU,34,307,309,1,-0.9072108295646699,39.922710862739436,19.507750016587384,20.414960846152052
0.333333333,0.4,28.48333333,12/4/2016,16,17,home,8,HOU,200,184,30,57,21,13,Win,109,123,1,2,1,GBP,34,309,307,1,0.9072108295646699,39.922710862739436,20.414960846152052,19.507750016587384
0.470588235,0.5,31.96666667,12/4/2016,22,21,away,-18,CIN,306,332,88,80,14,32,Loss,53,80,1,0,2,PHI,46,359,412,3,-5.487888974381148,53.2962749296732,23.904192977646026,29.392081952027176
0.5,0.470588235,28.03333333,12/4/2016,21,22,home,18,PHI,332,306,23,64,32,14,Win,80,53,0,1,3,CIN,46,412,359,2,5.487888974381148,53.2962749296732,29.392081952027176,23.904192977646026
0.307692308,0.454545455,30.76666667,12/4/2016,16,28,away,-32,BAL,215,386,57,58,6,38,Loss,62,110,2,0,2,MIA,44,277,496,3,6.057913499236051,50.22890728538611,28.14341039231108,22.085496893075028
0.454545455,0.307692308,29.23333333,12/4/2016,28,16,home,32,MIA,386,215,68,70,38,6,Win,110,62,0,2,3,BAL,44,496,277,2,-6.057913499236051,50.22890728538611,22.085496893075028,28.14341039231108
0.28571428600000004,0.428571429,28.7,12/4/2016,10,19,away,-20,CHI,6,184,106,55,6,26,Loss,141,142,6,1,1,SFO,32,147,326,0,-4.74436541252766,28.503684722324735,11.87965965489854,16.624025067426196
0.428571429,0.28571428600000004,31.3,12/4/2016,19,10,home,20,SFO,184,6,40,59,26,6,Win,142,141,1,6,0,CHI,32,326,147,1,4.74436541252766,28.503684722324735,16.624025067426196,11.879659654898537
0.6,0.384615385,30.25,12/4/2016,24,24,away,-14,OAK,170,260,73,69,24,38,Loss,212,139,4,0,0,BUF,62,382,399,2,-9.263568169060978,55.14755056527497,22.941991198106997,32.20555936716797
0.384615385,0.6,29.75,12/4/2016,24,24,home,14,BUF,260,170,65,67,38,24,Win,139,212,0,4,2,OAK,62,399,382,0,9.263568169060978,55.14755056527497,32.20555936716797,22.941991198106997
0.363636364,0.46666666700000003,25.86666667,12/4/2016,16,20,away,-10,PIT,178,272,24,55,14,24,Loss,56,117,2,2,2,NYG,38,234,389,2,-4.026604496477601,43.74238067572801,19.857888089625202,23.884492586102805
0.46666666700000003,0.363636364,34.13333333,12/4/2016,20,16,home,10,NYG,272,178,115,69,24,14,Win,117,56,2,2,2,PIT,38,389,234,2,4.026604496477601,43.74238067572801,23.884492586102805,19.857888089625202
0.454545455,0.625,26.23333333,12/4/2016,19,24,away,-8,ARI,246,281,35,57,23,31,Loss,87,88,2,2,0,WAS,54,333,369,2,-6.58291514539146,44.97768558830934,19.19738522145894,25.7803003668504
0.625,0.454545455,33.76666667,12/4/2016,24,19,home,8,WAS,281,246,51,72,31,23,Win,88,87,2,2,2,ARI,54,369,333,0,6.58291514539146,44.97768558830934,25.7803003668504,19.19738522145894
0.384615385,0.5,31.68333333,12/4/2016,20,18,away,7,LAC,268,211,35,61,28,21,Win,81,119,1,2,2,TBB,49,349,330,1,0.7485045887537681,44.78434271298913,22.76642365087145,22.01791906211768
0.5,0.384615385,28.31666667,12/4/2016,18,20,home,-7,TBB,211,268,45,53,21,28,Loss,119,81,2,1,1,LAC,49,330,349,2,-0.7485045887537681,44.78434271298913,22.01791906211768,22.76642365087145
0.41666666700000005,0.5,25.98333333,12/4/2016,14,29,away,-33,SEA,182,294,63,54,7,40,Loss,89,240,0,3,1,CAR,47,271,534,2,-1.5838124585479108,52.25208005227334,25.334133796862716,26.917946255410627
0.5,0.41666666700000005,34.01666667,12/4/2016,29,14,home,33,CAR,294,182,37,71,40,7,Win,240,89,3,0,2,SEA,47,534,271,1,1.5838124585479108,52.25208005227334,26.917946255410627,25.334133796862716
0.538461538,0.272727273,38.4,12/5/2016,27,13,away,31,NYJ,282,214,28,70,41,10,Win,139,36,1,1,3,IND,51,421,250,1,1.4131927051353586,48.3788085244943,24.89600061481483,23.482807909679472
0.272727273,0.538461538,21.6,12/5/2016,13,27,home,-31,IND,214,282,90,52,10,41,Loss,36,139,1,1,1,NYJ,51,250,421,3,-1.4131927051353586,48.3788085244943,23.482807909679472,24.89600061481483
0.27777777800000003,0.454545455,31.75,12/8/2016,18,14,away,-8,KCC,109,258,82,73,13,21,Loss,135,65,1,1,3,OAK,34,244,323,0,-11.067629920402917,38.828986448961594,13.88067826427934,24.948308184682254
0.454545455,0.27777777800000003,28.25,12/8/2016,14,18,home,8,OAK,258,109,73,54,21,13,Win,65,135,1,1,0,KCC,34,323,244,3,11.067629920402917,38.828986448961594,24.948308184682254,13.88067826427934
0.428571429,0.333333333,38.68333333,12/11/2016,24,14,away,7,BUF,220,208,45,73,27,20,Win,240,67,0,5,1,PIT,47,460,275,3,3.271613880704918,46.96714884341871,25.119381362061816,21.847767481356897
0.333333333,0.428571429,21.31666667,12/11/2016,14,24,home,-7,PIT,208,220,46,48,20,27,Loss,67,240,5,0,3,BUF,47,275,460,1,-3.271613880704918,46.96714884341871,21.847767481356897,25.119381362061816
0.272727273,0.375,27.55,12/11/2016,19,16,away,-3,TEN,330,73,87,64,10,13,Loss,18,180,3,2,0,DEN,23,348,253,2,-7.3234836411102675,38.617561271976456,15.647038815433095,22.97052245654336
0.375,0.272727273,32.45,12/11/2016,16,19,home,3,DEN,73,330,55,65,13,10,Win,180,18,2,3,2,TEN,23,253,348,0,7.3234836411102675,38.617561271976456,22.970522456543364,15.647038815433094
0.28571428600000004,0.5,23.36666667,12/11/2016,16,24,away,5,PHI,227,288,86,46,27,22,Win,107,95,2,4,2,WAS,49,334,383,1,-0.9419546810686095,47.93084066663708,23.494442992784236,24.436397673852845
0.5,0.28571428600000004,36.63333333,12/11/2016,24,16,home,-5,WAS,288,227,54,76,22,27,Loss,95,107,4,2,1,PHI,49,383,334,2,0.9419546810686095,47.93084066663708,24.436397673852845,23.494442992784236
0.307692308,0.307692308,29.93333333,12/11/2016,21,15,away,-3,MIA,125,231,54,63,23,26,Loss,175,83,3,1,3,ARI,49,300,314,4,1.5967978771464688,41.51548331544301,21.55614059629474,19.959342719148268
0.307692308,0.307692308,30.06666667,12/11/2016,15,21,home,3,ARI,231,125,118,57,26,23,Win,83,175,1,3,4,MIA,49,314,300,3,-1.5967978771464688,41.51548331544301,19.959342719148268,21.55614059629474
0.384615385,0.333333333,27.38333333,12/11/2016,17,17,away,-12,CAR,220,146,32,64,16,28,Loss,58,126,5,2,1,LAC,44,278,272,5,-8.089212277353926,39.2154843807206,15.563136051683337,23.652348329037267
0.333333333,0.384615385,32.61666667,12/11/2016,17,17,home,12,LAC,146,220,35,67,28,16,Win,126,58,2,5,5,CAR,44,272,278,1,8.089212277353926,39.2154843807206,23.652348329037267,15.563136051683339
0.533333333,0.428571429,34.88333333,12/11/2016,21,13,away,13,CLE,147,85,43,70,23,10,Win,213,169,4,3,1,CIN,33,360,254,0,-1.9068896451057702,34.423136353688385,16.258123354291307,18.165012999397078
0.428571429,0.533333333,25.11666667,12/11/2016,13,21,home,-13,CIN,85,147,34,53,10,23,Loss,169,213,3,4,0,CLE,33,254,360,1,1.9068896451057702,34.423136353688385,18.165012999397078,16.258123354291307
0.4,0.5,25.71666667,12/11/2016,16,25,away,-3,DET,204,209,139,50,17,20,Loss,92,114,1,3,2,CHI,37,296,323,0,-2.3274715030794804,45.64431509632127,21.658421796620896,23.985893299700376
0.5,0.4,34.28333333,12/11/2016,25,16,home,3,CHI,209,204,55,66,20,17,Win,114,92,3,1,0,DET,37,323,296,2,2.3274715030794804,45.64431509632127,23.985893299700376,21.658421796620896
0.35714285700000004,0.41666666700000005,36.08333333,12/11/2016,20,21,away,5,IND,131,265,124,67,22,17,Win,185,83,2,1,3,HOU,39,316,348,1,-7.771633975126724,47.03690808301903,19.63263705394615,27.404271029072877
0.41666666700000005,0.35714285700000004,23.91666667,12/11/2016,21,20,home,-5,HOU,265,131,59,61,17,22,Loss,83,185,1,2,1,IND,39,348,316,3,7.771633975126724,47.03690808301903,27.404271029072877,19.63263705394615
0.272727273,0.4375,31.11666667,12/11/2016,22,18,away,9,JAX,292,230,93,63,25,16,Win,85,85,0,4,0,MIN,41,377,315,1,-9.848265267282066,44.53901921290699,17.345376972812463,27.19364224009453
0.4375,0.272727273,28.88333333,12/11/2016,18,22,home,-9,MIN,230,292,114,65,16,25,Loss,85,85,4,0,1,JAX,41,315,377,0,9.848265267282066,44.53901921290699,27.19364224009453,17.345376972812463
0.444444444,0.166666667,41.91666667,12/11/2016,24,17,away,6,SFO,216,116,56,81,6,0,Win,188,248,6,2,0,NYJ,6,404,364,1,-5.001106939623873,37.15095221028058,16.074922635328353,21.076029574952226
0.166666667,0.444444444,24.5,12/11/2016,17,24,home,-6,NYJ,116,216,25,55,0,6,Loss,248,188,2,6,1,SFO,6,364,404,0,5.001106939623873,37.15095221028058,21.076029574952226,16.074922635328353
0.307692308,0.46153846200000004,26.75,12/11/2016,14,21,away,-5,TBB,248,166,104,58,11,16,Loss,46,104,1,2,0,NOS,27,294,270,3,-5.864662032217591,38.47165388408129,16.30349592593185,22.168157958149443
0.46153846200000004,0.307692308,33.25,12/11/2016,21,14,home,5,NOS,166,248,65,63,16,11,Win,104,46,2,1,3,TBB,27,270,294,0,5.864662032217591,38.47165388408129,22.168157958149443,16.30349592593185
0.307692308,0.428571429,27.13333333,12/11/2016,18,21,away,28,LAR,220,208,40,57,42,14,Win,66,104,2,3,5,ATL,56,286,312,0,-2.87621035338082,41.990292918697065,19.557041282658123,22.433251636038943
0.428571429,0.307692308,32.86666667,12/11/2016,21,18,home,-28,ATL,208,220,105,67,14,42,Loss,104,66,3,2,0,LAR,56,312,286,5,2.87621035338082,41.990292918697065,22.433251636038943,19.557041282658123
0.5,0.363636364,31.83333333,12/11/2016,22,18,away,-28,GBP,218,237,63,68,10,38,Loss,136,93,3,1,0,SEA,48,354,330,6,4.702528313874861,49.3516403882767,27.02708435107578,22.32455603720092
0.363636364,0.5,28.16666667,12/11/2016,18,22,home,28,SEA,237,218,50,56,38,10,Win,93,136,1,3,6,GBP,48,330,354,0,-4.702528313874861,49.3516403882767,22.32455603720092,27.02708435107578
0.066666667,0.14285714300000002,29.13333333,12/11/2016,13,12,away,-3,NYG,152,167,54,65,7,10,Loss,108,93,3,3,3,DAL,17,260,260,3,-7.437840592898231,28.81913145348605,10.690645430293909,18.128486023192142
0.14285714300000002,0.066666667,30.86666667,12/11/2016,12,13,home,3,DAL,167,152,50,64,10,7,Win,93,108,3,3,3,NYG,17,260,260,3,7.437840592898231,28.81913145348605,18.128486023192142,10.690645430293909
0.375,0.5,30.76666667,12/12/2016,17,20,away,-7,NEP,306,401,47,68,23,30,Loss,42,95,2,1,3,BAL,53,348,496,1,7.985614779867822,49.196665387281996,28.59114008357491,20.605525303707086
0.5,0.375,29.23333333,12/12/2016,20,17,home,7,BAL,401,306,48,65,30,23,Win,95,42,1,2,1,NEP,53,496,348,3,-7.985614779867822,49.196665387281996,20.605525303707086,28.59114008357491
0.25,0.46666666700000003,27.48333333,12/15/2016,13,19,away,-21,SEA,136,227,76,56,3,24,Loss,47,72,4,2,1,LAR,27,183,299,0,-1.1556838440848107,32.2442326586624,15.544274407288793,16.699958251373605
0.46666666700000003,0.25,32.51666667,12/15/2016,19,13,home,21,LAR,227,136,86,58,24,3,Win,72,47,2,4,0,SEA,27,299,183,1,1.1556838440848107,32.2442326586624,16.699958251373605,15.544274407288793
0.41666666700000005,0.333333333,27.46666667,12/17/2016,13,20,away,21,NYJ,236,244,70,46,34,13,Win,67,116,1,3,4,MIA,47,303,360,1,2.1328227684256387,44.25210091439648,23.19246184141106,21.05963907298542
0.333333333,0.41666666700000005,32.53333333,12/17/2016,20,13,home,-21,MIA,244,236,42,72,13,34,Loss,116,67,3,1,1,NYJ,47,360,303,4,-2.1328227684256387,44.25210091439648,21.05963907298542,23.19246184141106
0.3,0.375,32.78333333,12/18/2016,20,29,away,3,CHI,225,354,64,58,30,27,Win,226,95,4,1,4,GBP,57,451,449,0,8.781139906711985,59.154693091404056,33.96791649905802,25.186776592346035
0.375,0.3,27.21666667,12/18/2016,29,20,home,-3,GBP,354,225,40,63,27,30,Loss,95,226,1,4,0,CHI,57,449,451,4,-8.781139906711985,59.154693091404056,25.186776592346035,33.96791649905802
0.23076923100000002,0.28571428600000004,23.3,12/18/2016,9,23,away,-1,HOU,83,308,91,50,20,21,Loss,67,79,2,0,2,JAX,41,150,387,1,-13.654972924345756,35.63711706708541,10.991072071369828,24.646044995715584
0.28571428600000004,0.23076923100000002,36.7,12/18/2016,23,9,home,1,JAX,308,83,71,78,21,20,Win,79,67,0,2,1,HOU,41,387,150,2,13.654972924345756,35.63711706708541,24.646044995715584,10.991072071369828
0.272727273,0.444444444,25.68333333,12/18/2016,16,29,away,-20,BUF,162,171,51,54,13,33,Loss,107,280,5,1,0,CLE,46,269,451,0,4.052793794692139,42.45214066649972,23.252467230595933,19.19967343590379
0.444444444,0.272727273,34.31666667,12/18/2016,29,16,home,20,CLE,171,162,42,66,33,13,Win,280,107,1,5,0,BUF,46,451,269,0,-4.052793794692139,42.45214066649972,19.19967343590379,23.252467230595933
0.444444444,0.363636364,36.63333333,12/18/2016,27,18,away,-1,BAL,159,189,30,81,26,27,Loss,169,151,1,3,2,PHI,53,328,340,1,0.6856851764435561,43.86770892976285,22.276697053103202,21.591011876659646
0.363636364,0.444444444,23.36666667,12/18/2016,18,27,home,1,PHI,189,159,62,57,27,26,Win,151,169,3,1,1,BAL,53,340,328,2,-0.6856851764435561,43.86770892976285,21.591011876659646,22.276697053103202
0.428571429,0.28571428600000004,30.58333333,12/18/2016,21,13,away,2,KCC,241,159,25,63,19,17,Win,148,157,1,1,1,TEN,36,389,316,3,-1.2633801315794893,42.665749668492204,20.701184768456358,21.964564900035846
0.28571428600000004,0.428571429,29.41666667,12/18/2016,13,21,home,-2,TEN,159,241,40,57,17,19,Loss,157,148,1,1,3,KCC,36,316,389,1,1.2633801315794893,42.665749668492204,21.964564900035846,20.701184768456358
0.35714285700000004,0.46666666700000003,29.73333333,12/18/2016,16,17,away,-11,NYG,268,186,15,59,6,17,Loss,56,114,1,2,0,DET,23,324,300,2,-1.829888149814007,41.67810707991859,19.92410946505229,21.7539976148663
0.46666666700000003,0.35714285700000004,30.26666667,12/18/2016,17,16,home,11,DET,186,268,46,62,17,6,Win,114,56,2,1,2,NYG,23,300,324,0,1.829888149814007,41.67810707991859,21.7539976148663,19.92410946505229
0.538461538,0.333333333,37.03333333,12/18/2016,27,20,away,28,MIN,250,248,55,68,34,6,Win,161,34,0,5,3,IND,40,411,282,0,5.3212559269645645,49.82454754360324,27.5729017352839,22.25164580831934
0.333333333,0.538461538,22.96666667,12/18/2016,20,27,home,-28,IND,248,250,27,56,6,34,Loss,34,161,5,0,0,MIN,40,282,411,3,-5.3212559269645645,49.82454754360324,22.25164580831934,27.5729017352839
0.384615385,0.5,32.53333333,12/18/2016,26,19,away,4,CIN,285,146,104,66,24,20,Win,97,76,1,1,1,PIT,44,382,222,0,0.5514969566872177,43.08994504790316,21.820721002295187,21.26922404560797
0.5,0.384615385,27.46666667,12/18/2016,19,26,home,-4,PIT,146,285,86,56,20,24,Loss,76,97,1,1,0,CIN,44,222,382,1,-0.5514969566872177,43.08994504790316,21.26922404560797,21.820721002295187
0.642857143,0.5,37.21666667,12/18/2016,33,26,away,7,ARI,358,309,46,83,48,41,Win,130,116,3,1,2,NOS,89,488,425,1,1.9490129979655384,61.230562985336405,31.589787991650972,29.640774993685433
0.5,0.642857143,22.78333333,12/18/2016,26,33,home,-7,NOS,309,358,52,56,41,48,Loss,116,130,1,3,1,ARI,89,425,488,2,-1.9490129979655384,61.230562985336405,29.640774993685433,31.589787991650972
0.46153846200000004,0.5555555560000001,23.98333333,12/18/2016,15,29,away,-28,ATL,165,302,20,55,13,41,Loss,107,248,2,1,1,SFO,54,272,550,1,4.51964902907666,49.304350196892734,26.911999612984697,22.392350583908037
0.5555555560000001,0.46153846200000004,36.01666667,12/18/2016,29,15,home,28,SFO,302,165,27,66,41,13,Win,248,107,1,2,1,ATL,54,550,272,1,-4.51964902907666,49.304350196892734,22.392350583908037,26.911999612984697
0.294117647,0.166666667,33.6,12/18/2016,20,15,away,13,DEN,177,251,30,73,16,3,Win,136,58,2,4,3,NEP,19,313,309,0,6.0599092415153635,35.77651722013455,20.918213230824957,14.858303989309594
0.166666667,0.294117647,26.4,12/18/2016,15,20,home,-13,NEP,251,177,49,61,3,16,Loss,58,136,4,2,0,DEN,19,309,313,3,-6.0599092415153635,35.77651722013455,14.858303989309594,20.918213230824957
0.307692308,0.533333333,32.28333333,12/18/2016,18,14,away,3,LAC,200,190,15,61,19,16,Win,145,73,2,3,2,OAK,35,345,263,2,-0.21253983846225644,43.43714713715381,21.612303649345776,21.82484348780803
0.533333333,0.307692308,27.71666667,12/18/2016,14,18,home,-3,OAK,190,200,44,55,16,19,Loss,73,145,3,2,2,LAC,35,263,345,2,0.21253983846225644,43.43714713715381,21.82484348780803,21.612303649345776
0.333333333,0.384615385,23.93333333,12/18/2016,16,24,away,-6,DAL,224,264,35,59,20,26,Loss,52,185,4,3,1,TBB,46,276,449,4,-6.996989047722174,44.72555575443262,18.864283353355223,25.861272401077397
0.384615385,0.333333333,36.06666667,12/18/2016,24,16,home,6,TBB,264,224,91,71,26,20,Win,185,52,3,4,4,DAL,46,449,276,1,6.996989047722174,44.72555575443262,25.861272401077397,18.864283353355223
0.26666666699999997,0.166666667,34.65,12/19/2016,22,18,away,11,WAS,290,306,62,72,26,15,Win,148,29,2,1,3,CAR,41,438,335,0,-11.2443867745142,45.91484507946315,17.335229152474476,28.579615926988673
0.166666667,0.26666666699999997,25.35,12/19/2016,18,22,home,-11,CAR,306,290,70,61,15,26,Loss,29,148,1,2,0,WAS,41,335,438,3,11.2443867745142,45.91484507946315,28.579615926988673,17.335229152474476
0.454545455,0.333333333,34.06666667,12/22/2016,24,15,away,-5,PHI,356,168,50,88,19,24,Loss,114,118,0,0,1,NYG,43,470,286,3,-8.62832661380575,48.898331893095744,20.135002639644995,28.76332925345075
0.333333333,0.454545455,25.93333333,12/22/2016,15,24,home,5,NYG,168,356,5,55,24,19,Win,118,114,0,0,3,PHI,43,286,470,1,8.62832661380575,48.898331893095744,28.76332925345075,20.135002639644995
0.41666666700000005,0.444444444,33.66666667,12/24/2016,22,30,away,3,BUF,233,317,15,68,3,0,Win,261,272,0,2,0,MIA,3,494,589,1,-11.980753644755833,49.41998830747604,18.719617331360105,30.700370976115934
0.444444444,0.41666666700000005,40.55,12/24/2016,30,22,home,-3,MIA,317,233,35,90,0,3,Loss,272,261,2,0,1,BUF,3,589,494,0,11.980753644755833,49.41998830747604,30.700370976115934,18.719617331360105
0.090909091,0.611111111,25.28333333,12/24/2016,14,21,away,-38,NEP,128,211,77,55,3,41,Loss,111,114,2,1,0,NYJ,44,239,325,4,5.17580660579668,37.674416610849796,21.42511160832324,16.249305002526558
0.611111111,0.090909091,34.71666667,12/24/2016,21,14,home,38,NYJ,211,128,20,70,41,3,Win,114,111,1,2,4,NEP,44,325,239,0,-5.17580660579668,37.674416610849796,16.249305002526558,21.42511160832324
0.35714285700000004,0.333333333,27.48333333,12/24/2016,19,25,away,-21,JAX,205,331,49,67,17,38,Loss,58,84,3,2,1,TEN,55,263,415,1,-9.257527849034734,44.655132180972615,17.698802165968942,26.956330015003672
0.333333333,0.35714285700000004,32.51666667,12/24/2016,25,19,home,21,TEN,331,205,45,69,38,17,Win,84,58,2,3,1,JAX,55,415,263,1,9.257527849034734,44.655132180972615,26.956330015003672,17.698802165968942
0.333333333,0.46153846200000004,31.01666667,12/24/2016,22,19,away,-13,GBP,353,308,70,74,25,38,Loss,93,40,4,4,0,MIN,63,446,348,2,0.12184805450068659,49.89195515777896,25.006901606139824,24.885053551639135
0.46153846200000004,0.333333333,28.98333333,12/24/2016,19,22,home,13,MIN,308,353,21,58,38,25,Win,40,93,4,4,2,GBP,63,348,446,0,-0.12184805450068659,49.89195515777896,24.885053551639135,25.006901606139824
0.333333333,0.4,27.51666667,12/24/2016,19,23,away,-3,CLE,322,127,92,65,17,20,Loss,34,124,0,9,0,LAC,37,356,251,1,-5.204585536558116,36.133218945193505,15.464316704317696,20.66890224087581
0.4,0.333333333,32.48333333,12/24/2016,23,19,home,3,LAC,127,322,44,66,20,17,Win,124,34,9,0,1,CLE,37,251,356,0,5.204585536558116,36.133218945193505,20.66890224087581,15.464316704317694
0.615384615,0.7,32.58333333,12/24/2016,21,31,away,20,CHI,270,318,73,64,41,21,Win,208,140,0,1,5,WAS,62,478,458,0,-8.441947724797458,64.57273998233245,28.065396128767496,36.507343853564954
0.7,0.615384615,27.41666667,12/24/2016,31,21,home,-20,WAS,318,270,52,67,21,41,Loss,140,208,1,0,0,CHI,62,458,478,5,8.441947724797458,64.57273998233245,36.507343853564954,28.065396128767496
0.428571429,0.26666666699999997,32.75,12/24/2016,21,17,away,17,CAR,256,183,45,61,33,16,Win,152,119,4,2,2,ATL,49,408,302,0,-5.33135030828498,41.69725602519884,18.18295285845693,23.51430316674191
0.26666666699999997,0.428571429,27.25,12/24/2016,17,21,home,-17,ATL,183,256,24,68,16,33,Loss,119,152,2,4,0,CAR,49,302,408,2,5.33135030828498,41.69725602519884,23.51430316674191,18.18295285845693
0.5,0.6,23.91666667,12/24/2016,20,27,away,-8,OAK,288,253,22,53,25,33,Loss,102,210,0,1,0,IND,58,390,463,3,-1.7266618540235878,61.817997332052066,30.045667739014238,31.772329593037828
0.6,0.5,36.08333333,12/24/2016,27,20,home,8,IND,253,288,97,72,33,25,Win,210,102,1,0,3,OAK,58,463,390,0,1.7266618540235878,61.817997332052066,31.772329593037828,30.045667739014238
0.583333333,0.41666666700000005,28.4,12/24/2016,23,25,away,-7,NOS,260,294,63,58,24,31,Loss,89,123,2,2,0,TBB,55,349,417,2,-0.6777073908365816,51.75956012944034,25.54092636930188,26.21863376013846
0.41666666700000005,0.583333333,31.6,12/24/2016,25,23,home,7,TBB,294,260,59,67,31,24,Win,123,89,2,2,2,NOS,55,417,349,0,0.6777073908365816,51.75956012944034,26.21863376013846,25.54092636930188
0.111111111,0.470588235,26.3,12/24/2016,21,24,away,3,SEA,276,313,85,57,34,31,Win,94,78,1,6,1,ARI,65,370,391,1,0.7872215750118836,42.86893477861891,21.828078176815396,21.04085660180351
0.470588235,0.111111111,33.7,12/24/2016,24,21,home,-3,ARI,313,276,40,78,31,34,Loss,78,94,6,1,1,SEA,65,391,370,1,-0.7872215750118836,42.86893477861891,21.04085660180351,21.828078176815396
0.375,0.307692308,31.05,12/24/2016,21,13,away,1,LAR,253,78,100,70,22,21,Win,70,99,4,4,2,SFO,43,323,177,2,-7.311771358351103,34.32480320946367,13.506515925556283,20.818287283907384
0.307692308,0.375,28.95,12/24/2016,13,21,home,-1,SFO,78,253,45,57,21,22,Loss,99,70,4,4,2,LAR,43,177,323,2,7.311771358351103,34.32480320946367,20.818287283907384,13.506515925556283
0.4375,0.28571428600000004,28.9,12/24/2016,15,17,away,-2,HOU,244,155,60,63,10,12,Loss,50,95,3,4,0,CIN,22,294,250,1,-0.9593195883473555,34.15177441142416,16.5962274115384,17.555546999885756
0.28571428600000004,0.4375,31.1,12/24/2016,17,15,home,2,CIN,155,244,25,57,12,10,Win,95,50,4,3,1,HOU,22,250,294,0,0.9593195883473555,34.15177441142416,17.555546999885756,16.5962274115384
0.529411765,0.428571429,34.61666667,12/25/2016,22,23,away,-4,PIT,246,279,95,72,27,31,Loss,122,127,2,0,2,BAL,58,368,406,1,3.033023353744791,50.06761959697758,26.550321475361184,23.517298121616395
0.428571429,0.529411765,25.38333333,12/25/2016,23,22,home,4,BAL,279,246,45,55,31,27,Win,127,122,0,2,1,PIT,58,406,368,2,-3.033023353744791,50.06761959697758,23.517298121616395,26.550321475361184
0.26666666699999997,0.529411765,21.98333333,12/25/2016,14,23,away,-23,KCC,183,246,70,57,10,33,Loss,63,238,0,0,1,DEN,43,246,484,3,-5.577718786860991,45.71192587177344,20.067103542456223,25.644822329317215
0.529411765,0.26666666699999997,38.01666667,12/25/2016,23,14,home,23,DEN,246,183,65,74,33,10,Win,238,63,0,0,3,KCC,43,484,246,1,5.577718786860991,45.71192587177344,25.644822329317215,20.067103542456223
0.41666666700000005,0.5,30.71666667,12/26/2016,23,23,away,-21,DAL,229,211,62,70,21,42,Loss,90,164,4,1,0,DET,63,319,375,2,1.4265949239826448,47.25987912152051,24.34323702275158,22.916642098768932
0.5,0.41666666700000005,29.28333333,12/26/2016,23,23,home,21,DET,211,229,47,52,42,21,Win,164,90,1,4,2,DAL,63,375,319,0,-1.4265949239826448,47.25987912152051,22.916642098768932,24.34323702275158
0.5,0.125,29.3,1/1/2017,22,25,away,-17,CIN,263,218,41,70,10,27,Loss,72,153,3,1,0,BAL,37,335,371,2,5.858877110041201,41.86899214424776,23.86393462714448,18.005057517103282
0.125,0.5,30.7,1/1/2017,25,22,home,17,BAL,218,263,20,67,27,10,Win,153,72,1,3,2,CIN,37,371,335,0,-5.858877110041201,41.86899214424776,18.005057517103282,23.86393462714448
0.2,0.6,29.13333333,1/1/2017,20,16,away,-7,TEN,243,133,35,74,17,24,Loss,46,103,4,4,1,HOU,41,289,236,1,-12.576163828001574,35.528320729993794,11.47607845099611,24.052242278997685
0.6,0.2,30.86666667,1/1/2017,16,20,home,7,HOU,133,243,50,59,24,17,Win,103,46,4,4,1,TEN,41,236,289,1,12.576163828001574,35.528320729993794,24.052242278997685,11.47607845099611
0.26666666699999997,0.333333333,32.4,1/1/2017,18,18,away,-1,TBB,207,188,45,67,16,17,Loss,128,112,3,3,2,CAR,33,335,300,3,-9.28300524114712,41.44257938765367,16.07978707325328,25.362792314400394
0.333333333,0.26666666699999997,27.6,1/1/2017,18,18,home,1,CAR,188,207,30,63,17,16,Win,112,128,3,3,3,TBB,33,300,335,2,9.28300524114712,41.44257938765367,25.362792314400394,16.07978707325328
0.28571428600000004,0.2,29.6,1/1/2017,23,24,away,-4,IND,288,290,54,71,20,24,Loss,182,94,2,4,2,JAX,44,470,384,2,-1.6535240785686867,52.35930881650466,25.352892368967986,27.006416447536672
0.2,0.28571428600000004,30.4,1/1/2017,24,23,home,4,JAX,290,288,35,67,24,20,Win,94,182,4,2,2,IND,44,384,470,2,1.6535240785686867,52.35930881650466,27.006416447536672,25.352892368967986
0.583333333,0.583333333,31.36666667,1/1/2017,22,16,away,21,MIA,276,205,64,63,35,14,Win,120,75,0,0,2,NEP,49,396,280,0,4.605192226683188,45.73032615488266,25.167759190782924,20.562566964099737
0.583333333,0.583333333,28.63333333,1/1/2017,16,22,home,-21,NEP,205,276,73,57,14,35,Loss,75,120,0,0,0,MIA,49,280,396,2,-4.605192226683188,45.73032615488266,20.562566964099737,25.167759190782924
0.222222222,0.5,29.8,1/1/2017,19,21,away,-28,MIN,140,250,49,59,10,38,Loss,183,124,2,0,1,CHI,48,323,374,5,2.6716686433007695,47.531944341332064,25.101806492316417,22.430137849015647
0.5,0.222222222,30.2,1/1/2017,21,19,home,28,CHI,250,140,15,62,38,10,Win,124,183,0,2,5,MIN,48,374,323,1,-2.6716686433007695,47.531944341332064,22.430137849015647,25.101806492316417
0.375,0.307692308,28.55,1/1/2017,14,18,away,-20,NYJ,162,202,0,62,10,30,Loss,68,127,3,1,0,BUF,40,230,329,3,0.9219784739904178,36.59102794627719,18.7565032101338,17.834524736143386
0.307692308,0.375,31.45,1/1/2017,18,14,home,20,BUF,202,162,15,61,30,10,Win,127,68,1,3,3,NYJ,40,329,230,0,-0.9219784739904178,36.59102794627719,17.834524736143386,18.7565032101338
0.41666666700000005,0.428571429,24.3,1/1/2017,15,24,away,-14,PHI,126,232,35,53,13,27,Loss,69,114,3,2,0,DAL,40,195,346,2,-2.7807730860135216,37.72976608414388,17.474496499065182,20.2552695850787
0.428571429,0.41666666700000005,35.7,1/1/2017,24,15,home,14,DAL,232,126,61,75,27,13,Win,114,69,2,3,2,PHI,40,346,195,0,2.7807730860135216,37.72976608414388,20.2552695850787,17.474496499065182
0.533333333,0.214285714,38.9,1/1/2017,27,21,away,-3,PIT,206,243,37,77,3,6,Loss,231,69,4,4,1,CLE,9,437,312,4,-4.8160120996243085,38.678923663208685,16.931455781792188,21.747467881416497
0.214285714,0.533333333,33.15,1/1/2017,21,27,home,3,CLE,243,206,43,69,6,3,Win,69,231,4,4,4,PIT,9,312,437,1,4.8160120996243085,38.678923663208685,21.747467881416497,16.931455781792188
0.4375,0.545454545,30.25,1/1/2017,26,25,away,-6,ATL,341,323,70,75,32,38,Loss,132,142,2,1,0,NOS,70,473,465,1,-0.9532651545086921,56.146077565258075,27.59640620537469,28.549671359883384
0.545454545,0.4375,29.75,1/1/2017,25,26,home,6,NOS,323,341,63,59,38,32,Win,142,132,1,2,1,ATL,70,465,473,0,0.9532651545086921,56.146077565258075,28.549671359883384,27.59640620537469
0.352941176,0.333333333,35.86666667,1/1/2017,17,16,away,9,WAS,171,246,42,68,19,10,Win,161,38,1,4,3,NYG,29,332,284,0,-6.036730693722522,38.790509108035394,16.376889207156438,22.413619900878956
0.333333333,0.352941176,24.13333333,1/1/2017,16,17,home,-9,NYG,246,171,42,54,10,19,Loss,38,161,4,1,0,WAS,29,284,332,3,6.036730693722522,38.790509108035394,22.413619900878956,16.376889207156438
0.28571428600000004,0.14285714300000002,27.96666667,1/1/2017,21,9,away,38,LAR,260,71,51,67,44,6,Win,84,52,1,7,3,ARI,50,344,123,2,-2.9520331499402914,29.687400442723774,13.367683646391743,16.31971679633203
0.14285714300000002,0.28571428600000004,32.03333333,1/1/2017,9,21,home,-38,ARI,71,260,61,57,6,44,Loss,52,84,7,1,2,LAR,50,123,344,3,2.9520331499402914,29.687400442723774,16.31971679633203,13.367683646391741
0.181818182,0.333333333,24.58333333,1/1/2017,11,18,away,-18,DEN,164,206,125,50,6,24,Loss,57,143,2,0,1,OAK,30,221,349,3,-2.470882780445443,41.28932915603092,19.409223187792737,21.88010596823818
0.333333333,0.181818182,35.41666667,1/1/2017,18,11,home,18,OAK,206,164,43,67,24,6,Win,143,57,0,2,3,DEN,30,349,221,1,2.470882780445443,41.28932915603092,21.88010596823818,19.409223187792737
0.666666667,0.3,30.8,1/1/2017,26,26,away,10,LAC,262,269,19,60,37,27,Win,103,129,1,0,2,KCC,64,365,398,1,5.046609474490319,52.624432724406525,28.83552109944842,23.788911624958104
0.3,0.666666667,29.2,1/1/2017,26,26,home,-10,KCC,269,262,50,64,27,37,Loss,129,103,0,1,1,LAC,64,398,365,2,-5.046609474490319,52.624432724406525,23.788911624958104,28.83552109944842
0.25,0.181818182,29.56666667,1/1/2017,18,14,away,2,SFO,289,191,34,65,25,23,Win,87,62,2,5,2,SEA,48,376,253,0,4.7364436843473126,32.57008220915749,18.653262946752402,13.916819262405088
0.181818182,0.25,30.43333333,1/1/2017,14,18,home,-2,SEA,191,289,25,58,23,25,Loss,62,87,5,2,0,SFO,48,253,376,2,-4.7364436843473126,32.57008220915749,13.916819262405088,18.653262946752402
0.538461538,0.41666666700000005,34.15,1/1/2017,28,24,away,7,DET,295,332,75,71,31,24,Win,153,76,1,2,1,GBP,55,448,408,0,-0.24369844193713242,57.631771627750936,28.6940365929069,28.937735034844035
0.41666666700000005,0.538461538,25.85,1/1/2017,24,28,home,-7,GBP,332,295,30,64,24,31,Loss,76,153,2,1,0,DET,55,408,448,1,0.24369844193713242,57.631771627750936,28.937735034844035,28.6940365929069
0.125,0.26666666699999997,26.51666667,1/7/2017,16,19,away,-13,HOU,139,168,63,69,14,27,Loss,64,123,3,0,0,OAK,41,203,291,3,-15.758630742557266,34.03515974847477,9.138264502958751,24.896895245516017
0.26666666699999997,0.125,33.48333333,1/7/2017,19,16,home,13,OAK,168,139,65,69,27,14,Win,123,64,0,3,3,HOU,41,291,203,0,15.758630742557266,34.03515974847477,24.896895245516017,9.138264502958751
0.181818182,0.5625,23.35,1/7/2017,13,24,away,-20,SEA,182,210,68,50,6,26,Loss,49,177,3,3,0,DET,32,231,387,0,1.5254982923893365,37.032209356290046,19.27885382433969,17.753355531950355
0.5625,0.181818182,36.65,1/7/2017,24,13,home,20,DET,210,182,40,71,26,6,Win,177,49,3,3,0,SEA,32,387,231,0,-1.5254982923893365,37.032209356290046,17.753355531950355,19.27885382433969
0.428571429,0.444444444,32.03333333,1/8/2017,18,19,away,-18,PIT,253,188,64,62,12,30,Loss,52,179,5,1,2,MIA,42,305,367,3,5.003884725391659,45.71062131364829,25.357253019519973,20.353368294128316
0.444444444,0.428571429,27.96666667,1/8/2017,19,18,home,18,MIA,188,253,60,54,30,12,Win,179,52,1,5,3,PIT,42,367,305,2,-5.003884725391659,45.71062131364829,20.353368294128316,25.357253019519973
0.3125,0.35714285700000004,25.48333333,1/8/2017,15,23,away,-25,GBP,295,331,42,63,13,38,Loss,70,75,2,5,0,NYG,51,365,406,2,-1.502269049441491,47.49787357724017,22.997802263899338,24.500071313340833
0.35714285700000004,0.3125,34.51666667,1/8/2017,23,15,home,25,NYG,331,295,21,70,38,13,Win,75,70,5,2,2,GBP,51,406,365,0,1.502269049441491,47.49787357724017,24.500071313340833,22.997802263899338
0.454545455,0.5,26.68333333,1/14/2017,17,28,away,-16,ATL,208,323,40,54,20,36,Loss,101,99,3,3,0,SEA,56,309,422,2,7.61162609602318,45.69945316101198,26.65553962851758,19.0439135324944
0.5,0.454545455,33.31666667,1/14/2017,28,17,home,16,SEA,323,208,10,69,36,20,Win,99,101,3,3,2,ATL,56,422,309,0,-7.61162609602318,45.69945316101198,19.0439135324944,26.65553962851758
0.1875,0.35714285700000004,32.5,1/14/2017,14,20,away,-18,NEP,180,279,75,66,16,34,Loss,105,98,3,2,3,HOU,50,285,377,3,-0.37236120451806975,41.269109387488626,20.448374091485277,20.82073529600335
0.35714285700000004,0.1875,27.5,1/14/2017,20,14,home,18,HOU,279,180,50,67,34,16,Win,98,105,2,3,3,NEP,50,377,285,3,0.37236120451806975,41.269109387488626,20.82073529600335,20.448374091485277
0.545454545,0.545454545,29.76666667,1/15/2017,27,25,away,3,DAL,326,291,22,63,34,31,Win,87,138,3,2,1,GBP,65,413,429,1,4.664067118414126,57.57107227147378,31.117569694943953,26.45350257652983
0.545454545,0.545454545,30.23333333,1/15/2017,25,27,home,-3,GBP,291,326,50,64,31,34,Loss,138,87,2,3,1,DAL,65,429,413,1,-4.664067118414126,57.57107227147378,26.45350257652983,31.117569694943953
0.46666666700000003,0.222222222,34.21666667,1/15/2017,20,16,away,2,KCC,218,166,53,66,18,16,Win,171,61,1,1,2,PIT,34,389,227,1,3.636313291242141,39.02817750607216,21.33224539865715,17.69593210741501
0.222222222,0.46666666700000003,25.78333333,1/15/2017,16,20,home,-2,PIT,166,218,60,49,16,18,Loss,61,171,1,1,1,KCC,34,227,389,2,-3.636313291242141,39.02817750607216,17.69593210741501,21.33224539865715
0.4,0.7692307690000001,26.35,1/22/2017,24,30,away,-23,ATL,268,392,63,64,21,44,Loss,99,101,2,0,0,GBP,65,367,493,2,2.0658453765947975,59.49556803609684,30.780706706345818,28.714861329751024
0.7692307690000001,0.4,33.65,1/22/2017,30,24,home,23,GBP,392,268,31,68,44,21,Win,101,99,0,2,2,ATL,65,493,367,0,-2.0658453765947975,59.49556803609684,28.714861329751024,30.780706706345818
0.6,0.647058824,28.56666667,1/22/2017,22,26,away,-19,NEP,314,374,19,67,17,36,Loss,54,57,0,2,0,PIT,53,368,431,2,4.890567117026917,52.52367191419333,28.707119515610124,23.816552398583205
0.647058824,0.6,31.43333333,1/22/2017,26,22,home,19,PIT,374,314,10,71,36,17,Win,57,54,2,0,2,NEP,53,431,368,0,-4.890567117026917,52.52367191419333,23.816552398583205,28.707119515610124
0.5,0.125,40.51666667,2/5/2017,37,17,away,6,ATL,442,240,23,93,6,0,Win,104,104,5,5,1,NEP,6,546,344,2,12.01169268242938,50.11947713471984,31.065584908574607,19.05389222614523
0.125,0.5,23.45,2/5/2017,17,37,home,-6,NEP,240,442,65,46,0,6,Loss,104,104,5,5,2,ATL,6,344,546,1,-12.01169268242938,50.11947713471984,19.05389222614523,31.065584908574607
0.363636364,0.333333333,30.23333333,9/7/2017,26,25,away,15,NEP,352,247,139,65,42,27,Win,185,124,3,3,0,KCC,69,537,371,1,1.7574467885235054,51.45555979303852,26.60650329078101,24.849056502257508
0.333333333,0.363636364,29.76666667,9/7/2017,25,26,home,-15,KCC,247,352,55,74,27,42,Loss,124,185,3,3,1,NEP,69,371,537,0,-1.7574467885235054,51.45555979303852,24.849056502257508,26.60650329078101
0.4,0.5,26.66666667,9/10/2017,24,19,away,-12,DET,263,285,55,67,23,35,Loss,45,82,1,1,1,ARI,58,308,367,4,-7.05694180064949,47.813067468207464,20.378062833778987,27.435004634428477
0.5,0.4,33.33333333,9/10/2017,19,24,home,12,ARI,285,263,100,69,35,23,Win,82,45,1,1,4,DET,58,367,308,1,7.05694180064949,47.813067468207464,27.435004634428477,20.378062833778987
0.454545455,0.384615385,30.56666667,9/10/2017,18,20,away,6,CHI,308,176,73,55,23,17,Win,64,125,2,4,0,ATL,40,372,301,0,-0.5553343964940183,39.813283703064,19.628974653284992,20.18430904977901
0.384615385,0.454545455,29.43333333,9/10/2017,20,18,home,-6,ATL,176,308,40,63,17,23,Loss,125,64,4,2,0,CHI,40,301,372,0,0.5553343964940183,39.813283703064,20.18430904977901,19.628974653284992
0.428571429,0.307692308,34.0,9/10/2017,17,14,away,20,CIN,111,144,85,60,20,0,Win,157,77,1,5,5,BAL,20,268,221,1,5.499855289733823,35.061226940777175,20.2805411152555,14.780685825521676
0.307692308,0.428571429,26.0,9/10/2017,14,17,home,-20,BAL,144,111,66,58,0,20,Loss,77,157,5,1,1,CIN,20,221,268,5,-5.499855289733823,35.061226940777175,14.780685825521676,20.2805411152555
0.28571428600000004,0.470588235,26.93333333,9/10/2017,11,23,away,-9,BUF,176,218,62,55,12,21,Loss,38,190,1,2,1,NYJ,33,214,408,2,-5.669415028259989,41.01590893659774,17.673246954168874,23.342661982428865
0.470588235,0.28571428600000004,33.06666667,9/10/2017,23,11,home,9,NYJ,218,176,50,72,21,12,Win,190,38,2,1,2,BUF,33,408,214,1,5.669415028259989,41.01590893659774,23.342661982428865,17.673246954168874
0.384615385,0.25,28.83333333,9/10/2017,16,20,away,3,CLE,255,180,143,54,21,18,Win,35,57,1,7,1,PIT,39,290,237,1,0.5142928989465823,34.32224888040771,17.418270889677146,16.903977990730567
0.25,0.384615385,31.16666667,9/10/2017,20,16,home,-3,PIT,180,255,61,62,18,21,Loss,57,35,7,1,1,CLE,39,237,290,1,-0.5142928989465823,34.32224888040771,16.903977990730567,17.418270889677146
0.25,0.41666666700000005,30.08333333,9/10/2017,19,23,away,22,HOU,125,110,89,60,29,7,Win,155,93,0,10,4,JAX,36,280,203,0,-10.00335113495429,38.492354531479535,14.244501698262624,24.24785283321691
0.41666666700000005,0.25,29.91666667,9/10/2017,23,19,home,-22,JAX,110,125,94,69,7,29,Loss,93,155,10,0,0,HOU,36,203,280,4,10.00335113495429,38.492354531479535,24.24785283321691,14.244501698262622
0.41666666700000005,0.5,31.65,9/10/2017,22,21,away,10,TEN,250,255,49,63,26,16,Win,109,95,2,1,0,OAK,42,359,350,0,-7.020789805880147,49.216682744695575,21.097946469407713,28.118736275287862
0.5,0.41666666700000005,28.35,9/10/2017,21,22,home,-10,OAK,255,250,49,63,16,26,Loss,95,109,1,2,0,TEN,42,350,359,0,7.020789805880147,49.216682744695575,28.118736275287862,21.097946469407713
0.571428571,0.272727273,34.26666667,9/10/2017,19,16,away,13,WAS,298,200,76,65,30,17,Win,58,64,2,4,4,PHI,47,356,264,2,-2.5884110078133897,44.99545293250208,21.203520962344346,23.791931970157737
0.272727273,0.571428571,25.73333333,9/10/2017,16,19,home,-13,PHI,200,298,15,61,17,30,Loss,64,58,4,2,2,WAS,47,264,356,4,2.5884110078133897,44.99545293250208,23.791931970157737,21.203520962344346
0.0,0.35714285700000004,25.58333333,9/10/2017,10,19,away,-37,LAR,150,310,20,49,9,46,Loss,75,63,4,1,1,IND,55,225,373,3,5.828047391366436,37.23607464077347,21.532061016069953,15.704013624703515
0.35714285700000004,0.0,34.41666667,9/10/2017,19,10,home,37,IND,310,150,50,64,46,9,Win,63,75,1,4,3,LAR,55,373,225,1,-5.828047391366436,37.23607464077347,15.704013624703514,21.532061016069953
0.538461538,0.181818182,34.35,9/10/2017,20,13,away,20,SFO,171,166,40,63,23,3,Win,116,51,0,4,2,CAR,26,287,217,2,-3.119406120500525,37.69151914462717,17.286056512063325,20.405462632563847
0.181818182,0.538461538,25.65,9/10/2017,13,20,home,-20,CAR,166,171,74,54,3,23,Loss,51,116,4,0,2,SFO,26,217,287,2,3.119406120500525,37.69151914462717,20.405462632563847,17.286056512063325
0.25,0.5625,20.78333333,9/10/2017,12,26,away,-8,GBP,135,286,50,48,9,17,Loss,90,84,3,4,1,SEA,26,225,370,1,3.4596543828293704,40.485420593919144,21.972537488374257,18.512883105544887
0.5625,0.25,39.21666667,9/10/2017,26,12,home,8,SEA,286,135,70,74,17,9,Win,84,90,4,3,1,GBP,26,370,225,1,-3.4596543828293704,40.485420593919144,18.512883105544887,21.972537488374257
0.333333333,0.533333333,25.76666667,9/10/2017,13,22,away,-16,DAL,198,263,55,53,3,19,Loss,35,129,3,1,0,NYG,22,233,392,1,-6.765763453628779,39.254339153492865,16.244287849932043,23.01005130356082
0.533333333,0.333333333,34.23333333,9/10/2017,22,13,home,16,NYG,263,198,50,71,19,3,Win,129,35,1,3,1,DAL,22,392,233,0,6.765763453628779,39.254339153492865,23.01005130356082,16.244287849932043
0.363636364,0.642857143,28.73333333,9/11/2017,19,23,away,-10,MIN,284,341,52,59,19,29,Loss,60,129,1,1,0,NOS,48,344,470,0,1.7272944773829835,50.62805120068558,26.177672839034283,24.4503783616513
0.642857143,0.363636364,31.26666667,9/11/2017,23,19,home,10,NOS,341,284,50,63,29,19,Win,129,60,1,1,0,MIN,48,470,344,0,-1.7272944773829835,50.62805120068558,24.4503783616513,26.177672839034283
0.25,0.533333333,25.78333333,9/11/2017,17,22,away,-3,DEN,185,181,40,56,21,24,Loss,64,140,1,4,2,LAC,45,249,321,1,0.5984785038431193,40.19399749475949,20.396237999301306,19.797759495458187
0.533333333,0.25,34.21666667,9/11/2017,22,17,home,3,LAC,181,185,62,68,24,21,Win,140,64,4,1,1,DEN,45,321,249,2,-0.5984785038431193,40.19399749475949,19.797759495458187,20.396237999301306
0.26666666699999997,0.26666666699999997,32.25,9/14/2017,14,12,away,4,CIN,98,213,61,62,13,9,Win,168,82,3,3,1,HOU,22,266,295,0,-6.8415069989559045,29.38884722978042,11.273670115412258,18.115177114368162
0.26666666699999997,0.26666666699999997,27.75,9/14/2017,12,14,home,-4,HOU,213,98,45,62,9,13,Loss,82,168,3,3,0,CIN,22,295,266,1,6.8415069989559045,29.38884722978042,18.115177114368162,11.273670115412258
0.4,0.444444444,28.81666667,9/17/2017,17,18,away,3,IND,306,190,41,65,3,0,Win,83,76,4,4,1,ARI,3,389,266,1,-7.319003473457352,37.47696131702651,15.078978921784579,22.39798239524193
0.444444444,0.4,33.15,9/17/2017,18,17,home,-3,ARI,190,306,70,70,0,3,Loss,76,83,4,4,1,IND,3,266,389,1,7.319003473457352,37.47696131702651,22.39798239524193,15.078978921784579
0.166666667,0.363636364,26.6,9/17/2017,20,24,away,-14,BAL,293,201,65,66,10,24,Loss,93,136,3,2,2,CLE,34,386,337,5,4.859251366903859,45.023574478083226,24.94141292249354,20.082161555589686
0.363636364,0.166666667,33.4,9/17/2017,24,20,home,14,CLE,201,293,45,68,24,10,Win,136,93,2,3,5,BAL,34,337,386,2,-4.859251366903859,45.023574478083226,20.082161555589686,24.94141292249354
0.307692308,0.4375,21.11666667,9/17/2017,10,19,away,-6,CAR,107,178,44,51,3,9,Loss,69,77,3,6,0,BUF,12,176,255,0,-5.0109589916981605,30.214629270393893,12.601835139347866,17.612794131046027
0.4375,0.307692308,38.88333333,9/17/2017,19,10,home,6,BUF,178,107,40,66,9,3,Win,77,69,6,3,0,CAR,12,255,176,0,5.0109589916981605,30.214629270393893,17.612794131046027,12.601835139347866
0.5,0.533333333,26.81666667,9/17/2017,19,22,away,-22,TBB,290,194,59,62,7,29,Loss,20,117,1,2,1,CHI,36,310,311,4,-8.719007210009948,45.97347300143483,18.627232895712442,27.34624010572239
0.533333333,0.5,33.18333333,9/17/2017,22,19,home,22,CHI,194,290,34,67,29,7,Win,117,20,2,1,4,TBB,36,311,310,1,8.719007210009948,45.97347300143483,27.34624010572239,18.627232895712442
0.46153846200000004,0.46153846200000004,30.76666667,9/17/2017,21,20,away,21,JAX,211,211,70,64,37,16,Win,179,99,1,2,3,TEN,53,390,310,1,-9.704200577633335,50.2079237070138,20.25186156469023,29.956062142323567
0.46153846200000004,0.46153846200000004,29.23333333,9/17/2017,20,21,home,-21,TEN,211,211,99,61,16,37,Loss,99,179,2,1,1,JAX,53,310,390,3,9.704200577633335,50.2079237070138,29.956062142323567,20.25186156469023
0.533333333,0.41666666700000005,30.81666667,9/17/2017,27,16,away,-7,KCC,299,232,30,69,20,27,Loss,107,112,6,4,0,PHI,47,406,344,2,8.816654693486315,49.86373815299767,29.34019642324199,20.523541729755678
0.41666666700000005,0.533333333,29.18333333,9/17/2017,16,27,home,7,PHI,232,299,40,51,27,20,Win,112,107,4,6,2,KCC,47,344,406,0,-8.816654693486315,49.86373815299767,20.523541729755678,29.34019642324199
0.333333333,0.23076923100000002,25.63333333,9/17/2017,14,22,away,-17,PIT,146,233,131,60,9,26,Loss,91,102,2,2,0,MIN,35,237,335,1,-8.918774594197817,34.14425378677222,12.612739596287199,21.53151419048502
0.23076923100000002,0.333333333,34.36666667,9/17/2017,22,14,home,17,MIN,233,146,72,69,26,9,Win,102,91,2,2,1,PIT,35,335,237,0,8.918774594197817,34.14425378677222,21.53151419048502,12.6127395962872
0.5,0.333333333,35.1,9/17/2017,29,20,away,16,NOS,436,348,66,72,36,20,Win,119,81,2,1,0,NEP,56,555,429,0,8.447600987665854,55.89737579056877,32.17248838911731,23.72488740145146
0.333333333,0.5,24.9,9/17/2017,20,29,home,-16,NEP,348,436,35,63,20,36,Loss,81,119,1,2,0,NOS,56,429,555,0,-8.447600987665854,55.89737579056877,23.72488740145146,32.17248838911731
0.384615385,0.25,33.36666667,9/17/2017,21,24,away,2,LAC,225,323,23,68,19,17,Win,111,44,2,1,0,MIA,36,336,367,0,4.873054700775322,42.175584803491134,23.524319752133227,18.651265051357907
0.25,0.384615385,26.63333333,9/17/2017,24,21,home,-2,MIA,323,225,56,54,17,19,Loss,44,111,1,2,0,LAC,36,367,336,0,-4.873054700775322,42.175584803491134,18.651265051357907,23.524319752133227
0.583333333,0.666666667,28.96666667,9/17/2017,17,21,away,-25,OAK,145,230,47,53,20,45,Loss,126,180,4,0,0,NYJ,65,271,410,2,0.5556314670496079,53.57946745802873,27.06754946253917,26.51191799548956
0.666666667,0.583333333,31.03333333,9/17/2017,21,17,home,25,NYJ,230,145,79,55,45,20,Win,180,126,0,4,2,OAK,65,410,271,0,-0.5556314670496079,53.57946745802873,26.51191799548956,27.06754946253917
0.214285714,0.6,26.16666667,9/17/2017,16,26,away,-25,DEN,228,202,69,66,17,42,Loss,40,178,2,2,2,DAL,59,268,380,2,-8.27728729980244,43.19369160304541,17.458202151621485,25.735489451423923
0.6,0.214285714,33.83333333,9/17/2017,26,16,home,25,DAL,202,228,61,73,42,17,Win,178,40,2,2,2,DEN,59,380,268,2,8.27728729980244,43.19369160304541,25.735489451423923,17.458202151621485
0.384615385,0.41666666700000005,36.31666667,9/17/2017,21,14,away,7,LAR,156,235,25,68,27,20,Win,229,97,2,2,2,WAS,47,385,332,0,-5.688975086074921,42.817618552405456,18.56432173316527,24.253296819240187
0.41666666700000005,0.384615385,23.68333333,9/17/2017,14,21,home,-7,WAS,235,156,75,49,20,27,Loss,97,229,2,2,0,LAR,47,332,385,2,5.688975086074921,42.817618552405456,24.253296819240187,18.56432173316527
0.166666667,0.42105263200000004,23.03333333,9/17/2017,11,21,away,-3,SEA,89,181,66,48,9,12,Loss,159,131,2,3,0,SFO,21,248,312,1,-5.420134604716159,29.084638272838617,11.832251834061228,17.25238643877739
0.42105263200000004,0.166666667,36.96666667,9/17/2017,21,11,home,3,SFO,181,89,71,79,12,9,Win,131,159,3,2,1,SEA,21,312,248,0,5.420134604716159,29.084638272838617,17.25238643877739,11.832251834061228
0.41666666700000005,0.454545455,31.38333333,9/17/2017,24,19,away,-11,ATL,308,223,70,68,23,34,Loss,59,141,3,3,0,GBP,57,367,364,2,2.331186006118097,47.40501069508683,24.868098350602462,22.536912344484367
0.454545455,0.41666666700000005,28.61666667,9/17/2017,19,24,home,11,GBP,223,308,34,58,34,23,Win,141,59,3,3,2,ATL,57,364,367,0,-2.331186006118097,47.40501069508683,22.536912344484367,24.868098350602462
0.46666666700000003,0.333333333,32.78333333,9/18/2017,12,14,away,14,NYG,119,208,50,56,24,10,Win,138,62,3,5,1,DET,34,257,270,1,-0.34640770862864123,35.7263640185048,17.689978154938082,18.03638586356672
0.333333333,0.46666666700000003,27.21666667,9/18/2017,14,12,home,-14,DET,208,119,50,55,10,24,Loss,62,138,5,3,1,NYG,34,270,257,1,0.34640770862864123,35.7263640185048,18.03638586356672,17.689978154938082
0.666666667,0.5,29.71666667,9/21/2017,26,25,away,2,SFO,292,308,52,60,41,39,Win,126,113,0,4,2,LAR,80,418,421,2,-4.245162460990177,58.494000045319524,27.124418792164672,31.369581253154852
0.5,0.666666667,30.28333333,9/21/2017,25,26,home,-2,LAR,308,292,55,74,39,41,Loss,113,126,4,0,2,SFO,80,421,418,2,4.245162460990177,58.494000045319524,31.369581253154852,27.124418792164672
0.272727273,0.25,25.95,9/24/2017,12,24,away,-37,JAX,52,244,88,54,7,44,Loss,134,166,2,0,0,BAL,51,186,410,3,-0.960123692271285,37.19274465395324,18.11631048084098,19.07643417311226
0.25,0.272727273,34.05,9/24/2017,24,12,home,37,BAL,244,52,70,68,44,7,Win,166,134,0,2,3,JAX,51,410,186,0,0.960123692271285,37.19274465395324,19.07643417311226,18.11631048084098
0.444444444,0.23076923100000002,32.58333333,9/24/2017,26,21,away,4,DET,277,253,68,65,30,26,Win,151,71,2,2,0,ATL,56,428,324,3,-1.7204619130350371,48.32909348664202,23.304315786803492,25.02477769983853
0.23076923100000002,0.444444444,27.41666667,9/24/2017,21,26,home,-4,ATL,253,277,98,66,26,30,Loss,71,151,2,2,3,DET,56,324,428,0,1.7204619130350371,48.32909348664202,25.02477769983853,23.304315786803492
0.428571429,0.375,29.56666667,9/24/2017,21,16,away,-10,BUF,255,197,79,66,16,26,Loss,111,75,3,4,0,DEN,42,366,272,2,-3.7629671565809444,42.929085718665625,19.583059281042342,23.346026437623284
0.375,0.428571429,30.43333333,9/24/2017,16,21,home,10,DEN,197,255,69,63,26,16,Win,75,111,4,3,2,BUF,42,272,366,0,3.7629671565809444,42.929085718665625,23.346026437623284,19.583059281042342
0.5,0.5,31.15,9/24/2017,21,18,away,21,CAR,213,156,10,57,34,13,Win,149,132,1,4,3,NOS,47,362,288,0,4.564265193048477,46.616674536204584,25.59046986462653,21.026204671578054
0.5,0.5,28.85,9/24/2017,18,21,home,-21,NOS,156,213,5,59,13,34,Loss,132,149,4,1,0,CAR,47,288,362,3,-4.564265193048477,46.616674536204584,21.026204671578054,25.59046986462653
0.363636364,0.333333333,27.56666667,9/24/2017,19,18,away,-6,CHI,212,84,40,59,0,6,Loss,70,222,3,2,2,PIT,6,282,306,2,-1.0077950163668348,37.93695043178203,18.464577707707598,19.472372724074432
0.333333333,0.363636364,33.98333333,9/24/2017,18,19,home,6,PIT,84,212,73,62,6,0,Win,222,70,2,3,2,CHI,6,306,282,2,1.0077950163668348,37.93695043178203,19.472372724074432,18.464577707707598
0.384615385,0.470588235,26.55,9/24/2017,25,16,away,-3,IND,235,243,113,69,28,31,Loss,111,92,1,3,1,CLE,59,346,335,3,-8.45502143434549,45.599991743408914,18.572485154531712,27.027506588877202
0.470588235,0.384615385,33.45,9/24/2017,16,25,home,3,CLE,243,235,99,63,31,28,Win,92,111,3,1,3,IND,59,335,346,1,8.45502143434549,45.599991743408914,27.027506588877202,18.572485154531712
0.428571429,0.46153846200000004,33.63333333,9/24/2017,23,21,away,-3,NEP,292,337,60,67,33,36,Loss,125,59,2,5,1,HOU,69,417,396,2,5.689866393531131,52.76034084760979,29.22510362057046,23.535237227039328
0.46153846200000004,0.428571429,26.36666667,9/24/2017,21,23,home,3,HOU,337,292,69,60,36,33,Win,59,125,5,2,2,NEP,69,396,417,1,-5.689866393531131,52.76034084760979,23.535237227039328,29.22510362057046
0.083333333,0.307692308,23.86666667,9/24/2017,16,16,away,-14,NYJ,195,233,51,63,6,20,Loss,30,103,3,2,1,MIA,26,225,336,2,-0.7413142122935561,34.13544201309742,16.69706390040193,17.43837811269549
0.307692308,0.083333333,36.13333333,9/24/2017,16,16,home,14,MIA,233,195,94,59,20,6,Win,103,30,2,3,2,NYJ,26,336,225,1,0.7413142122935561,34.13544201309742,17.43837811269549,16.69706390040193
0.166666667,0.538461538,22.23333333,9/24/2017,20,25,away,-17,MIN,316,369,37,51,17,34,Loss,26,125,2,0,0,TBB,51,342,494,3,3.1433331598543788,53.244774498418074,28.194053829136227,25.050720669281848
0.538461538,0.166666667,37.76666667,9/24/2017,25,20,home,17,TBB,369,316,53,70,34,17,Win,125,26,0,2,3,MIN,51,494,342,0,-3.1433331598543788,53.244774498418074,25.050720669281848,28.194053829136227
0.3,0.35714285700000004,22.46666667,9/24/2017,21,24,away,-3,PHI,366,161,137,64,24,27,Loss,49,193,0,3,1,NYG,51,415,354,2,-9.190604228690667,52.41422200166379,21.61180888648656,30.802413115177227
0.35714285700000004,0.3,37.53333333,9/24/2017,24,21,home,3,NYG,161,366,103,73,27,24,Win,193,49,3,0,2,PHI,51,354,415,1,9.190604228690667,52.41422200166379,30.802413115177227,21.61180888648656
0.28571428600000004,0.28571428600000004,27.31666667,9/24/2017,24,21,away,-6,TEN,364,225,98,72,27,33,Loss,69,195,1,0,0,SEA,60,433,420,0,-8.696849126888115,46.12747074009065,18.715310806601266,27.412159933489384
0.28571428600000004,0.28571428600000004,32.68333333,9/24/2017,21,24,home,6,SEA,225,364,45,67,33,27,Win,195,69,0,1,0,TEN,60,420,433,0,8.696849126888115,46.12747074009065,27.412159933489384,18.715310806601266
0.333333333,0.46666666700000003,34.28333333,9/24/2017,21,22,away,-3,GBP,191,280,68,60,0,3,Loss,110,64,3,6,1,CIN,3,301,344,1,6.630151871834464,42.85174103775102,24.74094645479274,18.110794582958277
0.46666666700000003,0.333333333,29.35,9/24/2017,22,21,home,3,CIN,280,191,33,65,3,0,Win,64,110,6,3,1,GBP,3,344,301,1,-6.630151871834464,42.85174103775102,18.110794582958277,24.74094645479274
0.333333333,0.384615385,30.43333333,9/24/2017,16,24,away,14,LAC,122,226,122,51,24,10,Win,189,104,5,2,3,KCC,34,311,330,0,-0.8738765186973252,41.14185939566146,20.13399143848207,21.007867957179393
0.384615385,0.333333333,29.56666667,9/24/2017,24,16,home,-14,KCC,226,122,61,68,10,24,Loss,104,189,2,5,0,LAC,34,330,311,3,0.8738765186973252,41.14185939566146,21.007867957179393,20.13399143848207
0.0,0.46666666700000003,21.9,9/24/2017,7,18,away,-17,WAS,96,356,35,48,10,27,Loss,32,116,4,1,2,OAK,37,128,472,3,-3.514743089979337,39.24574574501465,17.865501327517656,21.380244417496996
0.46666666700000003,0.0,38.1,9/24/2017,18,7,home,17,OAK,356,96,77,65,27,10,Win,116,32,1,4,3,WAS,37,472,128,2,3.514743089979337,39.24574574501465,21.380244417496996,17.865501327517656
0.222222222,0.444444444,23.75,9/25/2017,15,22,away,11,ARI,174,283,76,45,28,17,Win,99,49,1,6,0,DAL,45,273,332,0,-0.45989556408878074,33.79821686889219,16.669160652401704,17.129056216490486
0.444444444,0.222222222,36.25,9/25/2017,22,15,home,-11,DAL,283,174,50,75,17,28,Loss,49,99,6,1,0,ARI,45,332,273,0,0.45989556408878074,33.79821686889219,17.129056216490486,16.669160652401704
0.41666666700000005,0.5,31.85,9/28/2017,20,17,away,-21,GBP,205,169,62,64,14,35,Loss,103,91,1,2,0,CHI,49,308,260,4,0.5548103451482902,44.155175675049925,22.354993010099108,21.800182664950817
0.5,0.41666666700000005,28.15,9/28/2017,17,20,home,21,CHI,169,205,55,53,35,14,Win,91,103,2,1,4,GBP,49,260,308,0,-0.5548103451482902,44.155175675049925,21.800182664950817,22.354993010099108
0.46153846200000004,0.125,34.46666667,10/1/2017,22,11,away,20,MIA,261,128,71,70,20,0,Win,86,58,1,4,1,NOS,20,347,186,0,1.3627168108493617,32.76326604840615,17.062991429627758,15.700274618778394
0.125,0.46153846200000004,25.53333333,10/1/2017,11,22,home,-20,NOS,128,261,90,47,0,20,Loss,58,86,4,1,0,MIA,20,186,347,1,-1.3627168108493617,32.76326604840615,15.700274618778394,17.062991429627758
0.46153846200000004,0.384615385,28.75,10/1/2017,15,25,away,6,ATL,164,242,55,59,23,17,Win,117,147,3,1,3,BUF,40,281,389,0,-4.382025301435887,42.44909107660609,19.0335328875851,23.415558189020988
0.384615385,0.46153846200000004,31.25,10/1/2017,25,15,home,-6,BUF,242,164,45,72,17,23,Loss,147,117,1,3,0,ATL,40,389,281,3,4.382025301435887,42.44909107660609,23.415558189020988,19.0335328875851
0.46666666700000003,0.384615385,35.48333333,10/1/2017,22,18,away,17,BAL,208,206,60,73,26,9,Win,173,82,1,4,3,PIT,35,381,288,1,-5.566231808327245,40.74790381951654,17.590836005594646,23.15706781392189
0.384615385,0.46666666700000003,24.51666667,10/1/2017,18,22,home,-17,PIT,206,208,55,68,9,26,Loss,82,173,4,1,1,BAL,35,288,381,3,5.566231808327245,40.74790381951654,23.15706781392189,17.590836005594646
0.666666667,0.5,28.88333333,10/1/2017,28,24,away,3,NEP,304,293,33,60,33,30,Win,140,80,2,3,0,CAR,63,444,373,2,7.04950005310417,58.425161020993016,32.73733053704859,25.687830483944424
0.5,0.666666667,31.11666667,10/1/2017,24,28,home,-3,CAR,293,304,55,67,30,33,Loss,80,140,3,2,2,NEP,63,373,444,0,-7.04950005310417,58.425161020993016,25.687830483944424,32.73733053704859
0.545454545,0.3125,35.03333333,10/1/2017,25,16,away,24,CLE,264,170,66,63,31,7,Win,86,45,3,2,1,CIN,38,350,215,1,2.556656622145267,37.85874217635781,20.20769939925154,17.65104277710627
0.3125,0.545454545,24.96666667,10/1/2017,16,25,home,-24,CIN,170,264,28,61,7,31,Loss,45,86,2,3,1,CLE,38,215,350,1,-2.556656622145267,37.85874217635781,17.65104277710627,20.20769939925154
0.384615385,0.5,30.53333333,10/1/2017,24,22,away,5,DAL,244,251,41,68,35,30,Win,168,189,1,2,2,LAR,65,412,440,0,-6.662593542824936,50.549348739662975,21.94337759841902,28.605971141243955
0.5,0.384615385,29.46666667,10/1/2017,22,24,home,-5,LAR,251,244,45,65,30,35,Loss,189,168,2,1,0,DAL,65,440,412,2,6.662593542824936,50.549348739662975,28.605971141243955,21.94337759841902
0.23076923100000002,0.3,36.45,10/1/2017,19,15,away,7,MIN,154,197,60,68,14,7,Win,97,87,6,2,3,DET,21,251,284,0,2.2952191609284394,34.68456255002544,18.48989085547694,16.1946716945485
0.3,0.23076923100000002,23.55,10/1/2017,15,19,home,-7,DET,197,154,10,54,7,14,Loss,87,97,2,6,0,MIN,21,284,251,3,-2.2952191609284394,34.68456255002544,16.1946716945485,18.48989085547694
0.25,0.5,20.31666667,10/1/2017,9,33,away,-43,HOU,109,272,88,41,14,57,Loss,86,173,2,2,1,TEN,71,195,445,5,-0.6394332967658869,48.82753896816719,24.09405283570065,24.73348613246654
0.5,0.25,39.68333333,10/1/2017,33,9,home,43,TEN,272,109,20,78,57,14,Win,173,86,2,2,5,HOU,71,445,195,1,0.6394332967658869,48.82753896816719,24.73348613246654,24.09405283570065
0.26666666699999997,0.352941176,35.13333333,10/1/2017,20,18,away,-3,NYJ,136,215,47,75,0,3,Loss,175,256,1,5,2,JAX,3,311,471,1,-15.20268602187186,38.512834995535094,11.655074486831616,26.85776050870348
0.352941176,0.26666666699999997,34.4,10/1/2017,18,20,home,3,JAX,215,136,70,69,3,0,Win,256,175,5,1,1,NYJ,3,471,311,2,15.20268602187186,38.512834995535094,26.85776050870348,11.655074486831616
0.263157895,0.3125,33.21666667,10/1/2017,20,25,away,-3,ARI,210,317,113,79,3,6,Loss,95,51,3,6,1,SFO,9,305,368,1,-18.012351890569402,31.484100714203297,6.735874411816948,24.74822630238635
0.3125,0.263157895,36.25,10/1/2017,25,20,home,3,SFO,317,210,80,79,6,3,Win,51,95,6,3,1,ARI,9,368,305,1,18.012351890569402,31.484100714203297,24.74822630238635,6.735874411816948
0.5625,0.5,39.3,10/1/2017,26,18,away,2,LAC,240,342,58,74,26,24,Win,214,58,1,2,1,PHI,50,454,400,0,-0.34608143806142433,54.433128854849,27.04352370839379,27.389605146455214
0.5,0.5625,20.7,10/1/2017,18,26,home,-2,PHI,342,240,39,53,24,26,Loss,58,214,2,1,0,LAC,50,400,454,1,0.34608143806142433,54.433128854849,27.389605146455214,27.04352370839379
0.470588235,0.272727273,34.21666667,10/1/2017,24,20,away,-2,TBB,288,323,0,77,23,25,Loss,91,111,0,1,0,NYG,48,379,434,0,-9.193001633236602,46.28849723157692,18.54774779917016,27.74074943240676
0.272727273,0.470588235,25.78333333,10/1/2017,20,24,home,2,NYG,323,288,19,62,25,23,Win,111,91,1,0,0,TBB,48,434,379,0,9.193001633236602,46.28849723157692,27.74074943240676,18.54774779917016
0.166666667,0.3125,27.05,10/1/2017,11,16,away,-6,DEN,230,155,75,53,10,16,Loss,24,143,3,4,0,OAK,26,254,298,1,0.46884823878279924,35.65037393344923,18.059611086116014,17.590762847333217
0.3125,0.166666667,32.95,10/1/2017,16,11,home,6,OAK,155,230,40,62,16,10,Win,143,24,4,3,1,DEN,26,298,254,0,-0.46884823878279924,35.65037393344923,17.590762847333217,18.059611086116014
0.428571429,0.666666667,27.8,10/1/2017,16,22,away,-28,SEA,139,283,31,57,18,46,Loss,98,194,3,3,2,IND,64,237,477,2,5.131303403689351,48.342901233914716,26.737102318802034,21.605798915112683
0.666666667,0.428571429,32.2,10/1/2017,22,16,home,28,IND,283,139,45,62,46,18,Win,194,98,3,3,2,SEA,64,477,237,2,-5.131303403689351,48.342901233914716,21.605798915112683,26.737102318802034
0.363636364,0.615384615,22.85,10/2/2017,15,29,away,-9,KCC,220,261,44,50,20,29,Loss,111,168,0,4,0,WAS,49,331,429,1,-1.1633623731625207,46.24715538567333,22.541896506255405,23.705258879417926
0.615384615,0.363636364,37.15,10/2/2017,29,15,home,9,WAS,261,220,15,72,29,20,Win,168,111,4,0,1,KCC,49,429,331,0,1.1633623731625207,46.24715538567333,23.705258879417926,22.541896506255405
0.333333333,0.307692308,30.83333333,10/5/2017,23,26,away,5,TBB,289,319,108,66,19,14,Win,113,90,3,2,0,NEP,33,402,409,2,1.4758011444250982,49.264200610984076,25.370000877704587,23.89419973327949
0.307692308,0.333333333,29.16666667,10/5/2017,26,23,home,-5,NEP,319,289,70,68,14,19,Loss,90,113,2,3,2,TBB,33,409,402,0,-1.4758011444250982,49.264200610984076,23.89419973327949,25.370000877704587
0.28571428600000004,0.642857143,24.21666667,10/8/2017,16,19,away,-27,PHI,276,297,61,60,7,34,Loss,31,122,2,1,1,ARI,41,307,419,1,-0.8988414143677534,45.92180801174507,22.51148329868866,23.41032471305641
0.642857143,0.28571428600000004,35.78333333,10/8/2017,19,16,home,27,ARI,297,276,60,64,34,7,Win,122,31,1,2,1,PHI,41,419,307,1,0.8988414143677534,45.92180801174507,23.41032471305641,22.51148329868866
0.333333333,0.4,29.98333333,10/8/2017,17,18,away,-4,CIN,139,323,71,67,16,20,Loss,82,65,6,1,3,BUF,36,221,388,1,-3.6069855268793214,40.64465518337873,18.518834828249705,22.125820355129026
0.4,0.333333333,30.01666667,10/8/2017,18,17,home,4,BUF,323,139,71,64,20,16,Win,65,82,1,6,1,CIN,36,388,221,3,3.6069855268793214,40.64465518337873,22.125820355129026,18.518834828249705
0.4375,0.384615385,35.38333333,10/8/2017,16,19,away,3,DET,334,192,100,64,27,24,Win,28,50,3,6,1,CAR,51,362,242,0,-3.2766688617050725,42.16736893785193,19.44535003807343,22.722018899778504
0.384615385,0.4375,24.61666667,10/8/2017,19,16,home,-3,CAR,192,334,10,56,24,27,Loss,50,28,6,3,0,DET,51,242,362,1,3.2766688617050725,42.16736893785193,22.722018899778504,19.44535003807343
0.333333333,0.428571429,25.56666667,10/8/2017,14,22,away,3,CLE,178,279,80,51,17,14,Win,34,140,3,1,3,NYJ,31,212,419,1,-1.4392567412236854,41.78278655647427,20.171764907625292,21.61102164884898
0.428571429,0.333333333,34.43333333,10/8/2017,22,14,home,-3,NYJ,279,178,60,70,14,17,Loss,140,34,1,3,1,CLE,31,419,212,3,1.4392567412236854,41.78278655647427,21.61102164884898,20.171764907625292
0.28571428600000004,0.5,31.08333333,10/8/2017,23,25,away,-3,IND,336,288,77,70,0,3,Loss,66,159,2,4,1,SFO,3,402,447,0,-6.796490176131316,45.595230234117885,19.399370028993285,26.1958602051246
0.5,0.28571428600000004,37.28333333,10/8/2017,25,23,home,3,SFO,288,336,62,73,3,0,Win,159,66,4,2,0,IND,3,447,402,1,6.796490176131316,45.595230234117885,26.1958602051246,19.399370028993285
0.5,0.46666666700000003,28.86666667,10/8/2017,15,21,away,21,PIT,82,301,19,53,30,9,Win,231,70,2,2,5,JAX,39,313,371,1,-5.756305680416062,46.28564689289293,20.264670606238433,26.020976286654495
0.46666666700000003,0.5,31.13333333,10/8/2017,21,15,home,-21,JAX,301,82,37,77,9,30,Loss,70,231,2,2,1,PIT,39,371,313,5,5.756305680416062,46.28564689289293,26.020976286654495,20.264670606238433
0.444444444,0.333333333,31.75,10/8/2017,21,18,away,5,NYG,258,183,87,73,27,22,Win,124,152,0,5,2,LAC,49,382,335,1,-14.053992910944185,44.12825103148022,15.037129060268015,29.091121971212203
0.333333333,0.444444444,28.25,10/8/2017,18,21,home,-5,LAC,183,258,67,66,22,27,Loss,152,124,5,0,1,NYG,49,335,382,2,14.053992910944185,44.12825103148022,29.091121971212203,15.037129060268017
0.153846154,0.333333333,30.25,10/8/2017,14,12,away,-6,MIA,119,78,77,58,10,16,Loss,69,100,6,1,2,TEN,26,188,178,2,-2.6831873441852503,24.817730796457287,11.067271726136019,13.750459070321268
0.333333333,0.153846154,29.75,10/8/2017,12,14,home,6,TEN,78,119,23,59,16,10,Win,100,69,1,6,2,MIA,26,178,188,2,2.6831873441852503,24.817730796457287,13.750459070321268,11.067271726136019
0.5,0.5,33.71666667,10/8/2017,19,15,away,13,OAK,222,137,5,65,30,17,Win,143,108,0,3,1,BAL,47,365,245,0,2.2911783218583697,40.94744818631215,21.61931325408526,19.32813493222689
0.5,0.5,26.28333333,10/8/2017,15,19,home,-13,BAL,137,222,24,54,17,30,Loss,108,143,3,0,0,OAK,47,245,365,1,-2.2911783218583697,40.94744818631215,19.32813493222689,21.61931325408526
0.470588235,0.533333333,31.26666667,10/8/2017,15,21,away,6,LAR,179,275,40,66,16,10,Win,62,100,3,2,5,SEA,26,241,375,2,-8.363302294017203,43.92843224874679,17.782564977364792,26.145867271381995
0.533333333,0.470588235,28.73333333,10/8/2017,21,15,home,-6,SEA,275,179,45,71,10,16,Loss,100,62,2,3,2,LAR,26,375,241,5,8.363302294017203,43.92843224874679,26.145867271381995,17.782564977364792
0.428571429,0.583333333,24.9,10/8/2017,25,26,away,4,DAL,182,245,38,58,35,31,Win,160,163,4,1,3,GBP,66,342,408,1,0.7754926028212847,53.7644848452536,27.269988724037443,26.494496121216155
0.583333333,0.428571429,35.1,10/8/2017,26,25,home,-4,GBP,245,182,70,72,31,35,Loss,163,160,1,4,1,DAL,66,408,342,3,-0.7754926028212847,53.7644848452536,26.494496121216155,27.269988724037443
0.5625,0.3,38.28333333,10/8/2017,29,20,away,8,HOU,323,248,64,73,42,34,Win,127,144,1,3,1,KCC,76,450,392,0,-3.6792646589501707,52.29991886105866,24.31032710105424,27.989591760004416
0.3,0.5625,21.71666667,10/8/2017,20,29,home,-8,KCC,248,323,59,57,34,42,Loss,144,127,3,1,0,HOU,76,392,450,1,3.6792646589501707,52.29991886105866,27.989591760004416,24.31032710105424
0.4,0.25,31.4,10/9/2017,17,16,away,3,CHI,141,159,69,67,20,17,Win,159,115,4,1,2,MIN,37,300,274,0,-6.236494177360655,34.659570478928146,14.211538150783745,20.4480323281444
0.25,0.4,28.6,10/9/2017,16,17,home,-3,MIN,159,141,55,56,17,20,Loss,115,159,1,4,0,CHI,37,274,300,2,6.236494177360655,34.659570478928146,20.4480323281444,14.211538150783745
0.35714285700000004,0.25,28.56666667,10/12/2017,15,23,away,5,CAR,209,225,126,60,28,23,Win,101,80,3,2,3,PHI,51,310,305,1,-10.450974449447365,42.91862976668925,16.233827658620942,26.684802108068308
0.25,0.35714285700000004,31.43333333,10/12/2017,23,15,home,-5,PHI,225,209,1,79,23,28,Loss,80,101,2,3,1,CAR,51,305,310,3,10.450974449447365,42.91862976668925,26.684802108068308,16.233827658620942
0.41666666700000005,0.545454545,34.4,10/15/2017,20,19,away,3,ATL,151,239,42,64,20,17,Win,138,100,0,2,1,MIA,37,289,339,1,-0.32590867618981356,40.53315995813717,20.10362564097368,20.42953431716349
0.545454545,0.41666666700000005,25.6,10/15/2017,19,20,home,-3,MIA,239,151,73,56,17,20,Loss,100,138,2,0,1,ATL,37,339,289,1,0.32590867618981356,40.53315995813717,20.42953431716349,20.10362564097368
0.294117647,0.166666667,36.75,10/15/2017,18,16,away,3,BAL,111,166,44,75,3,0,Win,231,125,4,3,3,CHI,3,342,291,2,-10.079645097497455,28.866852366740247,9.393603634621396,19.47324873211885
0.166666667,0.294117647,31.15,10/15/2017,16,18,home,-3,CHI,166,111,69,70,0,3,Loss,125,231,3,4,2,BAL,3,291,342,3,10.079645097497455,28.866852366740247,19.47324873211885,9.393603634621396
0.214285714,0.384615385,30.9,10/15/2017,16,18,away,-16,HOU,113,217,72,63,17,33,Loss,134,123,4,1,1,CLE,50,247,340,3,-6.5872313132754545,35.72369257986301,14.56823063329378,21.155461946569233
0.384615385,0.214285714,29.1,10/15/2017,18,16,home,16,CLE,217,113,44,63,33,17,Win,123,134,1,4,3,HOU,50,340,247,1,6.5872313132754545,35.72369257986301,21.155461946569233,14.56823063329378
0.5,0.166666667,27.81666667,10/15/2017,18,19,away,-14,NOS,281,186,46,76,38,52,Loss,66,193,5,0,3,DET,90,347,379,5,-9.758843384119908,47.737775162481164,18.98946588918063,28.748309273300535
0.166666667,0.5,32.18333333,10/15/2017,19,18,home,14,DET,186,281,118,67,52,38,Win,193,66,0,5,5,NOS,90,379,347,3,9.758843384119908,47.737775162481164,28.748309273300535,18.98946588918063
0.235294118,0.333333333,27.85,10/15/2017,14,24,away,-13,MIN,155,239,92,65,10,23,Loss,72,112,4,0,2,GBP,33,227,351,3,-6.234463973095654,40.818210945986706,17.291873486445525,23.526337459541182
0.333333333,0.235294118,32.15,10/15/2017,24,14,home,13,GBP,239,155,65,70,23,10,Win,112,72,0,4,3,MIN,33,351,227,2,6.234463973095654,40.818210945986706,23.526337459541182,17.291873486445525
0.538461538,0.529411765,26.33333333,10/15/2017,23,23,away,7,NYJ,257,334,45,63,24,17,Win,118,74,0,4,3,NEP,41,375,408,2,1.8067957916734994,54.331373481734026,28.069084636703764,26.262288845030263
0.529411765,0.538461538,33.66666667,10/15/2017,23,23,home,-7,NEP,334,257,69,75,17,24,Loss,74,118,4,0,2,NYJ,41,408,375,3,-1.8067957916734994,54.331373481734026,26.262288845030263,28.069084636703764
0.352941176,0.5,23.13333333,10/15/2017,21,25,away,-2,WAS,250,325,40,70,24,26,Loss,85,94,3,1,2,SFO,50,335,419,1,-10.04022535101145,46.280422659015635,18.120098654002092,28.160324005013543
0.5,0.352941176,36.86666667,10/15/2017,25,21,home,2,SFO,325,250,43,71,26,24,Win,94,85,1,3,1,WAS,50,419,335,2,10.04022535101145,46.280422659015635,28.160324005013543,18.120098654002092
0.5,0.444444444,27.61666667,10/15/2017,21,23,away,-5,ARI,344,272,49,64,33,38,Loss,70,160,2,2,2,TBB,71,414,432,2,-0.13078673101591587,53.67185826562984,26.77053576730696,26.901322498322877
0.444444444,0.5,32.38333333,10/15/2017,23,21,home,5,TBB,272,344,61,59,38,33,Win,160,70,2,2,2,ARI,71,432,414,2,0.13078673101591587,53.67185826562984,26.901322498322877,26.77053576730696
0.307692308,0.26666666699999997,28.01666667,10/15/2017,12,19,away,10,JAX,107,220,70,56,27,17,Win,142,169,3,5,1,LAR,44,249,389,1,-7.209888937153305,37.06139737179447,14.925754217320584,22.135643154473886
0.26666666699999997,0.307692308,31.98333333,10/15/2017,19,12,home,-10,LAR,220,107,40,66,17,27,Loss,169,142,5,3,1,JAX,44,389,249,1,7.209888937153305,37.06139737179447,22.13564315447389,14.925754217320582
0.363636364,0.272727273,36.65,10/15/2017,23,12,away,6,KCC,245,223,57,63,19,13,Win,194,28,1,3,0,PIT,32,439,251,1,4.1364800085896665,38.923104255053566,21.529792131821615,17.39331212323195
0.272727273,0.363636364,23.35,10/15/2017,12,23,home,-6,PIT,223,245,48,52,13,19,Loss,28,194,3,1,1,KCC,32,251,439,0,-4.1364800085896665,38.923104255053566,17.39331212323195,21.529792131821615
0.428571429,0.5,32.05,10/15/2017,20,15,away,1,OAK,263,165,32,65,17,16,Win,80,109,1,1,2,LAC,33,343,274,1,-2.349448922476364,45.112187311536225,21.38136919452993,23.730818117006294
0.5,0.428571429,27.95,10/15/2017,15,20,home,-1,LAC,165,263,40,53,16,17,Loss,109,80,1,1,1,OAK,33,274,343,2,2.349448922476364,45.112187311536225,23.730818117006294,21.38136919452993
0.28571428600000004,0.294117647,30.6,10/15/2017,12,20,away,13,DEN,118,366,77,54,23,10,Win,148,46,3,4,3,NYG,33,266,412,0,-4.068118157995334,41.742745873457686,18.837313857731175,22.90543201572651
0.294117647,0.28571428600000004,29.4,10/15/2017,20,12,home,-13,NYG,366,118,46,75,10,23,Loss,46,148,4,3,0,DEN,33,412,266,3,4.068118157995334,41.742745873457686,22.90543201572651,18.837313857731175
0.222222222,0.46153846200000004,24.11666667,10/16/2017,18,25,away,-14,TEN,212,305,51,57,22,36,Loss,85,168,1,1,1,IND,58,297,473,1,0.20228462566890748,49.04603527140896,24.624159948538935,24.421875322870026
0.46153846200000004,0.222222222,35.88333333,10/16/2017,25,18,home,14,IND,305,212,45,67,36,22,Win,168,85,1,1,1,TEN,58,473,297,1,-0.20228462566890748,49.04603527140896,24.421875322870026,24.624159948538935
0.533333333,0.46153846200000004,30.6,10/19/2017,19,32,away,-1,OAK,331,417,108,60,30,31,Loss,94,88,1,0,0,KCC,61,425,505,0,-8.558144535338187,61.248351446049526,26.34510345535567,34.903247990693856
0.46153846200000004,0.533333333,29.4,10/19/2017,32,19,home,1,KCC,417,331,97,73,31,30,Win,88,94,0,1,0,OAK,61,505,425,0,8.558144535338187,61.248351446049526,34.903247990693856,26.34510345535567
0.25,0.684210526,20.98333333,10/22/2017,10,28,away,-33,LAR,171,228,65,47,0,33,Loss,25,197,3,1,1,ARI,33,196,425,2,-5.187209679308612,41.38941305817485,18.101101689433122,23.28831136874173
0.684210526,0.25,39.01666667,10/22/2017,28,10,home,33,ARI,228,171,45,78,33,0,Win,197,25,1,3,2,LAR,33,425,196,1,5.187209679308612,41.38941305817485,23.28831136874173,18.101101689433122
0.375,0.46666666700000003,27.98333333,10/22/2017,16,17,away,-8,MIN,144,188,15,64,16,24,Loss,64,169,5,0,1,BAL,40,208,357,0,-1.5280518694298717,32.52818176890991,15.500064949740018,17.02811681916989
0.46666666700000003,0.375,32.01666667,10/22/2017,17,16,home,8,BAL,188,144,47,64,24,16,Win,169,64,0,5,0,MIN,40,357,208,1,1.5280518694298717,32.52818176890991,17.02811681916989,15.500064949740018
0.545454545,0.625,33.16666667,10/22/2017,27,23,away,-3,BUF,378,261,55,70,27,30,Loss,69,173,1,1,1,TBB,57,447,434,3,-7.432676800760022,60.14592480463489,26.356624001937433,33.789300802697454
0.625,0.545454545,26.83333333,10/22/2017,23,27,home,3,TBB,261,378,35,67,30,27,Win,173,69,1,1,3,BUF,57,434,447,1,7.432676800760022,60.14592480463489,33.789300802697454,26.356624001937433
0.4,0.181818182,38.58333333,10/22/2017,20,5,away,-14,CHI,185,85,35,69,3,17,Loss,108,68,5,4,0,CAR,20,293,153,3,0.7348473630954908,31.109394257033948,15.922120810064719,15.187273446969229
0.181818182,0.4,21.41666667,10/22/2017,5,20,home,14,CAR,85,185,40,37,17,3,Win,68,108,4,5,3,CHI,20,153,293,0,-0.7348473630954908,31.109394257033948,15.187273446969229,15.922120810064719
0.294117647,0.23076923100000002,35.38333333,10/22/2017,16,19,away,3,CLE,189,218,35,68,3,0,Win,80,66,2,2,3,TEN,3,269,284,1,-10.131990401121698,29.066294613302563,9.467152106090435,19.59914250721213
0.23076923100000002,0.294117647,32.7,10/22/2017,19,16,home,-3,TEN,218,189,81,67,0,3,Loss,66,80,2,2,1,CLE,3,284,269,3,10.131990401121698,29.066294613302563,19.59914250721213,9.467152106090433
0.533333333,0.363636364,36.93333333,10/22/2017,25,16,away,9,GBP,324,79,80,75,26,17,Win,161,181,1,1,1,NOS,43,485,260,2,0.3533596600168718,49.80559071988439,25.07947518995063,24.72611552993376
0.363636364,0.533333333,23.06666667,10/22/2017,16,25,home,-9,NOS,79,324,54,50,17,26,Loss,181,161,1,1,2,GBP,43,260,485,1,-0.3533596600168718,49.80559071988439,24.72611552993376,25.07947518995063
0.571428571,0.333333333,32.78333333,10/22/2017,23,15,away,27,IND,330,136,34,65,27,0,Win,188,96,1,10,0,JAX,27,518,232,2,-6.24804085322932,46.14485949023946,19.94840931850507,26.19645017173439
0.333333333,0.571428571,27.21666667,10/22/2017,15,23,home,-27,JAX,136,330,55,67,0,27,Loss,96,188,10,1,2,IND,27,232,518,0,6.24804085322932,46.14485949023946,26.19645017173439,19.94840931850507
0.363636364,0.384615385,28.03333333,10/22/2017,16,25,away,-3,MIA,180,304,124,52,28,31,Loss,92,53,3,3,2,NYJ,59,272,357,2,2.66398894711846,46.377288692452474,24.520638819785468,21.856649872667006
0.384615385,0.363636364,31.96666667,10/22/2017,25,16,home,3,NYJ,304,180,76,65,31,28,Win,53,92,3,3,2,MIA,59,357,272,2,-2.66398894711846,46.377288692452474,21.856649872667006,24.520638819785468
0.636363636,0.46153846200000004,32.83333333,10/22/2017,27,23,away,30,SFO,236,187,36,70,40,10,Win,265,103,0,5,3,DAL,50,501,290,0,-3.211470725957888,50.20838520871179,23.49845724137695,26.70992796733484
0.46153846200000004,0.636363636,27.16666667,10/22/2017,23,27,home,-30,DAL,187,236,22,65,10,40,Loss,103,265,5,0,0,SFO,50,290,501,3,3.211470725957888,50.20838520871179,26.70992796733484,23.49845724137695
0.272727273,0.181818182,24.75,10/22/2017,11,21,away,-15,PIT,108,268,54,51,14,29,Loss,71,152,4,0,0,CIN,43,179,420,2,6.15795346904045,33.033381545232395,19.595667507136422,13.437714038095972
0.181818182,0.272727273,35.25,10/22/2017,21,11,home,15,CIN,268,108,5,68,29,14,Win,152,71,0,4,2,PIT,43,420,179,0,-6.15795346904045,33.033381545232395,13.437714038095972,19.595667507136422
0.214285714,0.25,31.06666667,10/22/2017,12,14,away,-21,LAC,182,162,68,59,0,21,Loss,69,80,5,3,0,DEN,21,251,242,3,1.401472826293185,30.91848308175978,16.159977954026484,14.758505127733297
0.25,0.214285714,28.93333333,10/22/2017,14,12,home,21,DEN,162,182,81,55,21,0,Win,80,69,3,5,3,LAC,21,242,251,0,-1.401472826293185,30.91848308175978,14.758505127733297,16.159977954026484
0.46153846200000004,0.166666667,35.43333333,10/22/2017,26,14,away,17,NYG,321,131,110,71,24,7,Win,104,46,1,1,1,SEA,31,425,177,1,-2.8726000610595808,39.615862014582795,18.371630976761608,21.244231037821187
0.166666667,0.46153846200000004,24.56666667,10/22/2017,14,26,home,-17,SEA,131,321,28,57,7,24,Loss,46,104,1,1,1,NYG,31,177,425,1,2.8726000610595808,39.615862014582795,21.244231037821187,18.371630976761608
0.222222222,0.538461538,25.91666667,10/22/2017,21,25,away,-16,NEP,223,241,40,56,7,23,Loss,120,162,1,2,0,ATL,30,343,403,0,10.444343769653237,43.373542698843806,26.90894323424852,16.464599464595285
0.538461538,0.222222222,34.08333333,10/22/2017,25,21,home,16,ATL,241,223,65,67,23,7,Win,162,120,2,1,0,NEP,30,403,343,0,-10.444343769653237,43.373542698843806,16.464599464595285,26.90894323424852
0.333333333,0.5,30.25,10/23/2017,19,23,away,-10,PHI,269,244,55,62,24,34,Loss,75,127,4,3,1,WAS,58,344,371,1,0.16969842802089197,47.43757984216266,23.803639135091778,23.633940707070884
0.5,0.333333333,29.75,10/23/2017,23,19,home,10,WAS,244,269,55,61,34,24,Win,127,75,3,4,1,PHI,58,371,344,1,-0.16969842802089197,47.43757984216266,23.633940707070884,23.803639135091778
0.26666666699999997,0.23076923100000002,28.76666667,10/26/2017,13,19,away,-40,BAL,151,121,43,66,0,40,Loss,45,174,3,0,0,MIA,40,196,295,2,0.15383120275926743,26.48621044780137,13.320020825280318,13.16618962252105
0.23076923100000002,0.26666666699999997,31.23333333,10/26/2017,19,13,home,40,MIA,121,151,40,62,40,0,Win,174,45,0,3,2,BAL,40,295,196,0,-0.15383120275926743,26.48621044780137,13.16618962252105,13.320020825280318
0.375,0.307692308,37.86666667,10/29/2017,26,16,away,17,CLE,287,161,58,78,33,16,Win,88,115,1,3,2,MIN,49,375,276,1,-7.783409012153914,39.687712920764234,15.952151954305158,23.735560966459076
0.307692308,0.375,22.13333333,10/29/2017,16,26,home,-17,MIN,161,287,74,59,16,33,Loss,115,88,3,1,1,CLE,49,276,375,2,7.783409012153914,39.687712920764234,23.735560966459076,15.95215195430516
0.35714285700000004,0.333333333,28.31666667,10/29/2017,18,15,away,5,NYJ,246,236,68,62,25,20,Win,140,43,1,3,1,ATL,45,386,279,2,-0.53477657174262,40.32142051941476,19.89332197383607,20.42809854557869
0.333333333,0.35714285700000004,31.68333333,10/29/2017,15,18,home,-5,ATL,236,246,50,58,20,25,Loss,43,140,3,1,2,NYJ,45,279,386,1,0.53477657174262,40.32142051941476,20.42809854557869,19.89332197383607
0.3,0.4,24.38333333,10/29/2017,23,17,away,-20,BUF,313,165,50,63,14,34,Loss,54,166,0,0,0,OAK,48,367,331,4,-5.404758674998494,50.89772488404376,22.746483104522632,28.15124177952113
0.4,0.3,35.61666667,10/29/2017,17,23,home,20,OAK,165,313,95,64,34,14,Win,166,54,0,0,4,BUF,48,331,367,0,5.404758674998494,50.89772488404376,28.15124177952113,22.746483104522632
0.470588235,0.166666667,32.18333333,10/29/2017,14,16,away,14,TBB,154,194,51,63,17,3,Win,100,85,0,3,3,CAR,20,254,279,1,-13.28260361493026,35.524794206661994,11.121095295865867,24.403698910796127
0.166666667,0.470588235,27.81666667,10/29/2017,16,14,home,-14,CAR,194,154,55,63,3,17,Loss,85,100,3,0,1,TBB,20,279,254,3,13.28260361493026,35.524794206661994,24.403698910796127,11.121095295865867
0.470588235,0.222222222,28.61666667,10/29/2017,17,19,away,-8,NOS,150,286,31,65,12,20,Loss,157,101,2,2,2,CHI,32,307,387,1,-0.9687040626685997,41.651250727762736,20.34127333254707,21.309977395215668
0.222222222,0.470588235,31.38333333,10/29/2017,19,17,home,8,CHI,286,150,51,60,20,12,Win,101,157,2,2,1,NOS,32,387,307,2,0.9687040626685997,41.651250727762736,21.309977395215668,20.34127333254707
0.5,0.363636364,33.21666667,10/29/2017,19,17,away,-1,CIN,216,218,45,71,23,24,Loss,115,58,4,3,2,IND,47,331,276,1,2.0731268064469344,41.196464422604784,21.63479561452586,19.561668808078924
0.363636364,0.5,26.78333333,10/29/2017,17,19,home,1,IND,218,216,54,53,24,23,Win,58,115,3,4,1,CIN,47,276,331,2,-2.0731268064469344,41.196464422604784,19.561668808078924,21.63479561452586
0.3,0.473684211,23.01666667,10/29/2017,16,27,away,-8,NEP,192,317,77,52,13,21,Loss,157,97,1,3,0,LAC,34,349,414,1,-0.4011295084580757,44.114439100658075,21.8566547961,22.257784304558076
0.473684211,0.3,36.98333333,10/29/2017,27,16,home,8,LAC,317,192,80,82,21,13,Win,97,157,3,1,1,NEP,34,414,349,0,0.4011295084580757,44.114439100658075,22.257784304558076,21.8566547961
0.2,0.28571428600000004,27.05,10/29/2017,14,19,away,-23,PHI,144,192,69,64,10,33,Loss,94,112,4,3,1,SFO,43,238,304,2,-1.9880872275778128,33.14225711299613,15.577084942709156,17.56517217028697
0.28571428600000004,0.2,32.95,10/29/2017,19,14,home,23,SFO,192,144,35,66,33,10,Win,112,94,3,4,2,PHI,43,304,238,1,1.9880872275778128,33.14225711299613,17.56517217028697,15.577084942709156
0.2,0.41666666700000005,30.36666667,10/29/2017,25,21,away,-3,SEA,367,446,93,69,38,41,Loss,142,33,5,2,1,HOU,79,509,479,3,-2.5264955475719617,59.376506152358296,28.425005302393167,30.95150084996513
0.41666666700000005,0.2,29.63333333,10/29/2017,21,25,home,3,HOU,446,367,120,64,41,38,Win,33,142,2,5,3,SEA,79,479,509,1,2.5264955475719617,59.376506152358296,30.95150084996513,28.425005302393167
0.35714285700000004,0.307692308,33.31666667,10/29/2017,18,16,away,14,WAS,138,236,89,63,33,19,Win,169,49,2,4,3,DAL,52,307,285,1,-6.011227489881194,36.21434708576878,15.101559797943793,21.112787287824986
0.307692308,0.35714285700000004,26.68333333,10/29/2017,16,18,home,-14,DAL,236,138,32,58,19,33,Loss,49,169,4,2,1,WAS,52,285,307,3,6.011227489881194,36.21434708576878,21.112787287824986,15.101559797943793
0.5,0.166666667,28.38333333,10/29/2017,17,21,away,5,DET,317,411,37,60,20,15,Win,75,71,0,2,1,PIT,35,392,482,2,-0.03117956089070173,51.19937079903877,25.584095619074034,25.615275179964733
0.166666667,0.5,31.61666667,10/29/2017,21,17,home,-5,PIT,411,317,57,69,15,20,Loss,71,75,2,0,2,DET,35,482,392,1,0.03117956089070173,51.19937079903877,25.615275179964733,25.584095619074034
0.384615385,0.166666667,31.38333333,10/30/2017,23,16,away,-10,KCC,187,197,53,70,19,29,Loss,177,79,3,1,2,DEN,48,364,276,5,1.5358696861852241,44.04257898098984,22.78922433358753,21.253354647402308
0.166666667,0.384615385,28.61666667,10/30/2017,16,23,home,10,DEN,197,187,69,59,29,19,Win,79,177,1,3,5,KCC,48,276,364,2,-1.5358696861852241,44.04257898098984,21.253354647402308,22.78922433358753
0.375,0.428571429,26.5,11/2/2017,21,21,away,-13,NYJ,244,137,99,69,21,34,Loss,63,194,7,1,0,BUF,55,307,331,3,-5.720408792780049,44.76209215864798,19.520841682933966,25.241250475714015
0.428571429,0.375,33.5,11/2/2017,21,21,home,13,BUF,137,244,66,62,34,21,Win,194,63,1,7,3,NYJ,55,331,307,0,5.720408792780049,44.76209215864798,25.241250475714015,19.520841682933966
0.333333333,0.307692308,27.13333333,11/5/2017,17,20,away,-3,CAR,302,129,70,58,17,20,Loss,53,201,2,1,2,ATL,37,355,330,1,-2.2507290496184225,42.86097439080709,20.305122670594333,22.555851720212754
0.307692308,0.333333333,32.86666667,11/5/2017,20,17,home,3,ATL,129,302,29,63,20,17,Win,201,53,1,2,1,CAR,37,330,355,2,2.2507290496184225,42.86097439080709,22.555851720212754,20.305122670594333
0.375,0.272727273,32.36666667,11/5/2017,24,14,away,-3,TEN,268,186,39,77,20,23,Loss,73,71,2,3,1,BAL,43,341,257,2,0.403427882852756,37.80622799360937,19.10482793823106,18.701400055378308
0.272727273,0.375,27.63333333,11/5/2017,14,24,home,3,BAL,186,268,39,52,23,20,Win,71,73,3,2,2,TEN,43,257,341,1,-0.403427882852756,37.80622799360937,18.701400055378308,19.10482793823106
0.125,0.666666667,19.76666667,11/5/2017,8,26,away,-16,JAX,119,259,77,37,7,23,Loss,29,149,2,0,1,CIN,30,148,408,0,-0.6692626911230803,37.80759213811143,18.569164723494175,19.238427414617256
0.666666667,0.125,40.23333333,11/5/2017,26,8,home,16,CIN,259,119,50,78,23,7,Win,149,29,0,2,0,JAX,30,408,148,1,0.6692626911230803,37.80759213811143,19.238427414617256,18.569164723494175
0.23076923100000002,0.384615385,30.1,11/5/2017,14,25,away,-28,PHI,191,222,105,60,23,51,Loss,35,197,3,2,1,DEN,74,226,419,2,2.30009724737646,44.43507738429618,23.367587315836317,21.06749006845986
0.384615385,0.23076923100000002,29.9,11/5/2017,25,14,home,28,DEN,222,191,35,67,51,23,Win,197,35,2,3,2,PHI,74,419,226,1,-2.30009724737646,44.43507738429618,21.06749006845986,23.367587315836317
0.28571428600000004,0.28571428600000004,30.98333333,11/5/2017,17,19,away,6,HOU,279,194,68,61,20,14,Win,92,94,3,2,1,IND,34,371,288,1,-6.584511370088885,40.787695971186416,17.101592300548766,23.68610367063765
0.28571428600000004,0.28571428600000004,29.01666667,11/5/2017,19,17,home,-6,IND,194,279,74,67,14,20,Loss,94,92,2,3,1,HOU,34,288,371,1,6.584511370088885,40.787695971186416,23.68610367063765,17.101592300548766
0.5,0.5,30.5,11/5/2017,20,17,away,34,NYG,311,208,55,61,51,17,Win,162,111,0,2,3,LAR,68,473,319,0,-8.819991558612138,51.5450390492066,21.36252374529723,30.18251530390937
0.5,0.5,29.5,11/5/2017,17,20,home,-34,LAR,208,311,52,66,17,51,Loss,111,162,2,0,0,NYG,68,319,473,3,8.819991558612138,51.5450390492066,30.18251530390937,21.36252374529723
0.307692308,0.538461538,27.7,11/5/2017,14,21,away,-20,NOS,113,256,50,57,10,30,Loss,87,151,4,1,2,TBB,40,200,407,1,0.41573879731408425,39.68582889744071,20.050783847377396,19.63504505006331
0.538461538,0.307692308,32.3,11/5/2017,21,14,home,20,TBB,256,113,28,60,30,10,Win,151,87,1,4,1,NOS,40,407,200,2,-0.41573879731408425,39.68582889744071,19.63504505006331,20.050783847377396
0.4375,0.352941176,36.36666667,11/5/2017,20,17,away,10,SFO,201,266,25,73,20,10,Win,167,63,0,5,2,ARI,30,368,329,2,-11.989983079677007,38.563233001882665,13.28662496110283,25.276608040779834
0.352941176,0.4375,23.63333333,11/5/2017,17,20,home,-10,ARI,266,201,53,73,10,20,Loss,63,167,5,0,2,SFO,30,329,368,2,11.989983079677007,38.563233001882665,25.276608040779834,13.286624961102829
0.307692308,0.35714285700000004,27.68333333,11/5/2017,16,22,away,3,SEA,193,289,62,60,17,14,Win,51,148,6,2,2,WAS,31,244,437,1,-11.72468197275677,39.46191790238025,13.86861796481174,25.59329993756851
0.35714285700000004,0.307692308,32.31666667,11/5/2017,22,16,home,-3,WAS,289,193,138,75,14,17,Loss,148,51,2,6,1,SEA,31,437,244,2,11.72468197275677,39.46191790238025,25.59329993756851,13.86861796481174
0.363636364,0.583333333,28.71666667,11/5/2017,17,24,away,-11,DAL,255,244,52,55,17,28,Loss,68,131,2,1,0,KCC,45,323,375,1,-1.0671043394004602,43.31254435453741,21.122720007568475,22.189824346968933
0.583333333,0.363636364,31.28333333,11/5/2017,24,17,home,11,KCC,244,255,65,65,28,17,Win,131,68,1,2,1,DAL,45,375,323,0,1.0671043394004602,43.31254435453741,22.189824346968933,21.122720007568475
0.533333333,0.41666666700000005,30.93333333,11/5/2017,20,23,away,3,MIA,295,309,105,58,27,24,Win,84,86,1,1,1,OAK,51,379,395,2,-2.3750671964322314,56.867788528824406,27.246360666196086,29.62142786262832
0.41666666700000005,0.533333333,29.06666667,11/5/2017,23,20,home,-3,OAK,309,295,107,61,24,27,Loss,86,84,1,1,2,MIA,51,395,379,1,2.3750671964322314,56.867788528824406,29.62142786262832,27.246360666196086
0.615384615,0.222222222,36.91666667,11/6/2017,24,21,away,13,GBP,353,233,19,67,30,17,Win,64,78,1,3,0,DET,47,417,311,1,6.4055038306817975,49.71703919659936,28.061271513640577,21.655767682958782
0.222222222,0.615384615,23.08333333,11/6/2017,21,24,home,-13,DET,233,353,20,58,17,30,Loss,78,64,3,1,1,GBP,47,311,417,0,-6.4055038306817975,49.71703919659936,21.655767682958782,28.061271513640577
0.23076923100000002,0.4,30.88333333,11/9/2017,14,24,away,6,ARI,212,256,108,60,22,16,Win,75,34,5,2,1,SEA,38,287,290,0,-5.2516835340991985,32.73172066993153,13.740018567916167,18.991702102015367
0.4,0.23076923100000002,29.11666667,11/9/2017,24,14,home,-6,SEA,256,212,58,73,16,22,Loss,34,75,2,5,0,ARI,38,290,287,1,5.2516835340991985,32.73172066993153,18.991702102015367,13.740018567916167
0.5,0.181818182,41.38333333,11/12/2017,32,10,away,37,BUF,184,129,41,73,47,10,Win,298,69,0,2,1,NOS,57,482,198,1,5.805199237612186,44.22216430743463,25.01368177252341,19.208482534911223
0.181818182,0.5,18.61666667,11/12/2017,10,32,home,-37,NOS,129,184,56,45,10,47,Loss,69,298,2,0,1,BUF,57,198,482,1,-5.805199237612186,44.22216430743463,19.208482534911223,25.01368177252341
0.4375,0.28571428600000004,33.88333333,11/12/2017,18,14,away,7,CHI,182,268,35,65,23,16,Win,160,55,3,5,1,GBP,39,342,323,0,-2.7927378516689405,39.680648011382836,18.44395507985695,21.236692931525887
0.28571428600000004,0.4375,26.11666667,11/12/2017,14,18,home,-7,GBP,268,182,78,57,16,23,Loss,55,160,5,3,0,CHI,39,323,342,1,2.7927378516689405,39.680648011382836,21.236692931525887,18.44395507985695
0.1,0.46666666700000003,19.85,11/12/2017,15,27,away,-4,TEN,255,236,84,50,20,24,Loss,53,180,1,4,2,CIN,44,308,416,2,-4.000911734987527,45.42891087766722,20.713999571339848,24.714911306327373
0.46666666700000003,0.1,40.15,11/12/2017,27,15,home,4,CIN,236,255,55,84,24,20,Win,180,53,4,1,2,TEN,44,416,308,2,4.000911734987527,45.42891087766722,24.714911306327373,20.713999571339848
0.333333333,0.454545455,34.56666667,11/12/2017,26,16,away,-14,DET,212,241,60,77,24,38,Loss,201,104,4,4,1,CLE,62,413,345,2,-0.8062887300175099,46.682170516490174,22.93794089323633,23.744229623253844
0.454545455,0.333333333,25.43333333,11/12/2017,16,26,home,14,CLE,241,212,81,49,38,24,Win,104,201,4,4,2,DET,62,345,413,1,0.8062887300175099,46.682170516490174,23.744229623253844,22.93794089323633
0.384615385,0.4,29.96666667,11/12/2017,18,13,away,3,IND,228,196,70,62,20,17,Win,88,71,1,3,1,PIT,37,316,267,1,-2.0401558150313175,37.793504712182326,17.876674448575503,19.916830263606823
0.4,0.384615385,30.03333333,11/12/2017,13,18,home,-3,PIT,196,228,82,56,17,20,Loss,71,88,3,1,1,IND,37,267,316,1,2.0401558150313175,37.793504712182326,19.916830263606823,17.876674448575503
0.2,0.27777777800000003,31.78333333,11/12/2017,16,20,away,-3,JAX,235,263,77,67,0,3,Loss,87,135,0,3,2,LAC,3,322,398,2,-20.56530674880505,36.82578846252969,8.130240856862319,28.695547605667368
0.27777777800000003,0.2,35.01666667,11/12/2017,20,16,home,3,LAC,263,235,106,81,3,0,Win,135,87,3,0,2,JAX,3,398,322,2,20.56530674880505,36.82578846252969,28.695547605667368,8.130240856862319
0.666666667,0.35714285700000004,28.9,11/12/2017,21,24,away,8,WAS,304,313,40,60,38,30,Win,102,81,0,1,1,MIN,68,406,394,2,-6.48084058882711,51.64949939047315,22.584329400823023,29.06516998965013
0.35714285700000004,0.666666667,31.1,11/12/2017,24,21,home,-8,MIN,313,304,15,73,30,38,Loss,81,102,1,0,2,WAS,68,394,406,1,6.48084058882711,51.64949939047315,29.06516998965013,22.584329400823023
0.2,0.4375,28.1,11/12/2017,15,17,away,-5,TBB,219,181,77,64,10,15,Loss,56,90,6,1,1,NYJ,25,275,271,2,-11.07698055629797,34.06454605666433,11.493782750183179,22.570763306481147
0.4375,0.2,31.9,11/12/2017,17,15,home,5,NYJ,181,219,50,66,15,10,Win,90,56,1,6,2,TBB,25,271,275,1,11.07698055629797,34.06454605666433,22.570763306481147,11.493782750183179
0.333333333,0.375,28.48333333,11/12/2017,17,19,away,-26,LAR,194,339,60,64,7,33,Loss,89,104,3,3,0,HOU,40,283,443,4,-10.53000046824194,46.3772049126486,17.92360222220333,28.453602690445273
0.375,0.333333333,31.51666667,11/12/2017,19,17,home,26,HOU,339,194,86,66,33,7,Win,104,89,3,3,4,LAR,40,443,283,0,10.53000046824194,46.3772049126486,28.453602690445273,17.92360222220333
0.454545455,0.538461538,27.9,11/12/2017,18,22,away,-20,ATL,126,204,54,59,7,27,Loss,107,132,8,1,1,DAL,34,233,336,2,-0.9006735382214046,37.69371825270559,18.39652235724209,19.297195895463496
0.538461538,0.454545455,32.1,11/12/2017,22,18,home,20,DAL,204,126,35,64,27,7,Win,132,107,1,8,2,ATL,34,336,233,1,0.9006735382214046,37.69371825270559,19.297195895463496,18.39652235724209
0.35714285700000004,0.666666667,31.0,11/12/2017,19,21,away,-10,SFO,260,288,35,63,21,31,Loss,114,186,3,0,2,NYG,52,374,474,1,0.589219339949679,54.22411330626297,27.406666323106325,26.817446983156646
0.666666667,0.35714285700000004,29.0,11/12/2017,21,19,home,10,NYG,288,260,44,58,31,21,Win,186,114,0,3,1,SFO,52,474,374,2,-0.589219339949679,54.22411330626297,26.817446983156646,27.406666323106325
0.363636364,0.533333333,29.71666667,11/12/2017,28,17,away,25,DEN,297,221,5,67,41,16,Win,99,118,1,0,2,NEP,57,396,339,0,12.125473137977556,48.333817802167395,30.229645470072477,18.10417233209492
0.533333333,0.363636364,30.28333333,11/12/2017,17,28,home,-25,NEP,221,297,28,61,16,41,Loss,118,99,0,1,0,DEN,57,339,396,2,-12.125473137977556,48.333817802167395,18.10417233209492,30.229645470072477
0.583333333,0.7857142859999999,24.35,11/13/2017,17,30,away,-24,CAR,213,254,57,54,21,45,Loss,100,294,0,0,0,MIA,66,313,548,1,-6.371201741954238,58.29129767868501,25.960047968365387,32.331249710319625
0.7857142859999999,0.583333333,35.65,11/13/2017,30,17,home,24,MIA,254,213,37,71,45,21,Win,294,100,0,0,1,CAR,66,548,313,0,6.371201741954238,58.29129767868501,32.331249710319625,25.960047968365387
0.384615385,0.333333333,28.33333333,11/16/2017,17,25,away,-23,PIT,264,284,65,60,17,40,Loss,52,65,5,3,0,TEN,57,316,349,4,-2.241587557816029,45.28365842426972,21.521035433226842,23.762622991042875
0.333333333,0.384615385,31.66666667,11/16/2017,25,17,home,23,TEN,284,264,61,69,40,17,Win,65,52,3,5,4,PIT,57,349,316,0,2.241587557816029,45.28365842426972,23.762622991042875,21.521035433226842
0.23076923100000002,0.46153846200000004,31.81666667,11/19/2017,19,18,away,10,MIA,268,365,82,62,30,20,Win,53,83,1,1,5,TBB,50,321,448,0,-5.013828573728836,49.32862476322125,22.157398094746206,27.171226668475043
0.46153846200000004,0.23076923100000002,28.18333333,11/19/2017,18,19,home,-10,TBB,365,268,123,60,20,30,Loss,83,53,1,1,0,MIA,50,448,321,5,5.013828573728836,49.32862476322125,27.171226668475043,22.157398094746206
0.3,0.533333333,26.23333333,11/19/2017,17,22,away,-10,HOU,244,223,90,54,21,31,Loss,48,134,2,1,2,ARI,52,292,357,2,-2.2641273487171016,44.845486083705765,21.29067936749433,23.554806716211434
0.533333333,0.3,33.76666667,11/19/2017,22,17,home,10,ARI,223,244,42,67,31,21,Win,134,48,1,2,2,HOU,52,357,292,2,2.2641273487171016,44.845486083705765,23.554806716211434,21.29067936749433
0.214285714,0.307692308,30.05,11/19/2017,14,16,away,23,GBP,161,190,30,57,23,0,Win,58,75,3,6,5,BAL,23,219,265,1,6.798727744419459,33.54168840596085,20.170208075190153,13.371480330770694
0.307692308,0.214285714,29.95,11/19/2017,16,14,home,-23,BAL,190,161,53,67,0,23,Loss,75,58,6,3,1,GBP,23,265,219,5,-6.798727744419459,33.54168840596085,13.371480330770694,20.170208075190153
0.3,0.333333333,30.6,11/19/2017,20,25,away,3,CHI,287,176,49,58,27,24,Win,65,222,3,1,1,DET,51,352,398,1,4.071855395191487,48.437099644127706,26.254477519659595,22.18262212446811
0.333333333,0.3,29.4,11/19/2017,25,20,home,-3,DET,176,287,64,61,24,27,Loss,222,65,1,3,1,CHI,51,398,352,1,-4.071855395191487,48.437099644127706,22.18262212446811,26.254477519659595
0.3,0.23076923100000002,36.91666667,11/19/2017,15,11,away,12,CLE,145,134,40,76,19,7,Win,139,50,2,5,5,JAX,26,284,184,1,-7.9894465231605025,27.866397872735803,9.93847567478765,17.927922197948153
0.23076923100000002,0.3,23.08333333,11/19/2017,11,15,home,-12,JAX,134,145,0,55,7,19,Loss,50,139,5,2,1,CLE,26,184,284,5,7.9894465231605025,27.866397872735803,17.927922197948153,9.93847567478765
0.272727273,0.23076923100000002,37.26666667,11/19/2017,22,20,away,-3,NYG,229,205,87,71,0,3,Loss,134,112,1,0,1,KCC,3,363,317,3,-8.670560287201821,38.04801895608743,14.688729334442804,23.359289621644628
0.23076923100000002,0.272727273,30.83333333,11/19/2017,20,22,home,3,KCC,205,229,48,68,3,0,Win,112,134,0,1,3,NYG,3,317,363,1,8.670560287201821,38.04801895608743,23.359289621644628,14.688729334442804
0.272727273,0.5,22.63333333,11/19/2017,15,27,away,-17,MIN,209,280,60,56,7,24,Loss,45,171,2,0,0,LAR,31,254,451,1,-6.725386332968995,44.62039925067486,18.94750645885293,25.672892791821926
0.5,0.272727273,37.36666667,11/19/2017,27,15,home,17,LAR,280,209,65,73,24,7,Win,171,45,0,2,1,MIN,31,451,254,0,6.725386332968995,44.62039925067486,25.672892791821926,18.94750645885293
0.333333333,0.333333333,32.18333333,11/19/2017,24,27,away,-3,NOS,300,375,67,67,0,3,Loss,156,160,2,2,1,WAS,3,456,535,0,-1.3144478579715067,54.566534840165936,26.626043491097214,27.940491349068722
0.333333333,0.333333333,30.4,11/19/2017,27,24,home,3,WAS,375,300,54,66,3,0,Win,160,156,2,2,0,NOS,3,535,456,1,1.3144478579715067,54.566534840165936,27.940491349068722,26.626043491097214
0.428571429,0.5,23.91666667,11/19/2017,18,28,away,-30,LAC,220,283,48,62,24,54,Loss,173,146,1,1,0,BUF,78,393,429,6,-2.1859241616408553,55.22919035022551,26.521633094292326,28.70755725593318
0.5,0.428571429,36.08333333,11/19/2017,28,18,home,30,BUF,283,220,13,73,54,24,Win,146,173,1,1,6,LAC,78,429,393,0,2.1859241616408553,55.22919035022551,28.70755725593318,26.521633094292326
0.46666666700000003,0.571428571,24.81666667,11/19/2017,12,20,away,3,DEN,141,229,14,53,20,17,Win,49,112,2,3,2,CIN,37,190,341,0,-4.792341682527566,35.88377230048636,15.5457153089794,20.338056991506964
0.571428571,0.46666666700000003,35.18333333,11/19/2017,20,12,home,-3,CIN,229,141,50,79,17,20,Loss,112,49,3,2,0,DEN,37,341,190,2,4.792341682527566,35.88377230048636,20.338056991506967,15.545715308979398
0.5,0.46666666700000003,27.61666667,11/19/2017,25,21,away,25,OAK,332,235,10,58,33,8,Win,89,109,1,1,2,NEP,41,421,344,0,5.5634864115743845,53.33190366067396,29.447695036124173,23.884208624549785
0.46666666700000003,0.5,32.38333333,11/19/2017,21,25,home,-25,NEP,235,332,66,71,8,33,Loss,109,89,1,1,0,OAK,41,344,421,2,-5.5634864115743845,53.33190366067396,23.884208624549785,29.447695036124173
0.35714285700000004,0.214285714,29.48333333,11/19/2017,17,14,away,28,DAL,168,113,30,60,37,9,Win,215,112,0,4,4,PHI,46,383,225,0,1.2987061734808556,35.956794318664414,18.627750246072637,17.329044072591778
0.214285714,0.35714285700000004,30.51666667,11/19/2017,14,17,home,-28,PHI,113,168,10,63,9,37,Loss,112,215,4,0,0,DAL,46,225,383,4,-1.2987061734808556,35.956794318664414,17.329044072591778,18.627750246072637
0.642857143,0.41666666700000005,30.35,11/20/2017,22,26,away,3,SEA,190,224,69,58,34,31,Win,89,136,1,3,2,ATL,65,279,360,1,-1.0190176989368993,45.78032668983404,22.38065449544857,23.39967219438547
0.41666666700000005,0.642857143,29.65,11/20/2017,26,22,home,-3,ATL,224,190,106,69,31,34,Loss,136,89,3,1,1,SEA,65,360,279,2,1.0190176989368993,45.78032668983404,23.39967219438547,22.38065449544857
0.46153846200000004,0.272727273,34.95,11/23/2017,28,17,away,7,DET,272,236,74,73,30,23,Win,136,53,2,3,2,MIN,53,408,289,0,0.8418743694046285,47.192331161347376,24.017102765376002,23.175228395971374
0.272727273,0.46153846200000004,25.05,11/23/2017,17,28,home,-7,MIN,236,272,54,53,23,30,Loss,53,136,3,2,0,DET,53,289,408,2,-0.8418743694046285,47.192331161347376,23.175228395971374,24.017102765376002
0.642857143,0.545454545,36.08333333,11/23/2017,25,14,away,22,DAL,434,168,56,66,28,6,Win,81,79,0,2,2,LAC,34,515,247,0,-0.8175120815223202,50.176283049265265,24.67938548387147,25.496897565393795
0.545454545,0.642857143,23.91666667,11/23/2017,14,25,home,-22,LAC,168,434,60,49,6,28,Loss,79,81,2,0,0,DAL,34,247,515,2,0.8175120815223202,50.176283049265265,25.496897565393795,24.67938548387147
0.14285714300000002,0.26666666699999997,25.38333333,11/23/2017,7,17,away,-10,WAS,86,201,79,55,10,20,Loss,84,122,4,6,1,NYG,30,170,323,1,-11.38060820912684,26.057644885547006,7.338518338210083,18.719126547336923
0.26666666699999997,0.14285714300000002,34.61666667,11/23/2017,17,7,home,10,NYG,201,86,55,68,20,10,Win,122,84,6,4,1,WAS,30,323,170,1,11.38060820912684,26.057644885547006,18.719126547336923,7.338518338210083
0.363636364,0.7857142859999999,29.9,11/26/2017,27,23,away,-14,ATL,279,368,15,68,20,34,Loss,94,148,1,0,1,TBB,54,373,516,0,-4.428416640956921,54.509541861400095,25.04056261022159,29.468979251178506
0.7857142859999999,0.363636364,30.1,11/26/2017,23,27,home,14,TBB,368,279,42,64,34,20,Win,148,94,0,1,0,ATL,54,516,373,1,4.428416640956921,54.509541861400095,29.468979251178506,25.04056261022159
0.352941176,0.153846154,33.3,11/26/2017,17,14,away,6,KCC,164,181,50,68,16,10,Win,104,55,2,2,1,BUF,26,268,236,0,-4.198560882487458,28.843622106318488,12.322530611915514,16.521091494402974
0.153846154,0.352941176,26.7,11/26/2017,14,17,home,-6,BUF,181,164,50,57,10,16,Loss,55,104,2,2,0,KCC,26,236,268,1,4.198560882487458,28.843622106318488,16.521091494402974,12.322530611915514
0.214285714,0.35714285700000004,31.83333333,11/26/2017,17,21,away,8,NYJ,154,282,84,64,35,27,Win,145,109,3,3,1,CAR,62,299,391,0,-9.339114819440901,42.48606778727591,16.573476483917503,25.912591303358404
0.35714285700000004,0.214285714,28.16666667,11/26/2017,21,17,home,-8,CAR,282,154,68,65,27,35,Loss,109,145,3,3,0,NYJ,62,391,299,1,9.339114819440901,42.48606778727591,25.912591303358404,16.573476483917503
0.23076923100000002,0.4375,22.86666667,11/26/2017,8,24,away,-28,PHI,134,244,56,49,3,31,Loss,6,176,2,1,3,CHI,34,140,420,2,-1.97904107069726,40.195431083806746,19.108195006554745,21.087236077252
0.4375,0.23076923100000002,37.13333333,11/26/2017,24,8,home,28,CHI,244,134,70,73,31,3,Win,176,6,1,2,2,PHI,34,420,140,3,1.97904107069726,40.195431083806746,21.087236077252,19.108195006554745
0.4,0.4,29.46666667,11/26/2017,21,23,away,-14,CIN,236,209,69,67,16,30,Loss,169,152,4,1,0,CLE,46,405,361,0,1.834094650702295,43.114646301815846,22.47437047625907,20.640275825556774
0.4,0.4,30.53333333,11/26/2017,23,21,home,14,CLE,209,236,35,59,30,16,Win,152,169,1,4,0,CIN,46,361,405,0,-1.834094650702295,43.114646301815846,20.640275825556774,22.47437047625907
0.375,0.428571429,28.63333333,11/26/2017,19,15,away,4,IND,184,165,15,53,20,16,Win,92,89,0,8,1,TEN,36,276,254,2,2.4943839145916273,38.745150061282374,20.619766987937002,18.125383073345372
0.428571429,0.375,31.36666667,11/26/2017,15,19,home,-4,TEN,165,184,67,61,16,20,Loss,89,92,8,0,2,IND,36,254,276,1,-2.4943839145916273,38.745150061282374,18.125383073345372,20.619766987937002
0.181818182,0.41666666700000005,27.31666667,11/26/2017,15,25,away,-18,NEP,154,221,52,60,17,35,Loss,67,196,7,1,2,MIA,52,221,417,3,9.473050008351994,40.5624354864348,25.0177427473934,15.544692739041404
0.41666666700000005,0.181818182,32.68333333,11/26/2017,25,15,home,18,MIA,221,154,70,67,35,17,Win,196,67,1,7,3,NEP,52,417,221,2,-9.473050008351994,40.5624354864348,15.544692739041402,25.0177427473934
0.384615385,0.3125,29.51666667,11/26/2017,20,16,away,11,SFO,228,196,35,64,24,13,Win,90,84,0,3,1,SEA,37,318,280,1,-4.254185628137524,34.70359283527669,15.22470360356958,19.478889231707107
0.3125,0.384615385,30.48333333,11/26/2017,16,20,home,-11,SEA,196,228,74,67,13,24,Loss,84,90,3,0,1,SFO,37,280,318,1,4.254185628137524,34.70359283527669,19.478889231707107,15.224703603569582
0.083333333,0.41176470600000004,25.35,11/26/2017,19,20,away,-3,ARI,128,236,45,58,24,27,Loss,91,108,3,1,2,JAX,51,219,344,3,-4.128781844509536,38.2521075511404,17.061662853315433,21.190444697824965
0.41176470600000004,0.083333333,34.65,11/26/2017,20,19,home,3,JAX,236,128,98,70,27,24,Win,108,91,1,3,3,ARI,51,344,219,2,4.128781844509536,38.2521075511404,21.190444697824965,17.061662853315433
0.35714285700000004,0.384615385,24.1,11/26/2017,12,21,away,-7,OAK,160,244,75,57,14,21,Loss,56,104,5,2,1,DEN,35,216,348,1,-2.350606556010016,41.71334553810205,19.681369491046016,22.03197604705603
0.384615385,0.35714285700000004,35.9,11/26/2017,21,12,home,7,DEN,244,160,68,63,21,14,Win,104,56,2,5,1,OAK,35,348,216,1,2.350606556010016,41.71334553810205,22.03197604705603,19.681369491046016
0.23076923100000002,0.214285714,24.56666667,11/26/2017,14,24,away,-6,LAR,223,327,112,52,20,26,Loss,123,88,3,4,1,NOS,46,346,415,0,-3.223742148554718,43.18806721250792,19.9821625319766,23.20590468053132
0.214285714,0.23076923100000002,35.43333333,11/26/2017,24,14,home,6,NOS,327,223,90,73,26,20,Win,88,123,4,3,0,LAR,46,415,346,1,3.223742148554718,43.18806721250792,23.20590468053132,19.9821625319766
0.46153846200000004,0.615384615,26.4,11/26/2017,15,28,away,-3,PIT,227,341,27,54,28,31,Loss,80,121,4,1,3,GBP,59,307,462,0,4.362551286273289,53.201065437892545,28.781808362082916,24.41925707580963
0.615384615,0.46153846200000004,33.6,11/26/2017,28,15,home,3,GBP,341,227,45,70,31,28,Win,121,80,1,4,0,PIT,59,462,307,3,-4.362551286273289,53.201065437892545,24.41925707580963,28.781808362082916
0.428571429,0.214285714,30.26666667,11/27/2017,20,17,away,-7,BAL,237,155,36,64,16,23,Loss,66,139,2,1,0,HOU,39,303,294,3,-3.444758448106562,37.716199515498964,17.1357205336962,20.580478981802763
0.214285714,0.428571429,29.73333333,11/27/2017,17,20,home,7,HOU,155,237,89,65,23,16,Win,139,66,1,2,3,BAL,39,294,303,0,3.444758448106562,37.716199515498964,20.580478981802763,17.1357205336962
0.428571429,0.5,27.53333333,11/30/2017,15,21,away,-24,DAL,224,93,43,60,14,38,Loss,56,182,4,1,0,WAS,52,280,275,4,-7.881915770457411,36.51556281973394,14.316823524638263,22.198739295095674
0.5,0.428571429,32.46666667,11/30/2017,21,15,home,24,WAS,93,224,25,65,38,14,Win,182,56,1,4,4,DAL,52,275,280,0,7.881915770457411,36.51556281973394,22.198739295095674,14.316823524638263
0.5,0.1,34.03333333,12/3/2017,22,15,away,5,ATL,207,173,51,63,14,9,Win,105,102,2,0,0,MIN,23,312,275,0,3.5379805198334604,34.64704357931245,19.092512049572957,15.554531529739496
0.1,0.5,25.96666667,12/3/2017,15,22,home,-5,MIN,173,207,55,51,9,14,Loss,102,105,0,2,0,ATL,23,275,312,0,-3.5379805198334604,34.64704357931245,15.554531529739496,19.092512049572957
0.307692308,0.41666666700000005,30.15,12/3/2017,18,24,away,-24,BAL,294,269,45,61,20,44,Loss,78,101,3,0,0,DET,64,372,370,3,8.571329637217076,47.25694378811317,27.914136712665123,19.342807075448047
0.41666666700000005,0.307692308,29.85,12/3/2017,24,18,home,24,DET,269,294,25,63,44,20,Win,101,78,0,3,3,BAL,64,370,372,0,-8.571329637217076,47.25694378811317,19.342807075448047,27.914136712665123
0.41666666700000005,0.384615385,34.01666667,12/3/2017,23,16,away,20,BUF,244,85,66,68,23,3,Win,191,183,3,4,1,NEP,26,435,268,1,2.431590145323552,41.49290336265888,21.962246753991217,19.530656608667663
0.384615385,0.41666666700000005,25.98333333,12/3/2017,16,23,home,-20,NEP,85,244,34,64,3,23,Loss,183,191,4,3,1,BUF,26,268,435,1,-2.431590145323552,41.49290336265888,19.530656608667663,21.962246753991217
0.5555555560000001,0.5,38.78333333,12/3/2017,23,8,away,1,CHI,278,85,53,73,15,14,Win,110,62,2,2,0,SFO,29,388,147,1,0.15982013125503292,36.38353123010183,18.27167568067843,18.1118555494234
0.5,0.5555555560000001,21.21666667,12/3/2017,8,23,home,-1,SFO,85,278,29,36,14,15,Loss,62,110,2,2,1,CHI,29,147,388,0,-0.15982013125503292,36.38353123010183,18.1118555494234,18.27167568067843
0.076923077,0.26666666699999997,25.63333333,12/3/2017,14,15,away,-26,MIA,167,222,57,67,9,35,Loss,103,145,3,2,3,DEN,44,270,367,3,-3.3203114802795213,37.00980894989203,16.844748734806256,20.165060215085777
0.26666666699999997,0.076923077,34.36666667,12/3/2017,15,14,home,26,DEN,222,167,85,64,35,9,Win,145,103,2,3,3,MIA,44,367,270,3,3.3203114802795213,37.00980894989203,20.165060215085777,16.844748734806256
0.5625,0.41666666700000005,37.28333333,12/3/2017,25,16,away,-6,GBP,230,77,74,74,0,6,Loss,165,199,7,2,1,TBB,6,395,276,1,-5.742920896551142,42.33397697973484,18.29552804159185,24.03844893814299
0.41666666700000005,0.5625,26.73333333,12/3/2017,16,25,home,6,TBB,77,230,47,53,6,0,Win,199,165,2,7,1,GBP,6,276,395,1,5.742920896551142,42.33397697973484,24.03844893814299,18.29552804159185
0.5,0.454545455,33.81666667,12/3/2017,24,19,away,-11,TEN,331,146,85,75,13,24,Loss,53,198,4,2,1,HOU,37,384,344,1,-8.078681865356222,49.81947456476606,20.87039634970492,28.949078215061142
0.454545455,0.5,26.18333333,12/3/2017,19,24,home,11,HOU,146,331,63,50,24,13,Win,198,53,2,4,1,TEN,37,344,384,1,8.078681865356222,49.81947456476606,28.949078215061142,20.87039634970492
0.333333333,0.6,26.21666667,12/3/2017,17,22,away,-20,JAX,149,330,31,66,10,30,Loss,141,96,4,1,0,IND,40,290,426,2,-6.229207146179146,46.59573812497261,20.18326548939673,26.41247263557588
0.6,0.333333333,33.78333333,12/3/2017,22,17,home,20,IND,330,149,55,64,30,10,Win,96,141,1,4,2,JAX,40,426,290,0,6.229207146179146,46.59573812497261,26.41247263557588,20.18326548939673
0.375,0.65,17.18333333,12/3/2017,17,30,away,-7,NYJ,362,331,30,46,31,38,Loss,112,157,2,0,0,KCC,69,474,488,0,-1.462561064353522,56.35190980659487,27.444674371120673,28.907235435474195
0.65,0.375,42.81666667,12/3/2017,30,17,home,7,KCC,331,362,40,85,38,31,Win,157,112,0,2,0,NYJ,69,488,474,0,1.462561064353522,56.35190980659487,28.907235435474195,27.444674371120673
0.454545455,0.533333333,25.05,12/3/2017,17,23,away,-9,LAC,202,335,24,57,10,19,Loss,89,94,3,1,0,CLE,29,291,429,2,-2.9529247142728927,43.95516846581978,20.501121875773443,23.45404659004634
0.533333333,0.454545455,34.95,12/3/2017,23,17,home,9,CLE,335,202,62,69,19,10,Win,94,89,1,3,2,LAC,29,429,291,0,2.9529247142728927,43.95516846581978,23.45404659004634,20.501121875773443
0.272727273,0.46666666700000003,28.96666667,12/3/2017,18,19,away,16,ARI,213,187,36,56,32,16,Win,90,118,1,7,2,LAR,48,303,305,1,3.5937934295251055,39.03162458944,21.312709009482553,17.718915579957446
0.46666666700000003,0.272727273,31.03333333,12/3/2017,19,18,home,-16,LAR,187,213,25,62,16,32,Loss,118,90,7,1,1,ARI,48,305,303,2,-3.5937934295251055,39.03162458944,17.718915579957446,21.312709009482553
0.3,0.4,26.65,12/3/2017,16,19,away,-10,NOS,167,252,54,53,21,31,Loss,112,148,2,2,1,CAR,52,279,400,1,-1.0052156534490546,43.67857714594222,21.336680746246582,22.34189639969564
0.4,0.3,33.35,12/3/2017,19,16,home,10,CAR,252,167,68,64,31,21,Win,148,112,2,2,1,NOS,52,400,279,1,1.0052156534490546,43.67857714594222,22.34189639969564,21.336680746246582
0.35714285700000004,0.4,28.68333333,12/3/2017,15,18,away,-7,OAK,200,282,5,61,17,24,Loss,65,119,3,1,1,NYG,41,265,401,2,-5.688609345820478,45.33965037120723,19.825520512693373,25.514129858513854
0.4,0.35714285700000004,31.31666667,12/3/2017,18,15,home,7,NYG,282,200,42,66,24,17,Win,119,65,1,3,2,OAK,41,401,265,1,5.688609345820478,45.33965037120723,25.514129858513854,19.825520512693373
0.5,0.5,31.9,12/3/2017,25,20,away,-14,SEA,327,209,64,74,10,24,Loss,98,101,3,2,0,PHI,34,425,310,2,0.985471461097557,49.553139582170395,25.269305521633974,24.28383406053642
0.5,0.5,28.1,12/3/2017,20,25,home,14,PHI,209,327,46,58,24,10,Win,101,98,2,3,2,SEA,34,310,425,0,-0.985471461097557,49.553139582170395,24.28383406053642,25.269305521633974
0.333333333,0.5,29.81666667,12/4/2017,24,19,away,3,CIN,282,223,66,63,23,20,Win,92,130,1,2,0,PIT,43,374,353,1,-1.9963151485723047,46.901686119543434,22.452685485485564,24.44900063405787
0.5,0.333333333,30.18333333,12/4/2017,19,24,home,-3,PIT,223,282,173,60,20,23,Loss,130,92,2,1,1,CIN,43,353,374,0,1.9963151485723047,46.901686119543434,24.44900063405787,22.452685485485564
0.3,0.583333333,25.31666667,12/7/2017,18,26,away,-3,ATL,256,211,82,52,17,20,Loss,50,132,2,1,3,NOS,37,306,343,1,7.559415492776155,46.63740927590889,27.09841238434252,19.538996891566367
0.583333333,0.3,34.68333333,12/7/2017,26,18,home,3,NOS,211,256,35,65,20,17,Win,132,50,1,2,1,ATL,37,343,306,3,-7.559415492776155,46.63740927590889,19.538996891566367,27.09841238434252
0.25,0.5555555560000001,36.03333333,12/10/2017,16,14,away,-6,BUF,64,92,20,69,0,6,Loss,163,227,1,0,2,IND,6,227,319,0,-11.168642005709508,27.2673066667318,8.049332330511145,19.217974336220653
0.5555555560000001,0.25,32.41666667,12/10/2017,14,16,home,6,IND,92,64,10,67,6,0,Win,227,163,0,1,0,BUF,6,319,227,2,11.168642005709508,27.2673066667318,19.217974336220653,8.049332330511145
0.46666666700000003,0.333333333,28.7,12/10/2017,21,15,away,-7,CAR,256,129,30,71,24,31,Loss,100,216,6,2,1,MIN,55,356,345,3,-9.829785673286372,44.35555109922058,17.2628827129671,27.092668386253475
0.333333333,0.46666666700000003,31.3,12/10/2017,15,21,home,7,MIN,129,256,48,63,31,24,Win,216,100,2,6,3,CAR,55,345,356,1,9.829785673286372,44.35555109922058,27.092668386253475,17.2628827129671
0.363636364,0.25,38.15,12/10/2017,29,14,away,26,CIN,250,164,74,72,33,7,Win,232,70,2,3,2,CHI,40,482,234,0,1.2173876932237135,43.68175586958196,22.449571781402838,21.232184088179125
0.25,0.363636364,21.85,12/10/2017,14,29,home,-26,CHI,164,250,56,53,7,33,Loss,70,232,3,2,0,CIN,40,234,482,2,-1.2173876932237135,43.68175586958196,21.232184088179125,22.449571781402838
0.5,0.538461538,36.28333333,12/10/2017,24,17,away,6,CLE,256,209,20,74,6,0,Win,85,136,1,2,2,GBP,6,341,345,0,-2.8758313288291717,42.089495875193336,19.606832273182082,22.482663602011254
0.538461538,0.5,28.63333333,12/10/2017,17,24,home,-6,GBP,209,256,45,57,0,6,Loss,136,85,2,1,0,CLE,6,345,341,2,2.8758313288291717,42.089495875193336,22.482663602011254,19.606832273182082
0.5,0.375,27.11666667,12/10/2017,19,21,away,20,NYG,332,228,51,61,30,10,Win,122,102,0,0,2,DAL,40,454,330,0,-12.240564110876743,47.36698948634699,17.563212687735124,29.803776798611864
0.375,0.5,32.88333333,12/10/2017,21,19,home,-20,DAL,228,332,69,75,10,30,Loss,102,122,0,0,0,NYG,40,330,454,2,12.240564110876743,47.36698948634699,29.803776798611864,17.563212687735124
0.454545455,0.5,29.78333333,12/10/2017,21,28,away,3,TBB,381,267,105,62,24,21,Win,53,133,0,3,5,DET,45,434,400,3,-3.8228453560076705,62.28788052383614,29.23251758391423,33.055362939921906
0.5,0.454545455,30.21666667,12/10/2017,28,21,home,-3,DET,267,381,65,69,21,24,Loss,133,53,3,0,3,TBB,45,400,434,5,3.8228453560076705,62.28788052383614,33.055362939921906,29.232517583914234
0.181818182,0.23076923100000002,34.81666667,12/10/2017,20,18,away,10,HOU,314,221,87,66,26,16,Win,102,90,2,3,1,SFO,42,416,311,1,-6.971939009744671,41.23068937118151,17.12937518071842,24.101314190463093
0.23076923100000002,0.181818182,25.18333333,12/10/2017,18,20,home,-10,SFO,221,314,81,64,16,26,Loss,90,102,3,2,1,HOU,42,311,416,1,6.971939009744671,41.23068937118151,24.101314190463093,17.12937518071842
0.384615385,0.384615385,23.33333333,12/10/2017,15,23,away,-11,KCC,198,243,39,55,15,26,Loss,70,165,3,4,1,OAK,41,268,408,3,-3.0376044469323276,46.345209319773744,21.65380243642071,24.691406883353036
0.384615385,0.384615385,36.66666667,12/10/2017,23,15,home,11,OAK,243,198,69,71,26,15,Win,165,70,4,3,3,KCC,41,408,268,1,3.0376044469323276,46.345209319773744,24.691406883353036,21.65380243642071
0.333333333,0.214285714,26.18333333,12/10/2017,14,16,away,-5,ARI,139,125,48,56,7,12,Loss,65,136,3,8,0,TEN,19,204,261,2,-1.0212532066745812,27.03761472415368,13.008180758739549,14.029433965414132
0.214285714,0.333333333,33.81666667,12/10/2017,16,14,home,5,TEN,125,139,30,63,12,7,Win,136,65,8,3,2,ARI,19,261,204,0,1.0212532066745812,27.03761472415368,14.029433965414132,13.008180758739549
0.23076923100000002,0.41176470600000004,22.41666667,12/10/2017,6,17,away,-23,DEN,41,189,20,48,0,23,Loss,59,84,4,2,0,NYJ,23,100,273,2,0.9488032078131035,25.3799236414413,13.164363424627203,12.215560216814099
0.41176470600000004,0.23076923100000002,37.58333333,12/10/2017,17,6,home,23,NYJ,189,41,21,68,23,0,Win,84,59,2,4,2,DEN,23,273,100,0,-0.9488032078131035,25.3799236414413,12.215560216814099,13.164363424627203
0.166666667,0.4,24.66666667,12/10/2017,9,24,away,-17,LAC,136,314,47,50,13,30,Loss,65,174,2,2,1,WAS,43,201,488,1,-4.799893738855573,37.280470699577755,16.24028848036109,21.040182219216664
0.4,0.166666667,35.33333333,12/10/2017,24,9,home,17,WAS,314,136,40,71,30,13,Win,174,65,2,2,1,LAC,43,488,201,1,4.799893738855573,37.280470699577755,21.040182219216664,16.24028848036109
0.222222222,0.333333333,26.98333333,12/10/2017,17,20,away,-6,JAX,260,268,73,57,24,30,Loss,141,156,2,0,1,SEA,54,401,424,3,0.4932840340050575,48.28595826785025,24.389621150927653,23.896337116922595
0.333333333,0.222222222,33.01666667,12/10/2017,20,17,home,6,SEA,268,260,48,66,30,24,Win,156,141,0,2,3,JAX,54,424,401,1,-0.4932840340050575,48.28595826785025,23.896337116922595,24.389621150927653
0.4,0.28571428600000004,39.2,12/10/2017,29,17,away,8,LAR,316,198,67,85,43,35,Win,139,109,2,2,2,PHI,78,455,307,1,-2.185521771860949,51.97249969912088,24.893488963629967,27.079010735490915
0.28571428600000004,0.4,20.8,12/10/2017,17,29,home,-8,PHI,198,316,102,45,35,43,Loss,109,139,2,2,1,LAR,78,307,455,2,2.185521771860949,51.97249969912088,27.079010735490915,24.893488963629967
0.4,0.666666667,26.16666667,12/10/2017,26,31,away,-1,PIT,261,486,35,62,38,39,Loss,152,59,1,3,0,BAL,77,413,545,1,-2.7244970246651943,58.64465582079282,27.96007939806381,30.68457642272901
0.666666667,0.4,33.83333333,12/10/2017,31,26,home,1,BAL,486,261,101,85,39,38,Win,59,152,3,1,1,PIT,77,545,413,0,2.7244970246651943,58.64465582079282,30.68457642272901,27.96007939806381
0.0,0.28571428600000004,23.85,12/11/2017,14,21,away,-7,MIA,223,242,78,55,20,27,Loss,25,120,2,2,0,NEP,47,248,362,2,6.0253582590394235,33.50991785719738,19.7676380581184,13.742279799078979
0.28571428600000004,0.0,36.15,12/11/2017,21,14,home,7,NEP,242,223,102,70,27,20,Win,120,25,2,2,2,MIA,47,362,248,0,-6.0253582590394235,33.50991785719738,13.742279799078979,19.7676380581184
0.46666666700000003,0.46153846200000004,36.85,12/14/2017,23,15,away,12,IND,251,158,80,74,25,13,Win,211,70,2,1,0,DEN,38,462,228,1,-3.0268894330660476,44.821056669165195,20.897083618049574,23.92397305111562
0.46153846200000004,0.46666666700000003,23.15,12/14/2017,15,23,home,-12,DEN,158,251,39,53,13,25,Loss,70,211,1,2,1,IND,38,228,462,0,3.0268894330660476,44.821056669165195,23.92397305111562,20.897083618049574
0.41666666700000005,0.46153846200000004,30.91666667,12/16/2017,22,18,away,-10,DET,306,202,97,63,10,20,Loss,43,91,2,4,1,CHI,30,349,293,3,-0.8702766434239857,47.57444934870415,23.352086352640082,24.222362996064067
0.46153846200000004,0.41666666700000005,29.08333333,12/16/2017,18,22,home,10,CHI,202,306,58,57,20,10,Win,91,43,4,2,3,DET,30,293,349,1,0.8702766434239857,47.57444934870415,24.222362996064067,23.352086352640082
0.363636364,0.428571429,26.65,12/16/2017,20,20,away,-17,KCC,209,223,61,60,13,30,Loss,98,174,2,1,0,LAC,43,307,397,4,-1.4681038450492707,44.90479387961642,21.718345017283575,23.186448862332846
0.428571429,0.363636364,33.35,12/16/2017,20,20,home,17,LAC,223,209,71,63,30,13,Win,174,98,1,2,4,KCC,43,397,307,0,1.4681038450492707,44.90479387961642,23.186448862332846,21.718345017283575
0.21052631600000002,0.111111111,36.26666667,12/17/2017,19,14,away,-5,WAS,145,187,71,80,15,20,Loss,141,31,5,1,1,ARI,35,286,218,2,-7.892426559408137,27.528014811531925,9.817794126061894,17.71022068547003
0.111111111,0.21052631600000002,23.73333333,12/17/2017,14,19,home,5,ARI,187,145,82,47,20,15,Win,31,141,1,5,2,WAS,35,218,286,1,7.892426559408137,27.528014811531925,17.71022068547003,9.817794126061894
0.4375,0.35714285700000004,36.8,12/17/2017,23,15,away,17,CLE,279,136,57,74,27,10,Win,97,130,1,2,4,BAL,37,376,266,0,-0.9388100892999773,38.42023534647057,18.740712628585296,19.679522717885273
0.35714285700000004,0.4375,23.2,12/17/2017,15,23,home,-17,BAL,136,279,35,58,10,27,Loss,130,97,2,1,0,CLE,37,266,376,4,0.9388100892999773,38.42023534647057,19.679522717885273,18.740712628585296
0.3125,0.46666666700000003,32.41666667,12/17/2017,21,21,away,-8,BUF,249,212,60,73,16,24,Loss,100,116,3,2,0,MIA,40,349,328,3,-2.8506647587138616,43.73729665130133,20.443315946293733,23.293980705007595
0.46666666700000003,0.3125,27.58333333,12/17/2017,21,21,home,8,MIA,212,249,28,61,24,16,Win,116,100,2,3,3,BUF,40,328,349,0,2.8506647587138616,43.73729665130133,23.293980705007595,20.443315946293733
0.363636364,0.5,26.05,12/17/2017,24,29,away,-7,CAR,264,236,28,67,24,31,Loss,120,151,3,1,0,GBP,55,384,387,4,-1.7715339356010986,56.953389485834116,27.59092777511651,29.362461710717607
0.5,0.363636364,33.95,12/17/2017,29,24,home,7,GBP,236,264,40,70,31,24,Win,151,120,1,3,4,CAR,55,387,384,0,1.7715339356010986,56.953389485834116,29.362461710717607,27.59092777511651
0.076923077,0.333333333,24.13333333,12/17/2017,8,18,away,-27,MIN,115,222,44,51,7,34,Loss,46,124,3,2,1,CIN,41,161,346,2,3.9777379141445124,30.499242024490314,17.238489969317413,13.260752055172901
0.333333333,0.076923077,35.86666667,12/17/2017,18,8,home,27,CIN,222,115,93,61,34,7,Win,124,46,2,3,2,MIN,41,346,161,1,-3.9777379141445124,30.499242024490314,13.260752055172901,17.238489969317413
0.25,0.3,26.7,12/17/2017,9,25,away,-38,JAX,99,326,127,56,7,45,Loss,87,138,4,1,0,HOU,52,186,464,1,-11.275453839715691,39.321199236641576,14.02287269846294,25.298326538178635
0.3,0.25,33.3,12/17/2017,25,9,home,38,HOU,326,99,54,68,45,7,Win,138,87,1,4,1,JAX,52,464,186,0,11.275453839715691,39.321199236641576,25.298326538178635,14.022872698462942
0.333333333,0.3,30.83333333,12/17/2017,19,23,away,-12,NOS,170,281,50,68,19,31,Loss,124,131,1,0,3,NYJ,50,294,412,2,-2.5760759480421367,47.231757217725324,22.327840634841593,24.90391658288373
0.3,0.333333333,29.16666667,12/17/2017,23,19,home,12,NYJ,281,170,92,64,31,19,Win,131,124,0,1,2,NOS,50,412,294,3,2.5760759480421367,47.231757217725324,24.90391658288373,22.327840634841593
0.46153846200000004,0.5555555560000001,30.88333333,12/17/2017,22,27,away,5,NYG,233,429,44,66,34,29,Win,108,75,1,1,1,PHI,63,341,504,0,-10.486928080271388,55.92156942462151,22.717320672175063,33.204248752446446
0.5555555560000001,0.46153846200000004,29.11666667,12/17/2017,27,22,home,-5,PHI,429,233,67,81,29,34,Loss,75,108,1,1,0,NYG,63,504,341,1,10.486928080271388,55.92156942462151,33.204248752446446,22.71732067217506
0.375,0.28571428600000004,36.76666667,12/17/2017,19,11,away,35,SEA,108,71,25,68,42,7,Win,244,78,2,7,2,LAR,49,352,149,1,-2.6333557652821007,29.70560667023929,13.536125452478593,16.169481217760698
0.28571428600000004,0.375,23.23333333,12/17/2017,11,19,home,-35,LAR,71,108,60,54,7,42,Loss,78,244,7,2,1,SEA,49,149,352,2,2.6333557652821007,29.70560667023929,16.169481217760698,13.536125452478595
0.333333333,0.625,24.88333333,12/17/2017,21,21,away,3,PIT,283,270,4,56,27,24,Win,77,143,2,2,1,NEP,51,360,413,1,13.6265789110239,48.66892643586987,31.147752673446885,17.521173762422986
0.625,0.333333333,35.11666667,12/17/2017,21,21,home,-3,NEP,270,283,63,63,24,27,Loss,143,77,2,2,1,PIT,51,413,360,1,-13.6265789110239,48.66892643586987,17.521173762422986,31.147752673446885
0.5,0.5,27.41666667,12/17/2017,23,23,away,-2,SFO,238,363,22,62,23,25,Loss,90,51,1,3,0,TEN,48,328,414,1,-4.312829868451704,48.85162948978423,22.269399810666265,26.582229679117965
0.5,0.5,32.58333333,12/17/2017,23,23,home,2,TEN,363,238,70,68,25,23,Win,51,90,3,1,1,SFO,48,414,328,0,4.312829868451704,48.85162948978423,26.582229679117965,22.269399810666265
0.2,0.533333333,32.33333333,12/17/2017,21,19,away,3,OAK,204,171,100,60,20,17,Win,126,122,2,0,1,DAL,37,330,293,2,-7.162587029123853,45.40072463524391,19.119068803060028,26.281655832183883
0.533333333,0.2,27.66666667,12/17/2017,19,21,home,-3,DAL,171,204,105,61,17,20,Loss,122,126,0,2,2,OAK,37,293,330,1,7.162587029123853,45.40072463524391,26.281655832183883,19.119068803060028
0.6,0.5,33.25,12/18/2017,24,22,away,3,TBB,209,289,60,67,24,21,Win,201,84,1,2,1,ATL,45,410,373,0,-3.1046923921309517,49.54991823700796,23.222612922438504,26.327305314569454
0.5,0.6,26.75,12/18/2017,22,24,home,-3,ATL,289,209,53,55,21,24,Loss,84,201,2,1,0,TBB,45,373,410,1,3.1046923921309517,49.54991823700796,26.327305314569454,23.222612922438504
0.384615385,0.428571429,24.2,12/23/2017,17,23,away,-7,BAL,203,220,19,59,16,23,Loss,93,103,2,1,0,IND,39,296,323,0,2.3967412365521024,37.1216014360804,19.75917133631625,17.362430099764147
0.428571429,0.384615385,35.8,12/23/2017,23,17,home,7,IND,220,203,25,71,23,16,Win,103,93,1,2,0,BAL,39,323,296,0,-2.3967412365521024,37.1216014360804,17.362430099764147,19.75917133631625
0.26666666699999997,0.26666666699999997,31.61666667,12/23/2017,15,12,away,16,GBP,124,126,10,61,16,0,Win,112,113,3,1,2,MIN,16,236,239,0,-5.45281264449163,28.504095596415077,11.525641475961724,16.978454120453353
0.26666666699999997,0.26666666699999997,28.38333333,12/23/2017,12,15,home,-16,MIN,126,124,79,65,0,16,Loss,113,112,1,3,0,GBP,16,239,236,2,5.45281264449163,28.504095596415077,16.978454120453353,11.525641475961724
0.153846154,0.23076923100000002,26.2,12/24/2017,15,15,away,-10,NOS,264,229,91,61,13,23,Loss,67,86,5,1,1,ATL,36,331,315,2,2.5354480397975543,34.409028617753535,18.472238328775546,15.93679028897799
0.23076923100000002,0.153846154,33.8,12/24/2017,15,15,home,10,ATL,229,264,30,60,23,13,Win,86,67,1,5,2,NOS,36,315,331,1,-2.5354480397975543,34.409028617753535,15.936790288977988,18.472238328775546
0.470588235,0.454545455,28.26666667,12/24/2017,17,28,away,-21,NEP,242,218,83,68,16,37,Loss,84,193,6,2,1,BUF,53,326,411,0,3.0868129233881323,45.530738748602595,24.308775835995363,21.221962912607232
0.454545455,0.470588235,31.73333333,12/24/2017,28,17,home,21,BUF,218,242,10,68,37,16,Win,193,84,2,6,0,NEP,53,411,326,1,-3.0868129233881323,45.530738748602595,21.221962912607232,24.308775835995363
0.545454545,0.307692308,29.5,12/24/2017,20,20,away,-3,CAR,326,140,72,57,19,22,Loss,66,115,6,2,1,TBB,41,392,255,3,-2.259386001032661,47.959392104797764,22.850003051882553,25.109389052915212
0.307692308,0.545454545,30.5,12/24/2017,20,20,home,3,TBB,140,326,50,59,22,19,Win,115,66,2,6,3,CAR,41,255,392,1,2.259386001032661,47.959392104797764,25.109389052915212,22.850003051882553
0.307692308,0.4375,26.76666667,12/24/2017,12,16,away,-17,CHI,178,161,60,57,3,20,Loss,76,97,1,5,0,CLE,23,254,258,3,-2.2862387593215807,31.057062647914748,14.385411944296585,16.671650703618162
0.4375,0.307692308,33.23333333,12/24/2017,16,12,home,17,CLE,161,178,25,59,20,3,Win,97,76,5,1,3,CHI,23,258,254,0,2.2862387593215807,31.057062647914748,16.671650703618162,14.385411944296584
0.4,0.5,27.51666667,12/24/2017,15,28,away,-9,CIN,189,222,74,59,17,26,Loss,87,142,2,3,1,DET,43,276,364,1,-6.478193145984651,42.889646613223235,18.205726733619294,24.68391987960394
0.5,0.4,32.48333333,12/24/2017,28,15,home,9,DET,222,189,60,78,26,17,Win,142,87,3,2,1,CIN,43,364,276,1,6.478193145984651,42.889646613223235,24.68391987960394,18.205726733619294
0.294117647,0.384615385,30.45,12/24/2017,18,19,away,-16,WAS,171,299,30,71,11,27,Loss,159,87,4,0,2,DEN,38,330,386,3,-7.450035117891357,43.70803649417211,18.12900068814038,25.579035806031733
0.384615385,0.294117647,29.55,12/24/2017,19,18,home,16,DEN,299,171,35,66,27,11,Win,87,159,0,4,3,WAS,38,386,330,2,7.450035117891357,43.70803649417211,25.579035806031733,18.12900068814038
0.0,0.5,22.11666667,12/24/2017,15,23,away,-16,KCC,286,301,75,54,13,29,Loss,59,103,0,1,0,MIA,42,345,404,2,-0.9285137207894572,41.214009707029234,20.14274799311989,21.071261713909344
0.5,0.0,37.88333333,12/24/2017,23,15,home,16,MIA,301,286,40,74,29,13,Win,103,59,1,0,2,KCC,42,404,345,0,0.9285137207894572,41.214009707029234,21.071261713909344,20.14274799311989
0.333333333,0.214285714,32.96666667,12/24/2017,21,13,away,7,NYJ,290,98,80,70,14,7,Win,89,197,0,3,3,LAC,21,379,295,0,-7.851819825349244,38.32055053201595,15.234365353333352,23.086185178682598
0.214285714,0.333333333,27.03333333,12/24/2017,13,21,home,-7,LAC,98,290,34,61,7,14,Loss,197,89,3,0,0,NYJ,21,295,379,3,7.851819825349244,38.32055053201595,23.086185178682598,15.234365353333352
0.428571429,0.25,30.06666667,12/24/2017,20,19,away,4,TEN,286,269,44,66,27,23,Win,116,97,1,1,1,LAR,50,402,366,1,-9.727608355694153,46.03291289293509,18.152652268620468,27.88026062431462
0.25,0.428571429,29.93333333,12/24/2017,19,20,home,-4,LAR,269,286,54,66,23,27,Loss,97,116,1,1,1,TEN,50,366,402,1,9.727608355694153,46.03291289293509,27.88026062431462,18.152652268620468
0.384615385,0.666666667,30.81666667,12/24/2017,32,26,away,-11,SFO,380,238,99,79,33,44,Loss,92,131,1,1,1,JAX,77,472,369,3,-10.18163007747981,60.27690096858984,25.047635445555017,35.229265523034826
0.666666667,0.384615385,29.18333333,12/24/2017,26,32,home,11,JAX,238,380,68,66,44,33,Win,131,92,1,1,3,SFO,77,369,472,1,10.18163007747981,60.27690096858984,35.229265523034826,25.047635445555017
0.071428571,0.35714285700000004,26.78333333,12/24/2017,12,19,away,-23,ARI,250,215,101,67,0,23,Loss,43,74,2,2,2,NYG,23,293,289,3,-7.336381384717285,35.80104380202842,14.232331208655566,21.56871259337285
0.35714285700000004,0.071428571,33.21666667,12/24/2017,19,12,home,23,NYG,215,250,45,64,23,0,Win,74,43,2,2,3,ARI,23,289,293,2,7.336381384717285,35.80104380202842,21.56871259337285,14.232331208655566
0.363636364,0.46153846200000004,27.16666667,12/24/2017,15,21,away,9,DAL,60,154,142,54,21,12,Win,76,128,3,4,3,SEA,33,136,282,0,-6.369667854352377,30.680762439881356,12.155547292764489,18.525215147116867
0.46153846200000004,0.363636364,32.83333333,12/24/2017,21,15,home,-9,SEA,154,60,75,68,12,21,Loss,128,76,4,3,0,DAL,33,282,136,3,6.369667854352377,30.680762439881356,18.525215147116867,12.155547292764489
0.583333333,0.25,30.93333333,12/25/2017,20,13,away,28,HOU,226,51,24,58,34,6,Win,104,176,0,7,2,PIT,40,330,227,0,1.42015146863843,37.46057476218835,19.44036311541339,18.02021164677496
0.25,0.583333333,29.06666667,12/25/2017,13,20,home,-28,PIT,51,226,80,52,6,34,Loss,176,104,7,0,0,HOU,40,227,330,2,-1.42015146863843,37.46057476218835,18.02021164677496,19.44036311541339
0.23076923100000002,0.071428571,34.35,12/25/2017,13,12,away,-9,PHI,137,138,50,63,10,19,Loss,137,78,1,2,2,OAK,29,274,216,5,-3.016471215227021,36.226344173789656,16.604936479281317,19.62140769450834
0.071428571,0.23076923100000002,25.65,12/25/2017,12,13,home,9,OAK,138,137,60,61,19,10,Win,78,137,2,1,5,PHI,29,216,274,2,3.016471215227021,36.226344173789656,19.62140769450834,16.604936479281317
0.083333333,0.384615385,24.08333333,12/31/2017,12,21,away,-13,MIN,171,180,116,53,10,23,Loss,30,147,1,2,0,CHI,33,201,327,0,-8.58454195130777,31.44103182847932,11.428244938585774,20.012786889893547
0.384615385,0.083333333,35.91666667,12/31/2017,21,12,home,13,CHI,180,171,103,67,23,10,Win,147,30,2,1,0,MIN,33,327,201,0,8.58454195130777,31.44103182847932,20.012786889893547,11.428244938585776
0.46666666700000003,0.3,30.91666667,12/31/2017,17,20,away,-4,PIT,272,224,77,63,24,28,Loss,102,124,6,3,2,CLE,52,374,348,2,3.9597133946074825,43.12241964234058,23.541066518474032,19.58135312386655
0.3,0.46666666700000003,29.08333333,12/31/2017,20,17,home,4,CLE,224,272,15,58,28,24,Win,124,102,3,6,2,PIT,52,348,374,2,-3.9597133946074825,43.12241964234058,19.58135312386655,23.541066518474032
0.333333333,0.181818182,30.08333333,12/31/2017,16,12,away,6,PHI,172,149,64,63,6,0,Win,129,70,1,3,2,DAL,6,301,219,1,-0.2475638059666494,32.078254926308354,15.915345560170852,16.1629093661375
0.181818182,0.333333333,29.91666667,12/31/2017,12,16,home,-6,DAL,149,172,49,55,0,6,Loss,70,129,3,1,1,PHI,6,219,301,2,0.2475638059666494,32.078254926308354,16.1629093661375,15.915345560170852
0.28571428600000004,0.333333333,31.78333333,12/31/2017,17,18,away,-24,DET,153,305,68,63,11,35,Loss,103,51,4,2,0,GBP,46,256,356,4,5.053595580010679,43.90445048276124,24.47902303138596,19.42542745137528
0.333333333,0.28571428600000004,28.21666667,12/31/2017,18,17,home,24,GBP,305,153,62,54,35,11,Win,51,103,2,4,4,DET,46,356,256,0,-5.053595580010679,43.90445048276124,19.42542745137528,24.47902303138596
0.454545455,0.46153846200000004,28.78333333,12/31/2017,15,20,away,-9,IND,124,104,34,53,13,22,Loss,85,146,2,1,0,HOU,35,209,250,1,-0.866820371873386,34.72874679021206,16.930963209169335,17.797783581042722
0.46153846200000004,0.454545455,31.21666667,12/31/2017,20,15,home,9,HOU,104,124,20,62,22,13,Win,146,85,1,2,1,IND,35,250,209,0,0.866820371873386,34.72874679021206,17.797783581042722,16.930963209169335
0.0,0.26666666699999997,25.18333333,12/31/2017,14,28,away,-20,NEP,207,183,84,59,6,26,Loss,40,147,4,2,0,NYJ,32,247,330,0,0.8898635899609886,31.10315915881884,15.996511374389915,15.106647784428926
0.26666666699999997,0.0,34.81666667,12/31/2017,28,14,home,20,NYJ,183,207,49,80,26,6,Win,147,40,2,4,0,NEP,32,330,247,0,-0.8898635899609886,31.10315915881884,15.106647784428926,15.996511374389915
0.076923077,0.25,28.11666667,12/31/2017,10,17,away,-8,NYG,136,121,35,56,10,18,Loss,61,260,3,2,1,WAS,28,197,381,3,-10.737052850246123,29.871936073456546,9.567441611605211,20.304494461851334
0.25,0.076923077,31.88333333,12/31/2017,17,10,home,8,WAS,121,136,25,74,18,10,Win,260,61,2,3,3,NYG,28,381,197,1,10.737052850246123,29.871936073456546,20.304494461851334,9.567441611605211
0.28571428600000004,0.083333333,32.26666667,12/31/2017,19,13,away,2,SEA,143,195,25,68,26,24,Win,116,101,1,3,0,ARI,50,259,296,1,0.6175574437549405,27.5511562711023,14.08435685742862,13.46679941367368
0.083333333,0.28571428600000004,27.73333333,12/31/2017,13,19,home,-2,ARI,195,143,100,54,24,26,Loss,101,116,3,1,1,SEA,50,296,259,0,-0.6175574437549405,27.5511562711023,13.46679941367368,14.08435685742862
0.333333333,0.375,25.3,12/31/2017,15,20,away,-12,ATL,161,311,35,60,10,22,Loss,87,60,2,1,0,CAR,32,248,371,3,-10.018395210180369,38.908114432184995,14.444859611002315,24.46325482118268
0.375,0.333333333,34.7,12/31/2017,20,15,home,12,CAR,311,161,60,72,22,10,Win,60,87,1,2,3,ATL,32,371,248,0,10.018395210180369,38.908114432184995,24.46325482118268,14.444859611002313
0.333333333,0.294117647,28.65,12/31/2017,22,19,away,4,BAL,213,194,60,75,31,27,Win,146,118,1,1,1,CIN,58,359,312,1,-7.803443921393958,36.25536360257102,14.225959840588533,22.02940376198249
0.294117647,0.333333333,31.35,12/31/2017,19,22,home,-4,CIN,194,213,47,74,27,31,Loss,118,146,1,1,1,BAL,58,312,359,1,7.803443921393958,36.25536360257102,22.02940376198249,14.225959840588533
0.41666666700000005,0.384615385,31.06666667,12/31/2017,23,21,away,6,MIA,186,263,45,63,22,16,Win,126,93,4,1,1,BUF,38,312,356,0,-5.482342356291386,43.96473996489004,19.24119880429933,24.723541160590713
0.384615385,0.41666666700000005,28.93333333,12/31/2017,21,23,home,-6,BUF,263,186,145,67,16,22,Loss,93,126,1,4,0,MIA,38,356,312,1,5.482342356291386,43.96473996489004,24.723541160590713,19.24119880429933
0.363636364,0.41666666700000005,29.05,12/31/2017,23,22,away,3,DEN,269,226,40,65,27,24,Win,110,110,2,5,3,KCC,51,379,336,2,5.171258644969324,48.95268910597938,27.06197387547435,21.89071523050503
0.41666666700000005,0.363636364,30.95,12/31/2017,22,23,home,-3,KCC,226,269,30,65,24,27,Loss,110,110,5,2,2,DEN,51,336,379,3,-5.171258644969324,48.95268910597938,21.89071523050503,27.06197387547435
0.375,0.1875,26.55,12/31/2017,13,11,away,-5,TEN,146,116,41,60,10,15,Loss,83,116,2,3,1,JAX,25,229,232,4,-8.950256775318826,30.26432858321597,10.657035903948572,19.6072926792674
0.1875,0.375,33.45,12/31/2017,11,13,home,5,JAX,116,146,15,63,15,10,Win,116,83,3,2,4,TEN,25,232,229,1,8.950256775318826,30.26432858321597,19.6072926792674,10.657035903948572
0.363636364,0.538461538,26.66666667,12/31/2017,14,26,away,-20,LAC,231,380,85,53,10,30,Loss,105,115,2,1,0,OAK,40,336,495,2,-3.8680399753936925,55.05085533819172,25.591407681399012,29.459447656792705
0.538461538,0.363636364,33.33333333,12/31/2017,26,14,home,20,OAK,380,231,65,68,30,10,Win,115,105,1,2,2,LAC,40,495,336,0,3.8680399753936925,55.05085533819172,29.459447656792705,25.591407681399012
0.5,0.333333333,29.15,12/31/2017,25,15,away,21,LAR,292,149,23,63,34,13,Win,169,102,0,3,2,SFO,47,461,251,3,-1.3882221472597358,47.21135770364229,22.911567778191277,24.299789925451016
0.333333333,0.5,30.85,12/31/2017,15,25,home,-21,SFO,149,292,46,63,13,34,Loss,102,169,3,0,3,LAR,47,251,461,2,1.3882221472597358,47.21135770364229,24.299789925451016,22.911567778191277
0.5,0.7222222220000001,28.45,12/31/2017,18,28,away,-7,TBB,231,345,38,58,24,31,Loss,92,110,2,2,3,NOS,55,323,455,1,-7.5781165318592265,52.6556506990435,22.538767083592134,30.116883615451364
0.7222222220000001,0.5,31.55,12/31/2017,28,18,home,7,NOS,345,231,15,81,31,24,Win,110,92,2,2,1,TBB,55,455,323,3,7.5781165318592265,52.6556506990435,30.116883615451364,22.538767083592134
0.615384615,0.363636364,32.46666667,1/6/2018,23,19,away,1,KCC,195,256,50,64,22,21,Win,202,69,2,4,0,TEN,43,397,325,2,0.44888150225899426,47.983982267034115,24.216431884646553,23.76755038238756
0.363636364,0.615384615,27.53333333,1/6/2018,19,23,home,-1,TEN,256,195,68,53,21,22,Loss,69,202,4,2,2,KCC,43,325,397,0,-0.44888150225899426,47.983982267034115,23.76755038238756,24.216431884646553
0.333333333,0.35714285700000004,37.58333333,1/6/2018,20,19,away,13,LAR,198,246,51,72,26,13,Win,124,115,3,3,2,ATL,39,322,361,0,-8.808184183561021,38.72991133404718,14.960863575243081,23.7690477588041
0.35714285700000004,0.333333333,22.41666667,1/6/2018,19,20,home,-13,ATL,246,198,45,64,13,26,Loss,115,124,3,3,0,LAR,39,361,322,2,8.808184183561021,38.72991133404718,23.7690477588041,14.96086357524308
0.38888888899999996,0.166666667,32.61666667,1/7/2018,20,15,away,-7,JAX,133,75,52,74,3,10,Loss,130,155,2,2,0,BUF,13,263,230,2,-10.284237336589934,31.466222673109783,10.590992668259926,20.875230004849858
0.166666667,0.38888888899999996,27.38333333,1/7/2018,15,20,home,7,BUF,75,133,34,59,10,3,Win,155,130,2,2,2,JAX,13,230,263,0,10.284237336589934,31.466222673109783,20.875230004849858,10.590992668259926
0.470588235,0.25,33.81666667,1/7/2018,24,21,away,-5,NOS,306,369,18,71,26,31,Loss,107,41,4,1,1,CAR,57,413,410,0,-0.18004427397097444,52.32381787918104,26.071886802605036,26.251931076576007
0.25,0.470588235,26.18333333,1/7/2018,21,24,home,5,CAR,369,306,96,56,31,26,Win,41,107,1,4,0,NOS,57,410,413,1,0.18004427397097444,52.32381787918104,26.251931076576007,26.071886802605036
0.307692308,0.46153846200000004,27.9,1/13/2018,19,22,away,-5,PHI,195,238,73,59,10,15,Loss,86,96,3,1,2,ATL,25,281,334,0,4.428671490200179,41.82915691857936,23.12891420438977,18.70024271418959
0.46153846200000004,0.307692308,32.1,1/13/2018,22,19,home,5,ATL,238,195,24,63,15,10,Win,96,86,1,3,0,PHI,25,334,281,2,-4.428671490200179,41.82915691857936,18.70024271418959,23.12891420438977
0.333333333,0.647058824,27.06666667,1/13/2018,15,31,away,-21,NEP,202,337,62,61,14,35,Loss,65,101,8,0,0,TEN,49,267,438,0,-3.2138111244624987,43.722774002317045,20.25448143892727,23.468292563389774
0.647058824,0.333333333,32.93333333,1/13/2018,31,15,home,21,TEN,337,202,37,80,35,14,Win,101,65,0,8,0,NEP,49,438,267,0,3.2138111244624987,43.722774002317045,23.468292563389774,20.25448143892727
0.571428571,0.4375,28.83333333,1/14/2018,22,28,away,3,PIT,214,462,40,61,45,42,Win,164,83,0,2,2,JAX,87,378,545,0,-5.46468439231968,57.684143332949496,26.109729470314907,31.57441386263459
0.4375,0.571428571,31.16666667,1/14/2018,28,22,home,-3,JAX,462,214,25,78,42,45,Loss,83,164,2,0,0,PIT,87,545,378,2,5.46468439231968,57.684143332949496,31.57441386263459,26.109729470314907
0.222222222,0.588235294,26.71666667,1/14/2018,23,24,away,-5,MIN,278,308,97,67,24,29,Loss,80,95,2,2,1,NOS,53,358,403,2,-3.4372087203781234,49.647339370226604,23.10506532492424,26.542274045302364
0.588235294,0.222222222,33.28333333,1/14/2018,24,23,home,5,NOS,308,278,30,71,29,24,Win,95,80,2,2,2,MIN,53,403,358,1,3.4372087203781234,49.647339370226604,26.542274045302364,23.10506532492424
0.4,0.25,35.13333333,1/21/2018,22,22,away,-4,NEP,273,298,98,71,20,24,Loss,101,46,3,3,1,JAX,44,374,344,0,3.9558272484212256,43.98469862677008,23.970262937595653,20.01443568917443
0.25,0.4,24.86666667,1/21/2018,22,22,home,4,JAX,298,273,10,61,24,20,Win,46,101,3,3,0,NEP,44,344,374,1,-3.9558272484212256,43.98469862677008,20.01443568917443,23.970262937595653
0.46153846200000004,0.7142857140000001,25.93333333,1/21/2018,22,27,away,-31,PHI,263,346,19,67,7,38,Loss,70,110,1,1,0,MIN,45,333,456,3,1.7006791940092363,57.88723164258637,29.793955418297806,28.093276224288566
0.7142857140000001,0.46153846200000004,34.06666667,1/21/2018,27,22,home,31,MIN,346,263,55,64,38,7,Win,110,70,1,1,3,PHI,45,456,333,0,-1.7006791940092363,57.88723164258637,28.093276224288566,29.793955418297806
0.625,0.5,34.06666667,2/4/2018,25,29,away,8,NEP,374,500,35,71,41,33,Win,164,113,0,1,1,PHI,74,538,613,1,8.412928991163215,69.71691314371246,39.06492106743784,30.651992076274624
0.5,0.625,25.93333333,2/4/2018,29,25,home,-8,PHI,500,374,5,72,33,41,Loss,113,164,1,0,1,NEP,74,613,538,1,-8.412928991163215,69.71691314371246,30.651992076274624,39.06492106743784
